PokerStars Hand #255105599349: Tournament #3862890532, $4.80+$5.00+$1.20 USD Hold'em No Limit - Level I (25/50) - 2025/03/02 16:29:54 WET [2025/03/02 11:29:54 ET]
Table '3862890532 33' 8-max Seat #1 is the button
Seat 1: Roselot_14 (5000 in chips, $5 bounty) 
Seat 2: an1k1tos23 (5000 in chips, $5 bounty) 
Seat 3: danielhgh (5000 in chips, $5 bounty) 
Seat 4: Kevin12345Mc (5000 in chips, $5 bounty) 
Seat 5: Shlblk1990 (5000 in chips, $5 bounty) 
Seat 6: Ás do Pokker (5000 in chips, $5 bounty) 
Seat 7: kafe1107 (5000 in chips, $5 bounty) 
Seat 8: chigivara553 (5000 in chips, $5 bounty) 
Roselot_14: posts the ante 8
an1k1tos23: posts the ante 8
danielhgh: posts the ante 8
Kevin12345Mc: posts the ante 8
Shlblk1990: posts the ante 8
Ás do Pokker: posts the ante 8
kafe1107: posts the ante 8
chigivara553: posts the ante 8
an1k1tos23: posts small blind 25
danielhgh: posts big blind 50
*** HOLE CARDS ***
Dealt to Kevin12345Mc [Qh Jd]
Kevin12345Mc: folds 
Shlblk1990: folds 
Ás do Pokker: folds 
kafe1107: folds 
chigivara553: folds 
Roselot_14: folds 
an1k1tos23: folds 
Uncalled bet (25) returned to danielhgh
danielhgh collected 114 from pot
*** SUMMARY ***
Total pot 114 | Rake 0 
Seat 1: Roselot_14 (button) folded before Flop (didn't bet)
Seat 2: an1k1tos23 (small blind) folded before Flop
Seat 3: danielhgh (big blind) collected (114)
Seat 4: Kevin12345Mc folded before Flop (didn't bet)
Seat 5: Shlblk1990 folded before Flop (didn't bet)
Seat 6: Ás do Pokker folded before Flop (didn't bet)
Seat 7: kafe1107 folded before Flop (didn't bet)
Seat 8: chigivara553 folded before Flop (didn't bet)



PokerStars Hand #255105606334: Tournament #3862890532, $4.80+$5.00+$1.20 USD Hold'em No Limit - Level I (25/50) - 2025/03/02 16:30:20 WET [2025/03/02 11:30:20 ET]
Table '3862890532 160' 8-max Seat #1 is the button
Seat 1: Kevin12345Mc (4992 in chips, $5 bounty) 
Seat 2: ghettosunrise (5131 in chips, $5 bounty) 
Seat 3: sontz88 (5000 in chips, $5 bounty) 
Seat 4: PaulaZaranec (5000 in chips, $5 bounty) 
Seat 5: zagi2409 (5000 in chips, $5 bounty) 
Kevin12345Mc: posts the ante 8
ghettosunrise: posts the ante 8
sontz88: posts the ante 8
PaulaZaranec: posts the ante 8
zagi2409: posts the ante 8
ghettosunrise: posts small blind 25
sontz88: posts big blind 50
*** HOLE CARDS ***
Dealt to Kevin12345Mc [Js 2c]
PaulaZaranec is disconnected 
PaulaZaranec is connected 
ghettosunrise is disconnected 
sontz88 is disconnected 
marceloprj is disconnected 
PaulaZaranec: raises 50 to 100
dideus94 is disconnected 
zagi2409 is disconnected 
zagi2409 is connected 
zagi2409: calls 100
Kevin12345Mc: folds 
ghettosunrise: raises 500 to 600
sontz88: folds 
PaulaZaranec: folds 
zagi2409: calls 500
*** FLOP *** [3d 9h Tc]
ghettosunrise: checks 
zagi2409: bets 1390
ghettosunrise: folds 
Uncalled bet (1390) returned to zagi2409
zagi2409 collected 1390 from pot
zagi2409: doesn't show hand 
*** SUMMARY ***
Total pot 1390 | Rake 0 
Board [3d 9h Tc]
Seat 1: Kevin12345Mc (button) folded before Flop (didn't bet)
Seat 2: ghettosunrise (small blind) folded on the Flop
Seat 3: sontz88 (big blind) folded before Flop
Seat 4: PaulaZaranec folded before Flop
Seat 5: zagi2409 collected (1390)



PokerStars Hand #255105619696: Tournament #3862890532, $4.80+$5.00+$1.20 USD Hold'em No Limit - Level I (25/50) - 2025/03/02 16:31:10 WET [2025/03/02 11:31:10 ET]
Table '3862890532 160' 8-max Seat #2 is the button
Seat 1: Kevin12345Mc (4984 in chips, $5 bounty) 
Seat 2: ghettosunrise (4523 in chips, $5 bounty) 
Seat 3: sontz88 (4942 in chips, $5 bounty) 
Seat 4: PaulaZaranec (4892 in chips, $5 bounty) 
Seat 5: zagi2409 (5782 in chips, $5 bounty) 
Seat 6: marceloprj (5000 in chips, $5 bounty) 
Seat 7: Svechnik322 (5231 in chips, $5 bounty) 
Seat 8: dideus94 (5000 in chips, $5 bounty) 
Kevin12345Mc: posts the ante 8
ghettosunrise: posts the ante 8
sontz88: posts the ante 8
PaulaZaranec: posts the ante 8
zagi2409: posts the ante 8
marceloprj: posts the ante 8
Svechnik322: posts the ante 8
dideus94: posts the ante 8
sontz88: posts small blind 25
PaulaZaranec: posts big blind 50
*** HOLE CARDS ***
Dealt to Kevin12345Mc [8c 4d]
zagi2409: folds 
marceloprj: folds 
Svechnik322: raises 62 to 112
dideus94: folds 
Kevin12345Mc: folds 
ghettosunrise: folds 
sontz88: folds 
PaulaZaranec: folds 
Uncalled bet (62) returned to Svechnik322
Svechnik322 collected 189 from pot
Svechnik322: doesn't show hand 
*** SUMMARY ***
Total pot 189 | Rake 0 
Seat 1: Kevin12345Mc folded before Flop (didn't bet)
Seat 2: ghettosunrise (button) folded before Flop (didn't bet)
Seat 3: sontz88 (small blind) folded before Flop
Seat 4: PaulaZaranec (big blind) folded before Flop
Seat 5: zagi2409 folded before Flop (didn't bet)
Seat 6: marceloprj folded before Flop (didn't bet)
Seat 7: Svechnik322 collected (189)
Seat 8: dideus94 folded before Flop (didn't bet)



PokerStars Hand #255105626721: Tournament #3862890532, $4.80+$5.00+$1.20 USD Hold'em No Limit - Level I (25/50) - 2025/03/02 16:31:35 WET [2025/03/02 11:31:35 ET]
Table '3862890532 160' 8-max Seat #3 is the button
Seat 1: Kevin12345Mc (4976 in chips, $5 bounty) 
Seat 2: ghettosunrise (4515 in chips, $5 bounty) 
Seat 3: sontz88 (4909 in chips, $5 bounty) 
Seat 4: PaulaZaranec (4834 in chips, $5 bounty) 
Seat 5: zagi2409 (5774 in chips, $5 bounty) 
Seat 6: marceloprj (4992 in chips, $5 bounty) 
Seat 7: Svechnik322 (5362 in chips, $5 bounty) 
Seat 8: dideus94 (4992 in chips, $5 bounty) 
Kevin12345Mc: posts the ante 8
ghettosunrise: posts the ante 8
sontz88: posts the ante 8
PaulaZaranec: posts the ante 8
zagi2409: posts the ante 8
marceloprj: posts the ante 8
Svechnik322: posts the ante 8
dideus94: posts the ante 8
PaulaZaranec: posts small blind 25
zagi2409: posts big blind 50
*** HOLE CARDS ***
Dealt to Kevin12345Mc [7c 4h]
marceloprj: folds 
Svechnik322: folds 
dideus94: folds 
Kevin12345Mc: folds 
ghettosunrise: folds 
sontz88: folds 
PaulaZaranec: raises 100 to 150
zagi2409: calls 100
*** FLOP *** [Qd Jc As]
PaulaZaranec: bets 200
zagi2409: folds 
Uncalled bet (200) returned to PaulaZaranec
PaulaZaranec collected 364 from pot
PaulaZaranec: doesn't show hand 
*** SUMMARY ***
Total pot 364 | Rake 0 
Board [Qd Jc As]
Seat 1: Kevin12345Mc folded before Flop (didn't bet)
Seat 2: ghettosunrise folded before Flop (didn't bet)
Seat 3: sontz88 (button) folded before Flop (didn't bet)
Seat 4: PaulaZaranec (small blind) collected (364)
Seat 5: zagi2409 (big blind) folded on the Flop
Seat 6: marceloprj folded before Flop (didn't bet)
Seat 7: Svechnik322 folded before Flop (didn't bet)
Seat 8: dideus94 folded before Flop (didn't bet)



PokerStars Hand #255105636600: Tournament #3862890532, $4.80+$5.00+$1.20 USD Hold'em No Limit - Level I (25/50) - 2025/03/02 16:32:12 WET [2025/03/02 11:32:12 ET]
Table '3862890532 160' 8-max Seat #4 is the button
Seat 1: Kevin12345Mc (4968 in chips, $5 bounty) 
Seat 2: ghettosunrise (4507 in chips, $5 bounty) 
Seat 3: sontz88 (4901 in chips, $5 bounty) 
Seat 4: PaulaZaranec (5040 in chips, $5 bounty) 
Seat 5: zagi2409 (5616 in chips, $5 bounty) 
Seat 7: Svechnik322 (5354 in chips, $5 bounty) 
Seat 8: dideus94 (4984 in chips, $5 bounty) 
Kevin12345Mc: posts the ante 8
ghettosunrise: posts the ante 8
sontz88: posts the ante 8
PaulaZaranec: posts the ante 8
zagi2409: posts the ante 8
Svechnik322: posts the ante 8
dideus94: posts the ante 8
zagi2409: posts small blind 25
Svechnik322: posts big blind 50
*** HOLE CARDS ***
Dealt to Kevin12345Mc [3s Kd]
dideus94: folds 
Kevin12345Mc: folds 
ghettosunrise: folds 
sontz88: folds 
PaulaZaranec: folds 
zagi2409: folds 
Uncalled bet (25) returned to Svechnik322
Svechnik322 collected 106 from pot
Svechnik322: doesn't show hand 
*** SUMMARY ***
Total pot 106 | Rake 0 
Seat 1: Kevin12345Mc folded before Flop (didn't bet)
Seat 2: ghettosunrise folded before Flop (didn't bet)
Seat 3: sontz88 folded before Flop (didn't bet)
Seat 4: PaulaZaranec (button) folded before Flop (didn't bet)
Seat 5: zagi2409 (small blind) folded before Flop
Seat 7: Svechnik322 (big blind) collected (106)
Seat 8: dideus94 folded before Flop (didn't bet)



PokerStars Hand #255105644163: Tournament #3862890532, $4.80+$5.00+$1.20 USD Hold'em No Limit - Level I (25/50) - 2025/03/02 16:32:40 WET [2025/03/02 11:32:40 ET]
Table '3862890532 160' 8-max Seat #5 is the button
Seat 1: Kevin12345Mc (4960 in chips, $5 bounty) 
Seat 2: ghettosunrise (4499 in chips, $5 bounty) 
Seat 3: sontz88 (4893 in chips, $5 bounty) 
Seat 4: PaulaZaranec (5032 in chips, $5 bounty) 
Seat 5: zagi2409 (5583 in chips, $5 bounty) 
Seat 6: pitt7675 (5000 in chips) out of hand (moved from another table into small blind)
Seat 7: Svechnik322 (5427 in chips, $5 bounty) 
Seat 8: dideus94 (4976 in chips, $5 bounty) 
pitt7675 will be allowed to play after the button
Kevin12345Mc: posts the ante 8
ghettosunrise: posts the ante 8
sontz88: posts the ante 8
PaulaZaranec: posts the ante 8
zagi2409: posts the ante 8
Svechnik322: posts the ante 8
dideus94: posts the ante 8
Svechnik322: posts small blind 25
dideus94: posts big blind 50
*** HOLE CARDS ***
Dealt to Kevin12345Mc [5h 5d]
Kevin12345Mc: raises 65 to 115
ghettosunrise: folds 
sontz88: folds 
PaulaZaranec: folds 
zagi2409: raises 361 to 476
Svechnik322: raises 874 to 1350
dideus94: folds 
Kevin12345Mc: folds 
zagi2409: calls 874
*** FLOP *** [Js 6h 6s]
Svechnik322: bets 750
zagi2409: raises 750 to 1500
Svechnik322: raises 2569 to 4069 and is all-in
zagi2409: calls 2569
*** TURN *** [Js 6h 6s] [5c]
*** RIVER *** [Js 6h 6s 5c] [9h]
*** SHOW DOWN ***
Svechnik322: shows [Ah Ad] (two pair, Aces and Sixes)
zagi2409: shows [4d 6d] (three of a kind, Sixes)
zagi2409 collected 11059 from pot
zagi2409 wins $2.50 for eliminating Svechnik322 and their own bounty increases by $2.50 to $7.50
Svechnik322 finished the tournament
*** SUMMARY ***
Total pot 11059 | Rake 0 
Board [Js 6h 6s 5c 9h]
Seat 1: Kevin12345Mc folded before Flop
Seat 2: ghettosunrise folded before Flop (didn't bet)
Seat 3: sontz88 folded before Flop (didn't bet)
Seat 4: PaulaZaranec folded before Flop (didn't bet)
Seat 5: zagi2409 (button) showed [4d 6d] and won (11059) with three of a kind, Sixes
Seat 7: Svechnik322 (small blind) showed [Ah Ad] and lost with two pair, Aces and Sixes
Seat 8: dideus94 (big blind) folded before Flop



PokerStars Hand #255105663140: Tournament #3862890532, $4.80+$5.00+$1.20 USD Hold'em No Limit - Level I (25/50) - 2025/03/02 16:33:50 WET [2025/03/02 11:33:50 ET]
Table '3862890532 160' 8-max Seat #8 is the button
Seat 1: Kevin12345Mc (4837 in chips, $5 bounty) 
Seat 2: ghettosunrise (4491 in chips, $5 bounty) 
Seat 3: sontz88 (4885 in chips, $5 bounty) 
Seat 4: PaulaZaranec (5024 in chips, $5 bounty) 
Seat 5: zagi2409 (11215 in chips, $7.50 bounty) 
Seat 6: pitt7675 (5000 in chips, $5 bounty) 
Seat 8: dideus94 (4918 in chips, $5 bounty) 
Kevin12345Mc: posts the ante 8
ghettosunrise: posts the ante 8
sontz88: posts the ante 8
PaulaZaranec: posts the ante 8
zagi2409: posts the ante 8
pitt7675: posts the ante 8
dideus94: posts the ante 8
Kevin12345Mc: posts small blind 25
ghettosunrise: posts big blind 50
*** HOLE CARDS ***
Dealt to Kevin12345Mc [8d 2c]
sontz88: folds 
PaulaZaranec: folds 
zagi2409: folds 
pitt7675: raises 4942 to 4992 and is all-in
dideus94: folds 
Kevin12345Mc: folds 
ghettosunrise: folds 
Uncalled bet (4942) returned to pitt7675
pitt7675 collected 181 from pot
pitt7675: doesn't show hand 
*** SUMMARY ***
Total pot 181 | Rake 0 
Seat 1: Kevin12345Mc (small blind) folded before Flop
Seat 2: ghettosunrise (big blind) folded before Flop
Seat 3: sontz88 folded before Flop (didn't bet)
Seat 4: PaulaZaranec folded before Flop (didn't bet)
Seat 5: zagi2409 folded before Flop (didn't bet)
Seat 6: pitt7675 collected (181)
Seat 8: dideus94 (button) folded before Flop (didn't bet)



PokerStars Hand #255105671771: Tournament #3862890532, $4.80+$5.00+$1.20 USD Hold'em No Limit - Level I (25/50) - 2025/03/02 16:34:22 WET [2025/03/02 11:34:22 ET]
Table '3862890532 160' 8-max Seat #1 is the button
Seat 1: Kevin12345Mc (4804 in chips, $5 bounty) 
Seat 2: ghettosunrise (4433 in chips, $5 bounty) 
Seat 3: sontz88 (4877 in chips, $5 bounty) 
Seat 4: PaulaZaranec (5016 in chips, $5 bounty) 
Seat 5: zagi2409 (11207 in chips, $7.50 bounty) 
Seat 6: pitt7675 (5123 in chips, $5 bounty) 
Seat 7: Gambz93 (5000 in chips, $5 bounty) 
Seat 8: dideus94 (4910 in chips, $5 bounty) 
Kevin12345Mc: posts the ante 8
ghettosunrise: posts the ante 8
sontz88: posts the ante 8
PaulaZaranec: posts the ante 8
zagi2409: posts the ante 8
pitt7675: posts the ante 8
Gambz93: posts the ante 8
dideus94: posts the ante 8
ghettosunrise: posts small blind 25
sontz88: posts big blind 50
*** HOLE CARDS ***
Dealt to Kevin12345Mc [Jd Tc]
PaulaZaranec: folds 
zagi2409: calls 50
pitt7675: folds 
Gambz93: raises 50 to 100
dideus94: folds 
Kevin12345Mc: folds 
ghettosunrise: folds 
sontz88: calls 50
zagi2409: calls 50
*** FLOP *** [Kh Th Jh]
sontz88: checks 
zagi2409: checks 
Gambz93: checks 
*** TURN *** [Kh Th Jh] [9d]
sontz88: checks 
zagi2409: checks 
Gambz93: bets 150
sontz88: folds 
zagi2409: folds 
Uncalled bet (150) returned to Gambz93
Gambz93 collected 389 from pot
*** SUMMARY ***
Total pot 389 | Rake 0 
Board [Kh Th Jh 9d]
Seat 1: Kevin12345Mc (button) folded before Flop (didn't bet)
Seat 2: ghettosunrise (small blind) folded before Flop
Seat 3: sontz88 (big blind) folded on the Turn
Seat 4: PaulaZaranec folded before Flop (didn't bet)
Seat 5: zagi2409 folded on the Turn
Seat 6: pitt7675 folded before Flop (didn't bet)
Seat 7: Gambz93 collected (389)
Seat 8: dideus94 folded before Flop (didn't bet)



PokerStars Hand #255105691501: Tournament #3862890532, $4.80+$5.00+$1.20 USD Hold'em No Limit - Level I (25/50) - 2025/03/02 16:35:35 WET [2025/03/02 11:35:35 ET]
Table '3862890532 160' 8-max Seat #2 is the button
Seat 1: Kevin12345Mc (4796 in chips, $5 bounty) 
Seat 2: ghettosunrise (4400 in chips, $5 bounty) 
Seat 3: sontz88 (4769 in chips, $5 bounty) 
Seat 4: PaulaZaranec (5008 in chips, $5 bounty) 
Seat 5: zagi2409 (11099 in chips, $7.50 bounty) 
Seat 6: pitt7675 (5115 in chips, $5 bounty) 
Seat 7: Gambz93 (5281 in chips, $5 bounty) 
Seat 8: dideus94 (4902 in chips, $5 bounty) 
Kevin12345Mc: posts the ante 8
ghettosunrise: posts the ante 8
sontz88: posts the ante 8
PaulaZaranec: posts the ante 8
zagi2409: posts the ante 8
pitt7675: posts the ante 8
Gambz93: posts the ante 8
dideus94: posts the ante 8
sontz88: posts small blind 25
PaulaZaranec: posts big blind 50
*** HOLE CARDS ***
Dealt to Kevin12345Mc [4h 6h]
zagi2409: folds 
pitt7675: folds 
Gambz93: folds 
dideus94: folds 
Kevin12345Mc: folds 
ghettosunrise: raises 50 to 100
sontz88: calls 75
PaulaZaranec: folds 
*** FLOP *** [As Qc 2d]
sontz88: checks 
ghettosunrise: bets 94
sontz88: calls 94
*** TURN *** [As Qc 2d] [6c]
sontz88: checks 
ghettosunrise: checks 
*** RIVER *** [As Qc 2d 6c] [Qh]
sontz88: checks 
ghettosunrise: checks 
*** SHOW DOWN ***
sontz88: shows [Td Ad] (two pair, Aces and Queens)
ghettosunrise: mucks hand 
sontz88 collected 502 from pot
*** SUMMARY ***
Total pot 502 | Rake 0 
Board [As Qc 2d 6c Qh]
Seat 1: Kevin12345Mc folded before Flop (didn't bet)
Seat 2: ghettosunrise (button) mucked [Jd Jc]
Seat 3: sontz88 (small blind) showed [Td Ad] and won (502) with two pair, Aces and Queens
Seat 4: PaulaZaranec (big blind) folded before Flop
Seat 5: zagi2409 folded before Flop (didn't bet)
Seat 6: pitt7675 folded before Flop (didn't bet)
Seat 7: Gambz93 folded before Flop (didn't bet)
Seat 8: dideus94 folded before Flop (didn't bet)



PokerStars Hand #255105708679: Tournament #3862890532, $4.80+$5.00+$1.20 USD Hold'em No Limit - Level I (25/50) - 2025/03/02 16:36:39 WET [2025/03/02 11:36:39 ET]
Table '3862890532 160' 8-max Seat #3 is the button
Seat 1: Kevin12345Mc (4788 in chips, $5 bounty) 
Seat 2: ghettosunrise (4198 in chips, $5 bounty) 
Seat 3: sontz88 (5069 in chips, $5 bounty) 
Seat 4: PaulaZaranec (4950 in chips, $5 bounty) 
Seat 5: zagi2409 (11091 in chips, $7.50 bounty) 
Seat 6: pitt7675 (5107 in chips, $5 bounty) 
Seat 7: Gambz93 (5273 in chips, $5 bounty) 
Seat 8: dideus94 (4894 in chips, $5 bounty) 
Kevin12345Mc: posts the ante 8
ghettosunrise: posts the ante 8
sontz88: posts the ante 8
PaulaZaranec: posts the ante 8
zagi2409: posts the ante 8
pitt7675: posts the ante 8
Gambz93: posts the ante 8
dideus94: posts the ante 8
PaulaZaranec: posts small blind 25
zagi2409: posts big blind 50
*** HOLE CARDS ***
Dealt to Kevin12345Mc [Qh Kd]
pitt7675: folds 
Gambz93: folds 
dideus94: folds 
Kevin12345Mc: raises 65 to 115
ghettosunrise: folds 
sontz88: calls 115
PaulaZaranec: folds 
zagi2409: calls 65
*** FLOP *** [6s 4h 3s]
zagi2409: bets 217
Kevin12345Mc: folds 
sontz88: calls 217
*** TURN *** [6s 4h 3s] [8c]
zagi2409: bets 434
sontz88: folds 
Uncalled bet (434) returned to zagi2409
zagi2409 collected 868 from pot
zagi2409: doesn't show hand 
*** SUMMARY ***
Total pot 868 | Rake 0 
Board [6s 4h 3s 8c]
Seat 1: Kevin12345Mc folded on the Flop
Seat 2: ghettosunrise folded before Flop (didn't bet)
Seat 3: sontz88 (button) folded on the Turn
Seat 4: PaulaZaranec (small blind) folded before Flop
Seat 5: zagi2409 (big blind) collected (868)
Seat 6: pitt7675 folded before Flop (didn't bet)
Seat 7: Gambz93 folded before Flop (didn't bet)
Seat 8: dideus94 folded before Flop (didn't bet)



PokerStars Hand #255105728785: Tournament #3862890532, $4.80+$5.00+$1.20 USD Hold'em No Limit - Level I (25/50) - 2025/03/02 16:37:53 WET [2025/03/02 11:37:53 ET]
Table '3862890532 160' 8-max Seat #4 is the button
Seat 1: Kevin12345Mc (4665 in chips, $5 bounty) 
Seat 2: ghettosunrise (4190 in chips, $5 bounty) 
Seat 3: sontz88 (4729 in chips, $5 bounty) 
Seat 4: PaulaZaranec (4917 in chips, $5 bounty) 
Seat 5: zagi2409 (11619 in chips, $7.50 bounty) 
Seat 6: pitt7675 (5099 in chips, $5 bounty) 
Seat 7: Gambz93 (5265 in chips, $5 bounty) 
Seat 8: dideus94 (4886 in chips, $5 bounty) 
Kevin12345Mc: posts the ante 8
ghettosunrise: posts the ante 8
sontz88: posts the ante 8
PaulaZaranec: posts the ante 8
zagi2409: posts the ante 8
pitt7675: posts the ante 8
Gambz93: posts the ante 8
dideus94: posts the ante 8
zagi2409: posts small blind 25
pitt7675: posts big blind 50
*** HOLE CARDS ***
Dealt to Kevin12345Mc [4s 9h]
Gambz93: calls 50
dideus94: folds 
Kevin12345Mc: folds 
ghettosunrise: folds 
sontz88: raises 75 to 125
PaulaZaranec: folds 
zagi2409: folds 
pitt7675: calls 75
Gambz93: calls 75
*** FLOP *** [3s 6s Qc]
pitt7675: checks 
Gambz93: checks 
sontz88: bets 200
pitt7675: calls 200
Gambz93: folds 
*** TURN *** [3s 6s Qc] [Kh]
pitt7675: checks 
sontz88: bets 406
pitt7675: calls 406
*** RIVER *** [3s 6s Qc Kh] [9d]
pitt7675: checks 
sontz88: checks 
*** SHOW DOWN ***
pitt7675: shows [Jc Qd] (a pair of Queens)
sontz88: mucks hand 
pitt7675 collected 1676 from pot
*** SUMMARY ***
Total pot 1676 | Rake 0 
Board [3s 6s Qc Kh 9d]
Seat 1: Kevin12345Mc folded before Flop (didn't bet)
Seat 2: ghettosunrise folded before Flop (didn't bet)
Seat 3: sontz88 mucked [5s 5d]
Seat 4: PaulaZaranec (button) folded before Flop (didn't bet)
Seat 5: zagi2409 (small blind) folded before Flop
Seat 6: pitt7675 (big blind) showed [Jc Qd] and won (1676) with a pair of Queens
Seat 7: Gambz93 folded on the Flop
Seat 8: dideus94 folded before Flop (didn't bet)



PokerStars Hand #255105749017: Tournament #3862890532, $4.80+$5.00+$1.20 USD Hold'em No Limit - Level II (30/60) - 2025/03/02 16:39:08 WET [2025/03/02 11:39:08 ET]
Table '3862890532 160' 8-max Seat #5 is the button
Seat 1: Kevin12345Mc (4657 in chips, $5 bounty) 
Seat 2: ghettosunrise (4182 in chips, $5 bounty) 
Seat 3: sontz88 (3990 in chips, $5 bounty) 
Seat 4: PaulaZaranec (4909 in chips, $5 bounty) 
Seat 5: zagi2409 (11586 in chips, $7.50 bounty) 
Seat 6: pitt7675 (6036 in chips, $5 bounty) 
Seat 7: Gambz93 (5132 in chips, $5 bounty) 
Seat 8: dideus94 (4878 in chips, $5 bounty) 
Kevin12345Mc: posts the ante 9
ghettosunrise: posts the ante 9
sontz88: posts the ante 9
PaulaZaranec: posts the ante 9
zagi2409: posts the ante 9
pitt7675: posts the ante 9
Gambz93: posts the ante 9
dideus94: posts the ante 9
pitt7675: posts small blind 30
Gambz93: posts big blind 60
*** HOLE CARDS ***
Dealt to Kevin12345Mc [4s Ks]
dideus94: raises 60 to 120
Kevin12345Mc: folds 
ghettosunrise: folds 
sontz88: folds 
PaulaZaranec: folds 
zagi2409: calls 120
pitt7675: calls 90
Gambz93: calls 60
*** FLOP *** [6d 4h 5h]
pitt7675: checks 
Gambz93: checks 
dideus94: checks 
zagi2409: checks 
*** TURN *** [6d 4h 5h] [Qc]
pitt7675: checks 
Gambz93: bets 120
dideus94: raises 360 to 480
zagi2409: calls 480
pitt7675: folds 
Gambz93: folds 
*** RIVER *** [6d 4h 5h Qc] [2s]
dideus94: bets 780
zagi2409: folds 
Uncalled bet (780) returned to dideus94
dideus94 collected 1632 from pot
dideus94: doesn't show hand 
*** SUMMARY ***
Total pot 1632 | Rake 0 
Board [6d 4h 5h Qc 2s]
Seat 1: Kevin12345Mc folded before Flop (didn't bet)
Seat 2: ghettosunrise folded before Flop (didn't bet)
Seat 3: sontz88 folded before Flop (didn't bet)
Seat 4: PaulaZaranec folded before Flop (didn't bet)
Seat 5: zagi2409 (button) folded on the River
Seat 6: pitt7675 (small blind) folded on the Turn
Seat 7: Gambz93 (big blind) folded on the Turn
Seat 8: dideus94 collected (1632)



PokerStars Hand #255105775967: Tournament #3862890532, $4.80+$5.00+$1.20 USD Hold'em No Limit - Level II (30/60) - 2025/03/02 16:40:48 WET [2025/03/02 11:40:48 ET]
Table '3862890532 160' 8-max Seat #6 is the button
Seat 1: Kevin12345Mc (4648 in chips, $5 bounty) 
Seat 2: ghettosunrise (4173 in chips, $5 bounty) 
Seat 3: sontz88 (3981 in chips, $5 bounty) 
Seat 4: PaulaZaranec (4900 in chips, $5 bounty) 
Seat 5: zagi2409 (10977 in chips, $7.50 bounty) 
Seat 6: pitt7675 (5907 in chips, $5 bounty) 
Seat 7: Gambz93 (4883 in chips, $5 bounty) 
Seat 8: dideus94 (5901 in chips, $5 bounty) 
Kevin12345Mc: posts the ante 9
ghettosunrise: posts the ante 9
sontz88: posts the ante 9
PaulaZaranec: posts the ante 9
zagi2409: posts the ante 9
pitt7675: posts the ante 9
Gambz93: posts the ante 9
dideus94: posts the ante 9
Gambz93: posts small blind 30
dideus94: posts big blind 60
*** HOLE CARDS ***
Dealt to Kevin12345Mc [Tc Ts]
Kevin12345Mc: raises 78 to 138
ghettosunrise: raises 282 to 420
sontz88: folds 
PaulaZaranec: folds 
zagi2409: calls 420
pitt7675: folds 
Gambz93: calls 390
dideus94: folds 
Kevin12345Mc: calls 282
*** FLOP *** [6d 8h 2c]
Gambz93: checks 
Kevin12345Mc: checks 
ghettosunrise: checks 
zagi2409: bets 906
Gambz93: folds 
Kevin12345Mc: calls 906
ghettosunrise: folds 
*** TURN *** [6d 8h 2c] [5c]
Kevin12345Mc: checks 
zagi2409: bets 3624
Kevin12345Mc: calls 3313 and is all-in
Uncalled bet (311) returned to zagi2409
*** RIVER *** [6d 8h 2c 5c] [Jh]
*** SHOW DOWN ***
Kevin12345Mc: shows [Tc Ts] (a pair of Tens)
zagi2409: shows [8c 6c] (two pair, Eights and Sixes)
zagi2409 collected 10250 from pot
zagi2409 wins $2.50 for eliminating Kevin12345Mc and their own bounty increases by $2.50 to $10
Kevin12345Mc finished the tournament
*** SUMMARY ***
Total pot 10250 | Rake 0 
Board [6d 8h 2c 5c Jh]
Seat 1: Kevin12345Mc showed [Tc Ts] and lost with a pair of Tens
Seat 2: ghettosunrise folded on the Flop
Seat 3: sontz88 folded before Flop (didn't bet)
Seat 4: PaulaZaranec folded before Flop (didn't bet)
Seat 5: zagi2409 showed [8c 6c] and won (10250) with two pair, Eights and Sixes
Seat 6: pitt7675 (button) folded before Flop (didn't bet)
Seat 7: Gambz93 (small blind) folded on the Flop
Seat 8: dideus94 (big blind) folded before Flop



PokerStars Hand #255105825272: Tournament #3862890532, $4.80+$5.00+$1.20 USD Hold'em No Limit - Level II (30/60) - 2025/03/02 16:43:50 WET [2025/03/02 11:43:50 ET]
Table '3862890532 246' 8-max Seat #2 is the button
Seat 1: noodles0712 (4883 in chips, $5 bounty) 
Seat 2: Lukie99 (4961 in chips, $5 bounty) 
Seat 3: pszegryw (5414 in chips, $5 bounty) 
Seat 4: loseonteturn (4916 in chips, $5 bounty) 
Seat 5: David peixe (7364 in chips, $5 bounty) 
Seat 6: xmen358 (4628 in chips, $5 bounty) 
Seat 7: Gomma133 (5000 in chips, $5 bounty) 
Seat 8: Kevin12345Mc (5000 in chips, $5 bounty) 
noodles0712: posts the ante 9
Lukie99: posts the ante 9
pszegryw: posts the ante 9
loseonteturn: posts the ante 9
David peixe: posts the ante 9
xmen358: posts the ante 9
Gomma133: posts the ante 9
Kevin12345Mc: posts the ante 9
pszegryw: posts small blind 30
loseonteturn: posts big blind 60
*** HOLE CARDS ***
Dealt to Kevin12345Mc [As Ks]
David peixe: raises 90 to 150
xmen358: calls 150
Gomma133: folds 
Kevin12345Mc: raises 450 to 600
noodles0712: folds 
Lukie99: folds 
pszegryw: folds 
loseonteturn: folds 
David peixe: folds 
xmen358: calls 450
*** FLOP *** [5c Ad 9d]
xmen358: checks 
Kevin12345Mc: bets 499
xmen358: folds 
Uncalled bet (499) returned to Kevin12345Mc
Kevin12345Mc collected 1512 from pot
Kevin12345Mc: doesn't show hand 
*** SUMMARY ***
Total pot 1512 | Rake 0 
Board [5c Ad 9d]
Seat 1: noodles0712 folded before Flop (didn't bet)
Seat 2: Lukie99 (button) folded before Flop (didn't bet)
Seat 3: pszegryw (small blind) folded before Flop
Seat 4: loseonteturn (big blind) folded before Flop
Seat 5: David peixe folded before Flop
Seat 6: xmen358 folded on the Flop
Seat 7: Gomma133 folded before Flop (didn't bet)
Seat 8: Kevin12345Mc collected (1512)



PokerStars Hand #255105842267: Tournament #3862890532, $4.80+$5.00+$1.20 USD Hold'em No Limit - Level II (30/60) - 2025/03/02 16:44:52 WET [2025/03/02 11:44:52 ET]
Table '3862890532 246' 8-max Seat #3 is the button
Seat 1: noodles0712 (4874 in chips, $5 bounty) 
Seat 2: Lukie99 (4952 in chips, $5 bounty) 
Seat 3: pszegryw (5375 in chips, $5 bounty) 
Seat 4: loseonteturn (4847 in chips, $5 bounty) 
Seat 5: David peixe (7205 in chips, $5 bounty) 
Seat 6: xmen358 (4019 in chips, $5 bounty) 
Seat 7: Gomma133 (4991 in chips, $5 bounty) 
Seat 8: Kevin12345Mc (5903 in chips, $5 bounty) 
noodles0712: posts the ante 9
Lukie99: posts the ante 9
pszegryw: posts the ante 9
loseonteturn: posts the ante 9
David peixe: posts the ante 9
xmen358: posts the ante 9
Gomma133: posts the ante 9
Kevin12345Mc: posts the ante 9
loseonteturn: posts small blind 30
David peixe: posts big blind 60
*** HOLE CARDS ***
Dealt to Kevin12345Mc [Jc 8s]
xmen358: folds 
Gomma133: raises 120 to 180
Kevin12345Mc: folds 
noodles0712: calls 180
Lukie99: folds 
pszegryw: folds 
loseonteturn: folds 
David peixe: folds 
*** FLOP *** [Kd Th 3d]
Gomma133: checks 
noodles0712: checks 
*** TURN *** [Kd Th 3d] [4c]
Gomma133: bets 240
noodles0712: calls 240
*** RIVER *** [Kd Th 3d 4c] [Td]
Gomma133: checks 
noodles0712: bets 480
Gomma133: raises 4082 to 4562 and is all-in
noodles0712: calls 3965 and is all-in
Uncalled bet (117) returned to Gomma133
*** SHOW DOWN ***
Gomma133: shows [Kh Kc] (a full house, Kings full of Tens)
noodles0712: shows [8d 6d] (a flush, King high)
Gomma133 collected 9892 from pot
Gomma133 wins $2.50 for eliminating noodles0712 and their own bounty increases by $2.50 to $7.50
noodles0712 finished the tournament
*** SUMMARY ***
Total pot 9892 | Rake 0 
Board [Kd Th 3d 4c Td]
Seat 1: noodles0712 showed [8d 6d] and lost with a flush, King high
Seat 2: Lukie99 folded before Flop (didn't bet)
Seat 3: pszegryw (button) folded before Flop (didn't bet)
Seat 4: loseonteturn (small blind) folded before Flop
Seat 5: David peixe (big blind) folded before Flop
Seat 6: xmen358 folded before Flop (didn't bet)
Seat 7: Gomma133 showed [Kh Kc] and won (9892) with a full house, Kings full of Tens
Seat 8: Kevin12345Mc folded before Flop (didn't bet)



PokerStars Hand #255105862930: Tournament #3862890532, $4.80+$5.00+$1.20 USD Hold'em No Limit - Level III (35/70) - 2025/03/02 16:46:09 WET [2025/03/02 11:46:09 ET]
Table '3862890532 246' 8-max Seat #4 is the button
Seat 2: Lukie99 (4943 in chips, $5 bounty) 
Seat 3: pszegryw (5366 in chips, $5 bounty) 
Seat 4: loseonteturn (4808 in chips, $5 bounty) 
Seat 5: David peixe (7136 in chips, $5 bounty) 
Seat 6: xmen358 (4010 in chips, $5 bounty) 
Seat 7: Gomma133 (10009 in chips, $7.50 bounty) 
Seat 8: Kevin12345Mc (5894 in chips, $5 bounty) 
Lukie99: posts the ante 11
pszegryw: posts the ante 11
loseonteturn: posts the ante 11
David peixe: posts the ante 11
xmen358: posts the ante 11
Gomma133: posts the ante 11
Kevin12345Mc: posts the ante 11
David peixe: posts small blind 35
xmen358: posts big blind 70
*** HOLE CARDS ***
Dealt to Kevin12345Mc [7c 2d]
Gomma133: raises 70 to 140
Kevin12345Mc: folds 
Lukie99: folds 
pszegryw: folds 
loseonteturn: calls 140
David peixe: folds 
xmen358: calls 70
*** FLOP *** [4h 4c 6h]
xmen358: checks 
Gomma133: checks 
loseonteturn: checks 
*** TURN *** [4h 4c 6h] [6d]
xmen358: checks 
Gomma133: checks 
loseonteturn: bets 350
xmen358: folds 
Gomma133: folds 
Uncalled bet (350) returned to loseonteturn
loseonteturn collected 532 from pot
loseonteturn: doesn't show hand 
*** SUMMARY ***
Total pot 532 | Rake 0 
Board [4h 4c 6h 6d]
Seat 2: Lukie99 folded before Flop (didn't bet)
Seat 3: pszegryw folded before Flop (didn't bet)
Seat 4: loseonteturn (button) collected (532)
Seat 5: David peixe (small blind) folded before Flop
Seat 6: xmen358 (big blind) folded on the Turn
Seat 7: Gomma133 folded on the Turn
Seat 8: Kevin12345Mc folded before Flop (didn't bet)



PokerStars Hand #255105884747: Tournament #3862890532, $4.80+$5.00+$1.20 USD Hold'em No Limit - Level III (35/70) - 2025/03/02 16:47:28 WET [2025/03/02 11:47:28 ET]
Table '3862890532 246' 8-max Seat #5 is the button
Seat 1: Gbenj49 (5000 in chips, $5 bounty) 
Seat 2: Lukie99 (4932 in chips, $5 bounty) 
Seat 3: pszegryw (5355 in chips, $5 bounty) 
Seat 4: loseonteturn (5189 in chips, $5 bounty) 
Seat 5: David peixe (7090 in chips, $5 bounty) 
Seat 6: xmen358 (3859 in chips, $5 bounty) 
Seat 7: Gomma133 (9858 in chips, $7.50 bounty) 
Seat 8: Kevin12345Mc (5883 in chips, $5 bounty) 
Gbenj49: posts the ante 11
Lukie99: posts the ante 11
pszegryw: posts the ante 11
loseonteturn: posts the ante 11
David peixe: posts the ante 11
xmen358: posts the ante 11
Gomma133: posts the ante 11
Kevin12345Mc: posts the ante 11
xmen358: posts small blind 35
Gomma133: posts big blind 70
*** HOLE CARDS ***
Dealt to Kevin12345Mc [5c 7h]
Kevin12345Mc: folds 
Gbenj49: folds 
Lukie99: folds 
pszegryw: raises 78 to 148
loseonteturn: folds 
David peixe: calls 148
xmen358: folds 
Gomma133: folds 
*** FLOP *** [Ah Ts Jc]
pszegryw: bets 245
David peixe: calls 245
*** TURN *** [Ah Ts Jc] [3h]
pszegryw: checks 
David peixe: bets 665
pszegryw: folds 
Uncalled bet (665) returned to David peixe
David peixe collected 979 from pot
David peixe: doesn't show hand 
*** SUMMARY ***
Total pot 979 | Rake 0 
Board [Ah Ts Jc 3h]
Seat 1: Gbenj49 folded before Flop (didn't bet)
Seat 2: Lukie99 folded before Flop (didn't bet)
Seat 3: pszegryw folded on the Turn
Seat 4: loseonteturn folded before Flop (didn't bet)
Seat 5: David peixe (button) collected (979)
Seat 6: xmen358 (small blind) folded before Flop
Seat 7: Gomma133 (big blind) folded before Flop
Seat 8: Kevin12345Mc folded before Flop (didn't bet)



PokerStars Hand #255105900921: Tournament #3862890532, $4.80+$5.00+$1.20 USD Hold'em No Limit - Level III (35/70) - 2025/03/02 16:48:28 WET [2025/03/02 11:48:28 ET]
Table '3862890532 246' 8-max Seat #6 is the button
Seat 1: Gbenj49 (4989 in chips, $5 bounty) 
Seat 3: pszegryw (4951 in chips, $5 bounty) 
Seat 4: loseonteturn (5178 in chips, $5 bounty) 
Seat 5: David peixe (7665 in chips, $5 bounty) 
Seat 6: xmen358 (3813 in chips, $5 bounty) 
Seat 7: Gomma133 (9777 in chips, $7.50 bounty) 
Seat 8: Kevin12345Mc (5872 in chips, $5 bounty) 
Gbenj49: posts the ante 11
pszegryw: posts the ante 11
loseonteturn: posts the ante 11
David peixe: posts the ante 11
xmen358: posts the ante 11
Gomma133: posts the ante 11
Kevin12345Mc: posts the ante 11
Gomma133: posts small blind 35
Kevin12345Mc: posts big blind 70
*** HOLE CARDS ***
Dealt to Kevin12345Mc [9d Kh]
Gbenj49: raises 70 to 140
pszegryw: folds 
loseonteturn: folds 
David peixe: folds 
xmen358: folds 
Gomma133: folds 
A5632 is disconnected 
Kevin12345Mc: calls 70
*** FLOP *** [Kd 9s 8d]
Kevin12345Mc: checks 
Gbenj49: checks 
*** TURN *** [Kd 9s 8d] [7c]
Kevin12345Mc: bets 259
Gbenj49: folds 
Uncalled bet (259) returned to Kevin12345Mc
Kevin12345Mc collected 392 from pot
Kevin12345Mc: doesn't show hand 
*** SUMMARY ***
Total pot 392 | Rake 0 
Board [Kd 9s 8d 7c]
Seat 1: Gbenj49 folded on the Turn
Seat 3: pszegryw folded before Flop (didn't bet)
Seat 4: loseonteturn folded before Flop (didn't bet)
Seat 5: David peixe folded before Flop (didn't bet)
Seat 6: xmen358 (button) folded before Flop (didn't bet)
Seat 7: Gomma133 (small blind) folded before Flop
Seat 8: Kevin12345Mc (big blind) collected (392)



PokerStars Hand #255105906561: Tournament #3862890532, $4.80+$5.00+$1.20 USD Hold'em No Limit - Level III (35/70) - 2025/03/02 16:48:48 WET [2025/03/02 11:48:48 ET]
Table '3862890532 246' 8-max Seat #7 is the button
Seat 2: A5632 (5000 in chips, $5 bounty) 
Seat 3: pszegryw (4940 in chips, $5 bounty) 
Seat 4: loseonteturn (5167 in chips, $5 bounty) 
Seat 5: David peixe (7654 in chips, $5 bounty) 
Seat 6: xmen358 (3802 in chips, $5 bounty) 
Seat 7: Gomma133 (9731 in chips, $7.50 bounty) 
Seat 8: Kevin12345Mc (6113 in chips, $5 bounty) 
A5632: posts the ante 11
pszegryw: posts the ante 11
loseonteturn: posts the ante 11
David peixe: posts the ante 11
xmen358: posts the ante 11
Gomma133: posts the ante 11
Kevin12345Mc: posts the ante 11
Kevin12345Mc: posts small blind 35
A5632: posts big blind 70
*** HOLE CARDS ***
Dealt to Kevin12345Mc [Kd 3s]
pszegryw: folds 
CL0D0MIR0D is disconnected 
loseonteturn: folds 
David peixe: folds 
xmen358: folds 
Gomma133: raises 70 to 140
Kevin12345Mc: folds 
A5632: folds 
Uncalled bet (70) returned to Gomma133
Gomma133 collected 252 from pot
Gomma133: doesn't show hand 
*** SUMMARY ***
Total pot 252 | Rake 0 
Seat 2: A5632 (big blind) folded before Flop
Seat 3: pszegryw folded before Flop (didn't bet)
Seat 4: loseonteturn folded before Flop (didn't bet)
Seat 5: David peixe folded before Flop (didn't bet)
Seat 6: xmen358 folded before Flop (didn't bet)
Seat 7: Gomma133 (button) collected (252)
Seat 8: Kevin12345Mc (small blind) folded before Flop



PokerStars Hand #255105913473: Tournament #3862890532, $4.80+$5.00+$1.20 USD Hold'em No Limit - Level III (35/70) - 2025/03/02 16:49:13 WET [2025/03/02 11:49:13 ET]
Table '3862890532 246' 8-max Seat #8 is the button
Seat 1: CL0D0MIR0D (5000 in chips) out of hand (moved from another table into small blind)
Seat 2: A5632 (4919 in chips, $5 bounty) 
Seat 3: pszegryw (4929 in chips, $5 bounty) 
Seat 4: loseonteturn (5156 in chips, $5 bounty) 
Seat 5: David peixe (7643 in chips, $5 bounty) 
Seat 6: xmen358 (3791 in chips, $5 bounty) 
Seat 7: Gomma133 (9902 in chips, $7.50 bounty) 
Seat 8: Kevin12345Mc (6067 in chips, $5 bounty) 
CL0D0MIR0D will be allowed to play after the button
A5632: posts the ante 11
pszegryw: posts the ante 11
loseonteturn: posts the ante 11
David peixe: posts the ante 11
xmen358: posts the ante 11
Gomma133: posts the ante 11
Kevin12345Mc: posts the ante 11
A5632: posts small blind 35
pszegryw: posts big blind 70
*** HOLE CARDS ***
Dealt to Kevin12345Mc [Ad Ts]
loseonteturn: folds 
David peixe: folds 
xmen358: folds 
Gomma133: folds 
Kevin12345Mc: raises 91 to 161
A5632: folds 
pszegryw: folds 
Uncalled bet (91) returned to Kevin12345Mc
Kevin12345Mc collected 252 from pot
Kevin12345Mc: doesn't show hand 
*** SUMMARY ***
Total pot 252 | Rake 0 
Seat 2: A5632 (small blind) folded before Flop
Seat 3: pszegryw (big blind) folded before Flop
Seat 4: loseonteturn folded before Flop (didn't bet)
Seat 5: David peixe folded before Flop (didn't bet)
Seat 6: xmen358 folded before Flop (didn't bet)
Seat 7: Gomma133 folded before Flop (didn't bet)
Seat 8: Kevin12345Mc (button) collected (252)



PokerStars Hand #255105918172: Tournament #3862890532, $4.80+$5.00+$1.20 USD Hold'em No Limit - Level III (35/70) - 2025/03/02 16:49:31 WET [2025/03/02 11:49:31 ET]
Table '3862890532 246' 8-max Seat #2 is the button
Seat 1: CL0D0MIR0D (5000 in chips, $5 bounty) 
Seat 2: A5632 (4873 in chips, $5 bounty) 
Seat 3: pszegryw (4848 in chips, $5 bounty) 
Seat 4: loseonteturn (5145 in chips, $5 bounty) 
Seat 5: David peixe (7632 in chips, $5 bounty) 
Seat 6: xmen358 (3780 in chips, $5 bounty) 
Seat 7: Gomma133 (9891 in chips, $7.50 bounty) 
Seat 8: Kevin12345Mc (6238 in chips, $5 bounty) 
CL0D0MIR0D: posts the ante 11
A5632: posts the ante 11
pszegryw: posts the ante 11
loseonteturn: posts the ante 11
David peixe: posts the ante 11
xmen358: posts the ante 11
Gomma133: posts the ante 11
Kevin12345Mc: posts the ante 11
pszegryw: posts small blind 35
loseonteturn: posts big blind 70
*** HOLE CARDS ***
Dealt to Kevin12345Mc [Jh 5c]
David peixe: folds 
xmen358: folds 
Gomma133: folds 
Kevin12345Mc: folds 
CL0D0MIR0D: raises 84 to 154
A5632: folds 
pszegryw: calls 119
loseonteturn: calls 84
*** FLOP *** [Kc 4c Td]
pszegryw: checks 
loseonteturn: checks 
CL0D0MIR0D: bets 176
pszegryw: folds 
loseonteturn: calls 176
*** TURN *** [Kc 4c Td] [7s]
loseonteturn: checks 
CL0D0MIR0D: bets 695
loseonteturn: calls 695
*** RIVER *** [Kc 4c Td 7s] [4d]
loseonteturn: checks 
CL0D0MIR0D: checks 
*** SHOW DOWN ***
loseonteturn: shows [Th 9d] (two pair, Tens and Fours)
CL0D0MIR0D: mucks hand 
loseonteturn collected 2292 from pot
*** SUMMARY ***
Total pot 2292 | Rake 0 
Board [Kc 4c Td 7s 4d]
Seat 1: CL0D0MIR0D mucked [Ad 3h]
Seat 2: A5632 (button) folded before Flop (didn't bet)
Seat 3: pszegryw (small blind) folded on the Flop
Seat 4: loseonteturn (big blind) showed [Th 9d] and won (2292) with two pair, Tens and Fours
Seat 5: David peixe folded before Flop (didn't bet)
Seat 6: xmen358 folded before Flop (didn't bet)
Seat 7: Gomma133 folded before Flop (didn't bet)
Seat 8: Kevin12345Mc folded before Flop (didn't bet)



PokerStars Hand #255105957031: Tournament #3862890532, $4.80+$5.00+$1.20 USD Hold'em No Limit - Level III (35/70) - 2025/03/02 16:51:53 WET [2025/03/02 11:51:53 ET]
Table '3862890532 246' 8-max Seat #3 is the button
Seat 1: CL0D0MIR0D (3964 in chips, $5 bounty) 
Seat 2: A5632 (4862 in chips, $5 bounty) 
Seat 3: pszegryw (4683 in chips, $5 bounty) 
Seat 4: loseonteturn (6401 in chips, $5 bounty) 
Seat 5: David peixe (7621 in chips, $5 bounty) 
Seat 6: xmen358 (3769 in chips, $5 bounty) 
Seat 7: Gomma133 (9880 in chips, $7.50 bounty) 
Seat 8: Kevin12345Mc (6227 in chips, $5 bounty) 
CL0D0MIR0D: posts the ante 11
A5632: posts the ante 11
pszegryw: posts the ante 11
loseonteturn: posts the ante 11
David peixe: posts the ante 11
xmen358: posts the ante 11
Gomma133: posts the ante 11
Kevin12345Mc: posts the ante 11
loseonteturn: posts small blind 35
David peixe: posts big blind 70
*** HOLE CARDS ***
Dealt to Kevin12345Mc [Ad Ks]
xmen358: folds 
Gomma133: folds 
Kevin12345Mc: raises 91 to 161
CL0D0MIR0D: calls 161
A5632: folds 
pszegryw: calls 161
loseonteturn: calls 126
David peixe: calls 91
*** FLOP *** [5h Qh Th]
loseonteturn: checks 
David peixe: checks 
Kevin12345Mc: checks 
CL0D0MIR0D: bets 280
pszegryw: folds 
loseonteturn: folds 
David peixe: calls 280
Kevin12345Mc: folds 
*** TURN *** [5h Qh Th] [8h]
David peixe: checks 
CL0D0MIR0D: bets 555
David peixe: raises 555 to 1110
CL0D0MIR0D: calls 555
*** RIVER *** [5h Qh Th 8h] [5c]
David peixe: bets 6059 and is all-in
CL0D0MIR0D: folds 
Uncalled bet (6059) returned to David peixe
David peixe collected 3673 from pot
David peixe: doesn't show hand 
*** SUMMARY ***
Total pot 3673 | Rake 0 
Board [5h Qh Th 8h 5c]
Seat 1: CL0D0MIR0D folded on the River
Seat 2: A5632 folded before Flop (didn't bet)
Seat 3: pszegryw (button) folded on the Flop
Seat 4: loseonteturn (small blind) folded on the Flop
Seat 5: David peixe (big blind) collected (3673)
Seat 6: xmen358 folded before Flop (didn't bet)
Seat 7: Gomma133 folded before Flop (didn't bet)
Seat 8: Kevin12345Mc folded on the Flop



PokerStars Hand #255105982577: Tournament #3862890532, $4.80+$5.00+$1.20 USD Hold'em No Limit - Level III (35/70) - 2025/03/02 16:53:27 WET [2025/03/02 11:53:27 ET]
Table '3862890532 246' 8-max Seat #4 is the button
Seat 1: CL0D0MIR0D (2402 in chips, $5 bounty) 
Seat 2: A5632 (4851 in chips, $5 bounty) 
Seat 3: pszegryw (4511 in chips, $5 bounty) 
Seat 4: loseonteturn (6229 in chips, $5 bounty) 
Seat 5: David peixe (9732 in chips, $5 bounty) 
Seat 6: xmen358 (3758 in chips, $5 bounty) 
Seat 7: Gomma133 (9869 in chips, $7.50 bounty) 
Seat 8: Kevin12345Mc (6055 in chips, $5 bounty) 
CL0D0MIR0D: posts the ante 11
A5632: posts the ante 11
pszegryw: posts the ante 11
loseonteturn: posts the ante 11
David peixe: posts the ante 11
xmen358: posts the ante 11
Gomma133: posts the ante 11
Kevin12345Mc: posts the ante 11
David peixe: posts small blind 35
xmen358: posts big blind 70
*** HOLE CARDS ***
Dealt to Kevin12345Mc [7c Qs]
Gomma133: raises 70 to 140
Kevin12345Mc: folds 
CL0D0MIR0D: folds 
A5632: raises 280 to 420
pszegryw: folds 
loseonteturn: folds 
David peixe: folds 
xmen358: folds 
Gomma133: calls 280
*** FLOP *** [2d Kh 8c]
Gomma133: checks 
A5632: bets 362
Gomma133: folds 
Uncalled bet (362) returned to A5632
A5632 collected 1033 from pot
A5632: doesn't show hand 
*** SUMMARY ***
Total pot 1033 | Rake 0 
Board [2d Kh 8c]
Seat 1: CL0D0MIR0D folded before Flop (didn't bet)
Seat 2: A5632 collected (1033)
Seat 3: pszegryw folded before Flop (didn't bet)
Seat 4: loseonteturn (button) folded before Flop (didn't bet)
Seat 5: David peixe (small blind) folded before Flop
Seat 6: xmen358 (big blind) folded before Flop
Seat 7: Gomma133 folded on the Flop
Seat 8: Kevin12345Mc folded before Flop (didn't bet)



PokerStars Hand #255105991562: Tournament #3862890532, $4.80+$5.00+$1.20 USD Hold'em No Limit - Level IV (40/80) - 2025/03/02 16:54:00 WET [2025/03/02 11:54:00 ET]
Table '3862890532 246' 8-max Seat #5 is the button
Seat 1: CL0D0MIR0D (2391 in chips, $5 bounty) 
Seat 2: A5632 (5453 in chips, $5 bounty) 
Seat 3: pszegryw (4500 in chips, $5 bounty) 
Seat 4: loseonteturn (6218 in chips, $5 bounty) 
Seat 5: David peixe (9686 in chips, $5 bounty) 
Seat 6: xmen358 (3677 in chips, $5 bounty) 
Seat 7: Gomma133 (9438 in chips, $7.50 bounty) 
Seat 8: Kevin12345Mc (6044 in chips, $5 bounty) 
CL0D0MIR0D: posts the ante 12
A5632: posts the ante 12
pszegryw: posts the ante 12
loseonteturn: posts the ante 12
David peixe: posts the ante 12
xmen358: posts the ante 12
Gomma133: posts the ante 12
Kevin12345Mc: posts the ante 12
xmen358: posts small blind 40
Gomma133: posts big blind 80
*** HOLE CARDS ***
Dealt to Kevin12345Mc [4c 8d]
Kevin12345Mc: folds 
CL0D0MIR0D: folds 
A5632: folds 
pszegryw: folds 
loseonteturn: folds 
David peixe: folds 
xmen358: folds 
Uncalled bet (40) returned to Gomma133
Gomma133 collected 176 from pot
Gomma133: doesn't show hand 
*** SUMMARY ***
Total pot 176 | Rake 0 
Seat 1: CL0D0MIR0D folded before Flop (didn't bet)
Seat 2: A5632 folded before Flop (didn't bet)
Seat 3: pszegryw folded before Flop (didn't bet)
Seat 4: loseonteturn folded before Flop (didn't bet)
Seat 5: David peixe (button) folded before Flop (didn't bet)
Seat 6: xmen358 (small blind) folded before Flop
Seat 7: Gomma133 (big blind) collected (176)
Seat 8: Kevin12345Mc folded before Flop (didn't bet)



PokerStars Hand #255105996361: Tournament #3862890532, $4.80+$5.00+$1.20 USD Hold'em No Limit - Level IV (40/80) - 2025/03/02 16:54:18 WET [2025/03/02 11:54:18 ET]
Table '3862890532 246' 8-max Seat #6 is the button
Seat 1: CL0D0MIR0D (2379 in chips, $5 bounty) 
Seat 2: A5632 (5441 in chips, $5 bounty) 
Seat 3: pszegryw (4488 in chips, $5 bounty) 
Seat 4: loseonteturn (6206 in chips, $5 bounty) 
Seat 5: David peixe (9674 in chips, $5 bounty) 
Seat 6: xmen358 (3625 in chips, $5 bounty) 
Seat 7: Gomma133 (9562 in chips, $7.50 bounty) 
Seat 8: Kevin12345Mc (6032 in chips, $5 bounty) 
CL0D0MIR0D: posts the ante 12
A5632: posts the ante 12
pszegryw: posts the ante 12
loseonteturn: posts the ante 12
David peixe: posts the ante 12
xmen358: posts the ante 12
Gomma133: posts the ante 12
Kevin12345Mc: posts the ante 12
Gomma133: posts small blind 40
Kevin12345Mc: posts big blind 80
*** HOLE CARDS ***
Dealt to Kevin12345Mc [Js Ks]
CL0D0MIR0D: folds 
A5632: raises 96 to 176
pszegryw: folds 
loseonteturn: folds 
David peixe: folds 
xmen358: folds 
Gomma133: folds 
Kevin12345Mc: calls 96
*** FLOP *** [8c 9h 3c]
Kevin12345Mc: checks 
A5632: bets 171
Kevin12345Mc: folds 
Uncalled bet (171) returned to A5632
A5632 collected 488 from pot
A5632: doesn't show hand 
*** SUMMARY ***
Total pot 488 | Rake 0 
Board [8c 9h 3c]
Seat 1: CL0D0MIR0D folded before Flop (didn't bet)
Seat 2: A5632 collected (488)
Seat 3: pszegryw folded before Flop (didn't bet)
Seat 4: loseonteturn folded before Flop (didn't bet)
Seat 5: David peixe folded before Flop (didn't bet)
Seat 6: xmen358 (button) folded before Flop (didn't bet)
Seat 7: Gomma133 (small blind) folded before Flop
Seat 8: Kevin12345Mc (big blind) folded on the Flop



PokerStars Hand #255106006535: Tournament #3862890532, $4.80+$5.00+$1.20 USD Hold'em No Limit - Level IV (40/80) - 2025/03/02 16:54:55 WET [2025/03/02 11:54:55 ET]
Table '3862890532 246' 8-max Seat #7 is the button
Seat 1: CL0D0MIR0D (2367 in chips, $5 bounty) 
Seat 2: A5632 (5741 in chips, $5 bounty) 
Seat 3: pszegryw (4476 in chips, $5 bounty) 
Seat 4: loseonteturn (6194 in chips, $5 bounty) 
Seat 5: David peixe (9662 in chips, $5 bounty) 
Seat 6: xmen358 (3613 in chips, $5 bounty) 
Seat 7: Gomma133 (9510 in chips, $7.50 bounty) 
Seat 8: Kevin12345Mc (5844 in chips, $5 bounty) 
CL0D0MIR0D: posts the ante 12
A5632: posts the ante 12
pszegryw: posts the ante 12
loseonteturn: posts the ante 12
David peixe: posts the ante 12
xmen358: posts the ante 12
Gomma133: posts the ante 12
Kevin12345Mc: posts the ante 12
Kevin12345Mc: posts small blind 40
CL0D0MIR0D: posts big blind 80
*** HOLE CARDS ***
Dealt to Kevin12345Mc [As Qd]
A5632: folds 
pszegryw: folds 
loseonteturn: folds 
David peixe: folds 
xmen358: folds 
Gomma133: raises 80 to 160
Kevin12345Mc: raises 480 to 640
CL0D0MIR0D: folds 
Gomma133: calls 480
*** FLOP *** [Jh 7h 3d]
Kevin12345Mc: bets 480
Gomma133: folds 
Uncalled bet (480) returned to Kevin12345Mc
Kevin12345Mc collected 1456 from pot
Kevin12345Mc: doesn't show hand 
*** SUMMARY ***
Total pot 1456 | Rake 0 
Board [Jh 7h 3d]
Seat 1: CL0D0MIR0D (big blind) folded before Flop
Seat 2: A5632 folded before Flop (didn't bet)
Seat 3: pszegryw folded before Flop (didn't bet)
Seat 4: loseonteturn folded before Flop (didn't bet)
Seat 5: David peixe folded before Flop (didn't bet)
Seat 6: xmen358 folded before Flop (didn't bet)
Seat 7: Gomma133 (button) folded on the Flop
Seat 8: Kevin12345Mc (small blind) collected (1456)



PokerStars Hand #255106097884: Tournament #3862890532, $4.80+$5.00+$1.20 USD Hold'em No Limit - Level IV (40/80) - 2025/03/02 17:02:38 WET [2025/03/02 12:02:38 ET]
Table '3862890532 246' 8-max Seat #8 is the button
Seat 1: CL0D0MIR0D (2275 in chips, $5 bounty) 
Seat 2: A5632 (5729 in chips, $5 bounty) 
Seat 3: pszegryw (4464 in chips, $5 bounty) 
Seat 4: loseonteturn (6182 in chips, $5 bounty) 
Seat 5: David peixe (9650 in chips, $5 bounty) 
Seat 6: xmen358 (3601 in chips, $5 bounty) 
Seat 7: Gomma133 (8858 in chips, $7.50 bounty) 
Seat 8: Kevin12345Mc (6648 in chips, $5 bounty) 
CL0D0MIR0D: posts the ante 12
A5632: posts the ante 12
pszegryw: posts the ante 12
loseonteturn: posts the ante 12
David peixe: posts the ante 12
xmen358: posts the ante 12
Gomma133: posts the ante 12
Kevin12345Mc: posts the ante 12
CL0D0MIR0D: posts small blind 40
A5632: posts big blind 80
*** HOLE CARDS ***
Dealt to Kevin12345Mc [Td 3d]
pszegryw: folds 
loseonteturn: folds 
David peixe: folds 
xmen358: raises 80 to 160
Gomma133: folds 
Kevin12345Mc: folds 
CL0D0MIR0D: calls 120
A5632: calls 80
*** FLOP *** [7s 6s Kh]
CL0D0MIR0D: checks 
A5632: checks 
xmen358: bets 288
CL0D0MIR0D: calls 288
A5632: folds 
*** TURN *** [7s 6s Kh] [4d]
CL0D0MIR0D: checks 
xmen358: bets 1152
CL0D0MIR0D: folds 
Uncalled bet (1152) returned to xmen358
xmen358 collected 1152 from pot
xmen358: doesn't show hand 
*** SUMMARY ***
Total pot 1152 | Rake 0 
Board [7s 6s Kh 4d]
Seat 1: CL0D0MIR0D (small blind) folded on the Turn
Seat 2: A5632 (big blind) folded on the Flop
Seat 3: pszegryw folded before Flop (didn't bet)
Seat 4: loseonteturn folded before Flop (didn't bet)
Seat 5: David peixe folded before Flop (didn't bet)
Seat 6: xmen358 collected (1152)
Seat 7: Gomma133 folded before Flop (didn't bet)
Seat 8: Kevin12345Mc (button) folded before Flop (didn't bet)



PokerStars Hand #255106123986: Tournament #3862890532, $4.80+$5.00+$1.20 USD Hold'em No Limit - Level IV (40/80) - 2025/03/02 17:04:12 WET [2025/03/02 12:04:12 ET]
Table '3862890532 246' 8-max Seat #1 is the button
Seat 1: CL0D0MIR0D (1815 in chips, $5 bounty) 
Seat 2: A5632 (5557 in chips, $5 bounty) 
Seat 3: pszegryw (4452 in chips, $5 bounty) 
Seat 4: loseonteturn (6170 in chips, $5 bounty) 
Seat 5: David peixe (9638 in chips, $5 bounty) 
Seat 6: xmen358 (4293 in chips, $5 bounty) 
Seat 7: Gomma133 (8846 in chips, $7.50 bounty) 
Seat 8: Kevin12345Mc (6636 in chips, $5 bounty) 
CL0D0MIR0D: posts the ante 12
A5632: posts the ante 12
pszegryw: posts the ante 12
loseonteturn: posts the ante 12
David peixe: posts the ante 12
xmen358: posts the ante 12
Gomma133: posts the ante 12
Kevin12345Mc: posts the ante 12
A5632: posts small blind 40
pszegryw: posts big blind 80
*** HOLE CARDS ***
Dealt to Kevin12345Mc [6d Tc]
loseonteturn: folds 
David peixe: folds 
xmen358: folds 
Gomma133: folds 
Kevin12345Mc: folds 
CL0D0MIR0D: folds 
A5632: raises 160 to 240
pszegryw: folds 
Uncalled bet (160) returned to A5632
A5632 collected 256 from pot
A5632: doesn't show hand 
*** SUMMARY ***
Total pot 256 | Rake 0 
Seat 1: CL0D0MIR0D (button) folded before Flop (didn't bet)
Seat 2: A5632 (small blind) collected (256)
Seat 3: pszegryw (big blind) folded before Flop
Seat 4: loseonteturn folded before Flop (didn't bet)
Seat 5: David peixe folded before Flop (didn't bet)
Seat 6: xmen358 folded before Flop (didn't bet)
Seat 7: Gomma133 folded before Flop (didn't bet)
Seat 8: Kevin12345Mc folded before Flop (didn't bet)



PokerStars Hand #255106133823: Tournament #3862890532, $4.80+$5.00+$1.20 USD Hold'em No Limit - Level IV (40/80) - 2025/03/02 17:04:47 WET [2025/03/02 12:04:47 ET]
Table '3862890532 246' 8-max Seat #2 is the button
Seat 1: CL0D0MIR0D (1803 in chips, $5 bounty) 
Seat 2: A5632 (5721 in chips, $5 bounty) 
Seat 3: pszegryw (4360 in chips, $5 bounty) 
Seat 4: loseonteturn (6158 in chips, $5 bounty) 
Seat 5: David peixe (9626 in chips, $5 bounty) 
Seat 6: xmen358 (4281 in chips, $5 bounty) 
Seat 7: Gomma133 (8834 in chips, $7.50 bounty) 
Seat 8: Kevin12345Mc (6624 in chips, $5 bounty) 
CL0D0MIR0D: posts the ante 12
A5632: posts the ante 12
pszegryw: posts the ante 12
loseonteturn: posts the ante 12
David peixe: posts the ante 12
xmen358: posts the ante 12
Gomma133: posts the ante 12
Kevin12345Mc: posts the ante 12
pszegryw: posts small blind 40
loseonteturn: posts big blind 80
*** HOLE CARDS ***
Dealt to Kevin12345Mc [5c 7s]
David peixe: folds 
xmen358: raises 80 to 160
Gomma133: folds 
Kevin12345Mc: folds 
CL0D0MIR0D: folds 
A5632: calls 160
pszegryw: calls 120
loseonteturn: calls 80
*** FLOP *** [3c Jd 3d]
pszegryw: checks 
loseonteturn: checks 
xmen358: bets 368
A5632: folds 
pszegryw: folds 
loseonteturn: folds 
Uncalled bet (368) returned to xmen358
xmen358 collected 736 from pot
xmen358: doesn't show hand 
*** SUMMARY ***
Total pot 736 | Rake 0 
Board [3c Jd 3d]
Seat 1: CL0D0MIR0D folded before Flop (didn't bet)
Seat 2: A5632 (button) folded on the Flop
Seat 3: pszegryw (small blind) folded on the Flop
Seat 4: loseonteturn (big blind) folded on the Flop
Seat 5: David peixe folded before Flop (didn't bet)
Seat 6: xmen358 collected (736)
Seat 7: Gomma133 folded before Flop (didn't bet)
Seat 8: Kevin12345Mc folded before Flop (didn't bet)



PokerStars Hand #255106143534: Tournament #3862890532, $4.80+$5.00+$1.20 USD Hold'em No Limit - Level IV (40/80) - 2025/03/02 17:05:21 WET [2025/03/02 12:05:21 ET]
Table '3862890532 246' 8-max Seat #3 is the button
Seat 1: CL0D0MIR0D (1791 in chips, $5 bounty) 
Seat 2: A5632 (5549 in chips, $5 bounty) 
Seat 3: pszegryw (4188 in chips, $5 bounty) 
Seat 4: loseonteturn (5986 in chips, $5 bounty) 
Seat 5: David peixe (9614 in chips, $5 bounty) 
Seat 6: xmen358 (4845 in chips, $5 bounty) 
Seat 7: Gomma133 (8822 in chips, $7.50 bounty) 
Seat 8: Kevin12345Mc (6612 in chips, $5 bounty) 
CL0D0MIR0D: posts the ante 12
A5632: posts the ante 12
pszegryw: posts the ante 12
loseonteturn: posts the ante 12
David peixe: posts the ante 12
xmen358: posts the ante 12
Gomma133: posts the ante 12
Kevin12345Mc: posts the ante 12
loseonteturn: posts small blind 40
David peixe: posts big blind 80
*** HOLE CARDS ***
Dealt to Kevin12345Mc [6d 8h]
xmen358: folds 
Gomma133: raises 80 to 160
Kevin12345Mc: folds 
CL0D0MIR0D: folds 
A5632: calls 160
pszegryw: folds 
loseonteturn: folds 
David peixe: folds 
*** FLOP *** [4s Th Kh]
Gomma133: checks 
A5632: checks 
*** TURN *** [4s Th Kh] [5h]
Gomma133: bets 240
A5632: calls 240
*** RIVER *** [4s Th Kh 5h] [Ac]
Gomma133: checks 
A5632: bets 356
Gomma133: calls 356
*** SHOW DOWN ***
A5632: shows [Ad Jh] (a pair of Aces)
Gomma133: shows [Ah Js] (a pair of Aces)
Gomma133 collected 864 from pot
A5632 collected 864 from pot
*** SUMMARY ***
Total pot 1728 | Rake 0 
Board [4s Th Kh 5h Ac]
Seat 1: CL0D0MIR0D folded before Flop (didn't bet)
Seat 2: A5632 showed [Ad Jh] and won (864) with a pair of Aces
Seat 3: pszegryw (button) folded before Flop (didn't bet)
Seat 4: loseonteturn (small blind) folded before Flop
Seat 5: David peixe (big blind) folded before Flop
Seat 6: xmen358 folded before Flop (didn't bet)
Seat 7: Gomma133 showed [Ah Js] and won (864) with a pair of Aces
Seat 8: Kevin12345Mc folded before Flop (didn't bet)



PokerStars Hand #255106153484: Tournament #3862890532, $4.80+$5.00+$1.20 USD Hold'em No Limit - Level IV (40/80) - 2025/03/02 17:05:56 WET [2025/03/02 12:05:56 ET]
Table '3862890532 246' 8-max Seat #4 is the button
Seat 1: CL0D0MIR0D (1779 in chips, $5 bounty) 
Seat 2: A5632 (5645 in chips, $5 bounty) 
Seat 3: pszegryw (4176 in chips, $5 bounty) 
Seat 4: loseonteturn (5934 in chips, $5 bounty) 
Seat 5: David peixe (9522 in chips, $5 bounty) 
Seat 6: xmen358 (4833 in chips, $5 bounty) 
Seat 7: Gomma133 (8918 in chips, $7.50 bounty) 
Seat 8: Kevin12345Mc (6600 in chips, $5 bounty) 
CL0D0MIR0D: posts the ante 12
A5632: posts the ante 12
pszegryw: posts the ante 12
loseonteturn: posts the ante 12
David peixe: posts the ante 12
xmen358: posts the ante 12
Gomma133: posts the ante 12
Kevin12345Mc: posts the ante 12
David peixe: posts small blind 40
xmen358: posts big blind 80
*** HOLE CARDS ***
Dealt to Kevin12345Mc [6s Qs]
Gomma133: folds 
Kevin12345Mc: folds 
CL0D0MIR0D: raises 96 to 176
A5632: folds 
pszegryw: folds 
loseonteturn: folds 
David peixe: folds 
xmen358: folds 
Uncalled bet (96) returned to CL0D0MIR0D
CL0D0MIR0D collected 296 from pot
*** SUMMARY ***
Total pot 296 | Rake 0 
Seat 1: CL0D0MIR0D collected (296)
Seat 2: A5632 folded before Flop (didn't bet)
Seat 3: pszegryw folded before Flop (didn't bet)
Seat 4: loseonteturn (button) folded before Flop (didn't bet)
Seat 5: David peixe (small blind) folded before Flop
Seat 6: xmen358 (big blind) folded before Flop
Seat 7: Gomma133 folded before Flop (didn't bet)
Seat 8: Kevin12345Mc folded before Flop (didn't bet)



PokerStars Hand #255106159837: Tournament #3862890532, $4.80+$5.00+$1.20 USD Hold'em No Limit - Level IV (40/80) - 2025/03/02 17:06:18 WET [2025/03/02 12:06:18 ET]
Table '3862890532 246' 8-max Seat #5 is the button
Seat 1: CL0D0MIR0D (1983 in chips, $5 bounty) 
Seat 2: A5632 (5633 in chips, $5 bounty) 
Seat 3: pszegryw (4164 in chips, $5 bounty) 
Seat 4: loseonteturn (5922 in chips, $5 bounty) 
Seat 5: David peixe (9470 in chips, $5 bounty) 
Seat 6: xmen358 (4741 in chips, $5 bounty) 
Seat 7: Gomma133 (8906 in chips, $7.50 bounty) 
Seat 8: Kevin12345Mc (6588 in chips, $5 bounty) 
CL0D0MIR0D: posts the ante 12
A5632: posts the ante 12
pszegryw: posts the ante 12
loseonteturn: posts the ante 12
David peixe: posts the ante 12
xmen358: posts the ante 12
Gomma133: posts the ante 12
Kevin12345Mc: posts the ante 12
xmen358: posts small blind 40
Gomma133: posts big blind 80
*** HOLE CARDS ***
Dealt to Kevin12345Mc [7s 5d]
Kevin12345Mc: folds 
CL0D0MIR0D: folds 
A5632: folds 
pszegryw: raises 89 to 169
loseonteturn: folds 
David peixe: folds 
xmen358: calls 129
Gomma133: folds 
*** FLOP *** [2d 8h 4h]
xmen358: bets 257
pszegryw: calls 257
*** TURN *** [2d 8h 4h] [7c]
xmen358: bets 1028
pszegryw: calls 1028
*** RIVER *** [2d 8h 4h 7c] [Js]
xmen358: bets 3275 and is all-in
pszegryw: calls 2698 and is all-in
Uncalled bet (577) returned to xmen358
*** SHOW DOWN ***
xmen358: shows [Ad 8c] (a pair of Eights)
pszegryw: shows [4s As] (a pair of Fours)
xmen358 collected 8480 from pot
xmen358 wins $2.50 for eliminating pszegryw and their own bounty increases by $2.50 to $7.50
pszegryw finished the tournament
*** SUMMARY ***
Total pot 8480 | Rake 0 
Board [2d 8h 4h 7c Js]
Seat 1: CL0D0MIR0D folded before Flop (didn't bet)
Seat 2: A5632 folded before Flop (didn't bet)
Seat 3: pszegryw showed [4s As] and lost with a pair of Fours
Seat 4: loseonteturn folded before Flop (didn't bet)
Seat 5: David peixe (button) folded before Flop (didn't bet)
Seat 6: xmen358 (small blind) showed [Ad 8c] and won (8480) with a pair of Eights
Seat 7: Gomma133 (big blind) folded before Flop
Seat 8: Kevin12345Mc folded before Flop (didn't bet)



PokerStars Hand #255106176319: Tournament #3862890532, $4.80+$5.00+$1.20 USD Hold'em No Limit - Level IV (40/80) - 2025/03/02 17:07:16 WET [2025/03/02 12:07:16 ET]
Table '3862890532 246' 8-max Seat #6 is the button
Seat 1: CL0D0MIR0D (1971 in chips, $5 bounty) 
Seat 2: A5632 (5621 in chips, $5 bounty) 
Seat 4: loseonteturn (5910 in chips, $5 bounty) 
Seat 5: David peixe (9458 in chips, $5 bounty) 
Seat 6: xmen358 (9057 in chips, $7.50 bounty) 
Seat 7: Gomma133 (8814 in chips, $7.50 bounty) 
Seat 8: Kevin12345Mc (6576 in chips, $5 bounty) 
CL0D0MIR0D: posts the ante 12
A5632: posts the ante 12
loseonteturn: posts the ante 12
David peixe: posts the ante 12
xmen358: posts the ante 12
Gomma133: posts the ante 12
Kevin12345Mc: posts the ante 12
Gomma133: posts small blind 40
Kevin12345Mc: posts big blind 80
*** HOLE CARDS ***
Dealt to Kevin12345Mc [9s Js]
CL0D0MIR0D: raises 96 to 176
A5632: folds 
loseonteturn: folds 
David peixe: calls 176
xmen358: folds 
Gomma133: folds 
Kevin12345Mc: calls 96
*** FLOP *** [Qs Kh 2s]
Kevin12345Mc: checks 
CL0D0MIR0D: bets 209
David peixe: folds 
Kevin12345Mc: raises 6179 to 6388 and is all-in
CL0D0MIR0D: folds 
Uncalled bet (6179) returned to Kevin12345Mc
Kevin12345Mc collected 1070 from pot
Kevin12345Mc: doesn't show hand 
*** SUMMARY ***
Total pot 1070 | Rake 0 
Board [Qs Kh 2s]
Seat 1: CL0D0MIR0D folded on the Flop
Seat 2: A5632 folded before Flop (didn't bet)
Seat 4: loseonteturn folded before Flop (didn't bet)
Seat 5: David peixe folded on the Flop
Seat 6: xmen358 (button) folded before Flop (didn't bet)
Seat 7: Gomma133 (small blind) folded before Flop
Seat 8: Kevin12345Mc (big blind) collected (1070)



PokerStars Hand #255106191446: Tournament #3862890532, $4.80+$5.00+$1.20 USD Hold'em No Limit - Level IV (40/80) - 2025/03/02 17:08:10 WET [2025/03/02 12:08:10 ET]
Table '3862890532 246' 8-max Seat #7 is the button
Seat 1: CL0D0MIR0D (1574 in chips, $5 bounty) 
Seat 2: A5632 (5609 in chips, $5 bounty) 
Seat 3: kikokiko28 (5000 in chips, $5 bounty) 
Seat 4: loseonteturn (5898 in chips, $5 bounty) 
Seat 5: David peixe (9270 in chips, $5 bounty) 
Seat 6: xmen358 (9045 in chips, $7.50 bounty) 
Seat 7: Gomma133 (8762 in chips, $7.50 bounty) 
Seat 8: Kevin12345Mc (7249 in chips, $5 bounty) 
CL0D0MIR0D: posts the ante 12
A5632: posts the ante 12
kikokiko28: posts the ante 12
loseonteturn: posts the ante 12
David peixe: posts the ante 12
xmen358: posts the ante 12
Gomma133: posts the ante 12
Kevin12345Mc: posts the ante 12
Kevin12345Mc: posts small blind 40
CL0D0MIR0D: posts big blind 80
*** HOLE CARDS ***
Dealt to Kevin12345Mc [4h 8c]
A5632: folds 
kikokiko28: folds 
loseonteturn: folds 
David peixe: folds 
xmen358: raises 80 to 160
Gomma133: folds 
Kevin12345Mc: folds 
CL0D0MIR0D: calls 80
*** FLOP *** [4c Ts Qs]
CL0D0MIR0D: checks 
xmen358: bets 228
CL0D0MIR0D: calls 228
*** TURN *** [4c Ts Qs] [Jh]
CL0D0MIR0D: checks 
xmen358: checks 
*** RIVER *** [4c Ts Qs Jh] [As]
CL0D0MIR0D: bets 1174 and is all-in
xmen358: calls 1174
*** SHOW DOWN ***
CL0D0MIR0D: shows [8s Jd] (a pair of Jacks)
xmen358: shows [Tc Ks] (a straight, Ten to Ace)
xmen358 collected 3260 from pot
xmen358 wins $2.50 for eliminating CL0D0MIR0D and their own bounty increases by $2.50 to $10
CL0D0MIR0D finished the tournament
*** SUMMARY ***
Total pot 3260 | Rake 0 
Board [4c Ts Qs Jh As]
Seat 1: CL0D0MIR0D (big blind) showed [8s Jd] and lost with a pair of Jacks
Seat 2: A5632 folded before Flop (didn't bet)
Seat 3: kikokiko28 folded before Flop (didn't bet)
Seat 4: loseonteturn folded before Flop (didn't bet)
Seat 5: David peixe folded before Flop (didn't bet)
Seat 6: xmen358 showed [Tc Ks] and won (3260) with a straight, Ten to Ace
Seat 7: Gomma133 (button) folded before Flop (didn't bet)
Seat 8: Kevin12345Mc (small blind) folded before Flop



PokerStars Hand #255106208794: Tournament #3862890532, $4.80+$5.00+$1.20 USD Hold'em No Limit - Level IV (40/80) - 2025/03/02 17:09:12 WET [2025/03/02 12:09:12 ET]
Table '3862890532 246' 8-max Seat #8 is the button
Seat 2: A5632 (5597 in chips, $5 bounty) 
Seat 3: kikokiko28 (4988 in chips, $5 bounty) 
Seat 4: loseonteturn (5886 in chips, $5 bounty) 
Seat 5: David peixe (9258 in chips, $5 bounty) 
Seat 6: xmen358 (10731 in chips, $10 bounty) 
Seat 7: Gomma133 (8750 in chips, $7.50 bounty) 
Seat 8: Kevin12345Mc (7197 in chips, $5 bounty) 
A5632: posts the ante 12
kikokiko28: posts the ante 12
loseonteturn: posts the ante 12
David peixe: posts the ante 12
xmen358: posts the ante 12
Gomma133: posts the ante 12
Kevin12345Mc: posts the ante 12
A5632: posts small blind 40
kikokiko28: posts big blind 80
*** HOLE CARDS ***
Dealt to Kevin12345Mc [Jh 3d]
VVS777 is disconnected 
loseonteturn: folds 
David peixe: folds 
xmen358: raises 80 to 160
Gomma133: folds 
Kevin12345Mc: folds 
A5632: raises 320 to 480
kikokiko28: folds 
xmen358: calls 320
*** FLOP *** [Kc 7h 7d]
A5632: bets 393
xmen358: folds 
Uncalled bet (393) returned to A5632
A5632 collected 1124 from pot
A5632: doesn't show hand 
*** SUMMARY ***
Total pot 1124 | Rake 0 
Board [Kc 7h 7d]
Seat 2: A5632 (small blind) collected (1124)
Seat 3: kikokiko28 (big blind) folded before Flop
Seat 4: loseonteturn folded before Flop (didn't bet)
Seat 5: David peixe folded before Flop (didn't bet)
Seat 6: xmen358 folded on the Flop
Seat 7: Gomma133 folded before Flop (didn't bet)
Seat 8: Kevin12345Mc (button) folded before Flop (didn't bet)



PokerStars Hand #255106218821: Tournament #3862890532, $4.80+$5.00+$1.20 USD Hold'em No Limit - Level V (45/90) - 2025/03/02 17:09:47 WET [2025/03/02 12:09:47 ET]
Table '3862890532 246' 8-max Seat #2 is the button
Seat 1: VVS777 (5000 in chips, $5 bounty) 
Seat 2: A5632 (6229 in chips, $5 bounty) 
Seat 3: kikokiko28 (4896 in chips, $5 bounty) 
Seat 4: loseonteturn (5874 in chips, $5 bounty) 
Seat 5: David peixe (9246 in chips, $5 bounty) 
Seat 6: xmen358 (10239 in chips, $10 bounty) 
Seat 7: Gomma133 (8738 in chips, $7.50 bounty) 
Seat 8: Kevin12345Mc (7185 in chips, $5 bounty) 
VVS777: posts the ante 14
A5632: posts the ante 14
kikokiko28: posts the ante 14
loseonteturn: posts the ante 14
David peixe: posts the ante 14
xmen358: posts the ante 14
Gomma133: posts the ante 14
Kevin12345Mc: posts the ante 14
kikokiko28: posts small blind 45
loseonteturn: posts big blind 90
*** HOLE CARDS ***
Dealt to Kevin12345Mc [6d 4c]
David peixe: folds 
xmen358: calls 90
Gomma133: folds 
Kevin12345Mc: folds 
VVS777: folds 
A5632: folds 
kikokiko28: calls 45
loseonteturn: checks 
*** FLOP *** [Kc Ks 7d]
kikokiko28: checks 
loseonteturn: checks 
xmen358: checks 
*** TURN *** [Kc Ks 7d] [4d]
kikokiko28: checks 
loseonteturn: checks 
xmen358: checks 
*** RIVER *** [Kc Ks 7d 4d] [Th]
kikokiko28: checks 
loseonteturn: checks 
xmen358: checks 
*** SHOW DOWN ***
kikokiko28: shows [Ah 3h] (a pair of Kings)
loseonteturn: shows [As 7c] (two pair, Kings and Sevens)
xmen358: mucks hand 
loseonteturn collected 382 from pot
*** SUMMARY ***
Total pot 382 | Rake 0 
Board [Kc Ks 7d 4d Th]
Seat 1: VVS777 folded before Flop (didn't bet)
Seat 2: A5632 (button) folded before Flop (didn't bet)
Seat 3: kikokiko28 (small blind) showed [Ah 3h] and lost with a pair of Kings
Seat 4: loseonteturn (big blind) showed [As 7c] and won (382) with two pair, Kings and Sevens
Seat 5: David peixe folded before Flop (didn't bet)
Seat 6: xmen358 mucked [9h Qh]
Seat 7: Gomma133 folded before Flop (didn't bet)
Seat 8: Kevin12345Mc folded before Flop (didn't bet)



PokerStars Hand #255106234358: Tournament #3862890532, $4.80+$5.00+$1.20 USD Hold'em No Limit - Level V (45/90) - 2025/03/02 17:10:41 WET [2025/03/02 12:10:41 ET]
Table '3862890532 246' 8-max Seat #3 is the button
Seat 1: VVS777 (4986 in chips, $5 bounty) 
Seat 2: A5632 (6215 in chips, $5 bounty) 
Seat 3: kikokiko28 (4792 in chips, $5 bounty) 
Seat 4: loseonteturn (6152 in chips, $5 bounty) 
Seat 5: David peixe (9232 in chips, $5 bounty) 
Seat 6: xmen358 (10135 in chips, $10 bounty) 
Seat 7: Gomma133 (8724 in chips, $7.50 bounty) 
Seat 8: Kevin12345Mc (7171 in chips, $5 bounty) 
VVS777: posts the ante 14
A5632: posts the ante 14
kikokiko28: posts the ante 14
loseonteturn: posts the ante 14
David peixe: posts the ante 14
xmen358: posts the ante 14
Gomma133: posts the ante 14
Kevin12345Mc: posts the ante 14
loseonteturn: posts small blind 45
David peixe: posts big blind 90
*** HOLE CARDS ***
Dealt to Kevin12345Mc [Qc 3h]
xmen358: folds 
Gomma133: folds 
Kevin12345Mc: folds 
VVS777: folds 
A5632: raises 108 to 198
kikokiko28: calls 198
loseonteturn: folds 
David peixe: folds 
*** FLOP *** [Tc 8c 4c]
A5632: checks 
kikokiko28: checks 
*** TURN *** [Tc 8c 4c] [Jc]
A5632: checks 
kikokiko28: bets 322
A5632: folds 
Uncalled bet (322) returned to kikokiko28
kikokiko28 collected 643 from pot
*** SUMMARY ***
Total pot 643 | Rake 0 
Board [Tc 8c 4c Jc]
Seat 1: VVS777 folded before Flop (didn't bet)
Seat 2: A5632 folded on the Turn
Seat 3: kikokiko28 (button) collected (643)
Seat 4: loseonteturn (small blind) folded before Flop
Seat 5: David peixe (big blind) folded before Flop
Seat 6: xmen358 folded before Flop (didn't bet)
Seat 7: Gomma133 folded before Flop (didn't bet)
Seat 8: Kevin12345Mc folded before Flop (didn't bet)



PokerStars Hand #255106246926: Tournament #3862890532, $4.80+$5.00+$1.20 USD Hold'em No Limit - Level V (45/90) - 2025/03/02 17:11:25 WET [2025/03/02 12:11:25 ET]
Table '3862890532 246' 8-max Seat #4 is the button
Seat 1: VVS777 (4972 in chips, $5 bounty) 
Seat 2: A5632 (6003 in chips, $5 bounty) 
Seat 3: kikokiko28 (5223 in chips, $5 bounty) 
Seat 4: loseonteturn (6093 in chips, $5 bounty) 
Seat 5: David peixe (9128 in chips, $5 bounty) 
Seat 6: xmen358 (10121 in chips, $10 bounty) 
Seat 7: Gomma133 (8710 in chips, $7.50 bounty) 
Seat 8: Kevin12345Mc (7157 in chips, $5 bounty) 
VVS777: posts the ante 14
A5632: posts the ante 14
kikokiko28: posts the ante 14
loseonteturn: posts the ante 14
David peixe: posts the ante 14
xmen358: posts the ante 14
Gomma133: posts the ante 14
Kevin12345Mc: posts the ante 14
David peixe: posts small blind 45
xmen358: posts big blind 90
*** HOLE CARDS ***
Dealt to Kevin12345Mc [5s 9d]
Gomma133: raises 90 to 180
Kevin12345Mc: folds 
VVS777: calls 180
A5632: folds 
kikokiko28: calls 180
loseonteturn: raises 630 to 810
David peixe: folds 
xmen358: folds 
Gomma133: folds 
VVS777: folds 
kikokiko28: folds 
Uncalled bet (630) returned to loseonteturn
loseonteturn collected 967 from pot
loseonteturn: doesn't show hand 
*** SUMMARY ***
Total pot 967 | Rake 0 
Seat 1: VVS777 folded before Flop
Seat 2: A5632 folded before Flop (didn't bet)
Seat 3: kikokiko28 folded before Flop
Seat 4: loseonteturn (button) collected (967)
Seat 5: David peixe (small blind) folded before Flop
Seat 6: xmen358 (big blind) folded before Flop
Seat 7: Gomma133 folded before Flop
Seat 8: Kevin12345Mc folded before Flop (didn't bet)



PokerStars Hand #255106261415: Tournament #3862890532, $4.80+$5.00+$1.20 USD Hold'em No Limit - Level V (45/90) - 2025/03/02 17:12:15 WET [2025/03/02 12:12:15 ET]
Table '3862890532 246' 8-max Seat #5 is the button
Seat 1: VVS777 (4778 in chips, $5 bounty) 
Seat 2: A5632 (5989 in chips, $5 bounty) 
Seat 3: kikokiko28 (5029 in chips, $5 bounty) 
Seat 4: loseonteturn (6866 in chips, $5 bounty) 
Seat 5: David peixe (9069 in chips, $5 bounty) 
Seat 6: xmen358 (10017 in chips, $10 bounty) 
Seat 7: Gomma133 (8516 in chips, $7.50 bounty) 
Seat 8: Kevin12345Mc (7143 in chips, $5 bounty) 
VVS777: posts the ante 14
A5632: posts the ante 14
kikokiko28: posts the ante 14
loseonteturn: posts the ante 14
David peixe: posts the ante 14
xmen358: posts the ante 14
Gomma133: posts the ante 14
Kevin12345Mc: posts the ante 14
xmen358: posts small blind 45
Gomma133: posts big blind 90
*** HOLE CARDS ***
Dealt to Kevin12345Mc [Ts Ad]
Kevin12345Mc: raises 117 to 207
VVS777: folds 
A5632: calls 207
kikokiko28: calls 207
loseonteturn: folds 
David peixe: folds 
xmen358: folds 
Gomma133: calls 117
*** FLOP *** [2d 2s 7h]
Gomma133: checks 
Kevin12345Mc: checks 
A5632: bets 512
kikokiko28: calls 512
Gomma133: folds 
Kevin12345Mc: folds 
*** TURN *** [2d 2s 7h] [8s]
A5632: bets 1045
kikokiko28: folds 
Uncalled bet (1045) returned to A5632
A5632 collected 2009 from pot
A5632: doesn't show hand 
*** SUMMARY ***
Total pot 2009 | Rake 0 
Board [2d 2s 7h 8s]
Seat 1: VVS777 folded before Flop (didn't bet)
Seat 2: A5632 collected (2009)
Seat 3: kikokiko28 folded on the Turn
Seat 4: loseonteturn folded before Flop (didn't bet)
Seat 5: David peixe (button) folded before Flop (didn't bet)
Seat 6: xmen358 (small blind) folded before Flop
Seat 7: Gomma133 (big blind) folded on the Flop
Seat 8: Kevin12345Mc folded on the Flop



PokerStars Hand #255106272095: Tournament #3862890532, $4.80+$5.00+$1.20 USD Hold'em No Limit - Level V (45/90) - 2025/03/02 17:12:52 WET [2025/03/02 12:12:52 ET]
Table '3862890532 246' 8-max Seat #6 is the button
Seat 1: VVS777 (4764 in chips, $5 bounty) 
Seat 2: A5632 (7265 in chips, $5 bounty) 
Seat 3: kikokiko28 (4296 in chips, $5 bounty) 
Seat 4: loseonteturn (6852 in chips, $5 bounty) 
Seat 5: David peixe (9055 in chips, $5 bounty) 
Seat 6: xmen358 (9958 in chips, $10 bounty) 
Seat 7: Gomma133 (8295 in chips, $7.50 bounty) 
Seat 8: Kevin12345Mc (6922 in chips, $5 bounty) 
VVS777: posts the ante 14
A5632: posts the ante 14
kikokiko28: posts the ante 14
loseonteturn: posts the ante 14
David peixe: posts the ante 14
xmen358: posts the ante 14
Gomma133: posts the ante 14
Kevin12345Mc: posts the ante 14
Gomma133: posts small blind 45
Kevin12345Mc: posts big blind 90
*** HOLE CARDS ***
Dealt to Kevin12345Mc [5c 3s]
VVS777: folds 
A5632: folds 
kikokiko28: raises 180 to 270
loseonteturn: raises 540 to 810
David peixe: folds 
xmen358: folds 
Gomma133: folds 
Kevin12345Mc: folds 
kikokiko28: calls 540
*** FLOP *** [Tc Ac 2c]
kikokiko28: checks 
loseonteturn: bets 405
kikokiko28: calls 405
*** TURN *** [Tc Ac 2c] [9d]
kikokiko28: checks 
loseonteturn: checks 
*** RIVER *** [Tc Ac 2c 9d] [Jd]
kikokiko28: checks 
loseonteturn: bets 1260
kikokiko28: folds 
Uncalled bet (1260) returned to loseonteturn
loseonteturn collected 2677 from pot
loseonteturn: doesn't show hand 
*** SUMMARY ***
Total pot 2677 | Rake 0 
Board [Tc Ac 2c 9d Jd]
Seat 1: VVS777 folded before Flop (didn't bet)
Seat 2: A5632 folded before Flop (didn't bet)
Seat 3: kikokiko28 folded on the River
Seat 4: loseonteturn collected (2677)
Seat 5: David peixe folded before Flop (didn't bet)
Seat 6: xmen358 (button) folded before Flop (didn't bet)
Seat 7: Gomma133 (small blind) folded before Flop
Seat 8: Kevin12345Mc (big blind) folded before Flop



PokerStars Hand #255106288808: Tournament #3862890532, $4.80+$5.00+$1.20 USD Hold'em No Limit - Level V (45/90) - 2025/03/02 17:13:48 WET [2025/03/02 12:13:48 ET]
Table '3862890532 246' 8-max Seat #7 is the button
Seat 1: VVS777 (4750 in chips, $5 bounty) 
Seat 2: A5632 (7251 in chips, $5 bounty) 
Seat 3: kikokiko28 (3067 in chips, $5 bounty) 
Seat 4: loseonteturn (8300 in chips, $5 bounty) 
Seat 5: David peixe (9041 in chips, $5 bounty) 
Seat 6: xmen358 (9944 in chips, $10 bounty) 
Seat 7: Gomma133 (8236 in chips, $7.50 bounty) 
Seat 8: Kevin12345Mc (6818 in chips, $5 bounty) 
VVS777: posts the ante 14
A5632: posts the ante 14
kikokiko28: posts the ante 14
loseonteturn: posts the ante 14
David peixe: posts the ante 14
xmen358: posts the ante 14
Gomma133: posts the ante 14
Kevin12345Mc: posts the ante 14
Kevin12345Mc: posts small blind 45
VVS777: posts big blind 90
*** HOLE CARDS ***
Dealt to Kevin12345Mc [4d 8c]
A5632: raises 108 to 198
kikokiko28: folds 
loseonteturn: folds 
David peixe: calls 198
xmen358: folds 
Gomma133: folds 
Kevin12345Mc: folds 
VVS777: calls 108
*** FLOP *** [9s 9h Kd]
VVS777: checks 
A5632: checks 
David peixe: bets 405
VVS777: folds 
A5632: folds 
Uncalled bet (405) returned to David peixe
David peixe collected 751 from pot
David peixe: doesn't show hand 
*** SUMMARY ***
Total pot 751 | Rake 0 
Board [9s 9h Kd]
Seat 1: VVS777 (big blind) folded on the Flop
Seat 2: A5632 folded on the Flop
Seat 3: kikokiko28 folded before Flop (didn't bet)
Seat 4: loseonteturn folded before Flop (didn't bet)
Seat 5: David peixe collected (751)
Seat 6: xmen358 folded before Flop (didn't bet)
Seat 7: Gomma133 (button) folded before Flop (didn't bet)
Seat 8: Kevin12345Mc (small blind) folded before Flop



PokerStars Hand #255106301574: Tournament #3862890532, $4.80+$5.00+$1.20 USD Hold'em No Limit - Level V (45/90) - 2025/03/02 17:14:32 WET [2025/03/02 12:14:32 ET]
Table '3862890532 246' 8-max Seat #8 is the button
Seat 1: VVS777 (4538 in chips, $5 bounty) 
Seat 2: A5632 (7039 in chips, $5 bounty) 
Seat 3: kikokiko28 (3053 in chips, $5 bounty) 
Seat 4: loseonteturn (8286 in chips, $5 bounty) 
Seat 5: David peixe (9580 in chips, $5 bounty) 
Seat 6: xmen358 (9930 in chips, $10 bounty) 
Seat 7: Gomma133 (8222 in chips, $7.50 bounty) 
Seat 8: Kevin12345Mc (6759 in chips, $5 bounty) 
VVS777: posts the ante 14
A5632: posts the ante 14
kikokiko28: posts the ante 14
loseonteturn: posts the ante 14
David peixe: posts the ante 14
xmen358: posts the ante 14
Gomma133: posts the ante 14
Kevin12345Mc: posts the ante 14
VVS777: posts small blind 45
A5632: posts big blind 90
*** HOLE CARDS ***
Dealt to Kevin12345Mc [Tc 2c]
kikokiko28: folds 
loseonteturn: folds 
David peixe: folds 
xmen358: folds 
Gomma133: folds 
Kevin12345Mc: folds 
VVS777: raises 225 to 315
A5632: folds 
Uncalled bet (225) returned to VVS777
VVS777 collected 292 from pot
VVS777: doesn't show hand 
*** SUMMARY ***
Total pot 292 | Rake 0 
Seat 1: VVS777 (small blind) collected (292)
Seat 2: A5632 (big blind) folded before Flop
Seat 3: kikokiko28 folded before Flop (didn't bet)
Seat 4: loseonteturn folded before Flop (didn't bet)
Seat 5: David peixe folded before Flop (didn't bet)
Seat 6: xmen358 folded before Flop (didn't bet)
Seat 7: Gomma133 folded before Flop (didn't bet)
Seat 8: Kevin12345Mc (button) folded before Flop (didn't bet)



PokerStars Hand #255106309766: Tournament #3862890532, $4.80+$5.00+$1.20 USD Hold'em No Limit - Level V (45/90) - 2025/03/02 17:14:59 WET [2025/03/02 12:14:59 ET]
Table '3862890532 246' 8-max Seat #1 is the button
Seat 1: VVS777 (4726 in chips, $5 bounty) 
Seat 2: A5632 (6935 in chips, $5 bounty) 
Seat 3: kikokiko28 (3039 in chips, $5 bounty) 
Seat 4: loseonteturn (8272 in chips, $5 bounty) 
Seat 5: David peixe (9566 in chips, $5 bounty) 
Seat 6: xmen358 (9916 in chips, $10 bounty) 
Seat 7: Gomma133 (8208 in chips, $7.50 bounty) 
Seat 8: Kevin12345Mc (6745 in chips, $5 bounty) 
VVS777: posts the ante 14
A5632: posts the ante 14
kikokiko28: posts the ante 14
loseonteturn: posts the ante 14
David peixe: posts the ante 14
xmen358: posts the ante 14
Gomma133: posts the ante 14
Kevin12345Mc: posts the ante 14
A5632: posts small blind 45
kikokiko28: posts big blind 90
*** HOLE CARDS ***
Dealt to Kevin12345Mc [9s Ac]
loseonteturn: raises 135 to 225
David peixe: folds 
xmen358: folds 
Gomma133: folds 
Kevin12345Mc: folds 
VVS777: folds 
A5632: folds 
kikokiko28: raises 607 to 832
loseonteturn: calls 607
*** FLOP *** [8c 7d 8h]
kikokiko28: bets 2193 and is all-in
loseonteturn: folds 
Uncalled bet (2193) returned to kikokiko28
kikokiko28 collected 1821 from pot
*** SUMMARY ***
Total pot 1821 | Rake 0 
Board [8c 7d 8h]
Seat 1: VVS777 (button) folded before Flop (didn't bet)
Seat 2: A5632 (small blind) folded before Flop
Seat 3: kikokiko28 (big blind) collected (1821)
Seat 4: loseonteturn folded on the Flop
Seat 5: David peixe folded before Flop (didn't bet)
Seat 6: xmen358 folded before Flop (didn't bet)
Seat 7: Gomma133 folded before Flop (didn't bet)
Seat 8: Kevin12345Mc folded before Flop (didn't bet)



PokerStars Hand #255106320754: Tournament #3862890532, $4.80+$5.00+$1.20 USD Hold'em No Limit - Level V (45/90) - 2025/03/02 17:15:36 WET [2025/03/02 12:15:36 ET]
Table '3862890532 246' 8-max Seat #2 is the button
Seat 1: VVS777 (4712 in chips, $5 bounty) 
Seat 2: A5632 (6876 in chips, $5 bounty) 
Seat 3: kikokiko28 (4014 in chips, $5 bounty) 
Seat 4: loseonteturn (7426 in chips, $5 bounty) 
Seat 5: David peixe (9552 in chips, $5 bounty) 
Seat 6: xmen358 (9902 in chips, $10 bounty) 
Seat 7: Gomma133 (8194 in chips, $7.50 bounty) 
Seat 8: Kevin12345Mc (6731 in chips, $5 bounty) 
VVS777: posts the ante 14
A5632: posts the ante 14
kikokiko28: posts the ante 14
loseonteturn: posts the ante 14
David peixe: posts the ante 14
xmen358: posts the ante 14
Gomma133: posts the ante 14
Kevin12345Mc: posts the ante 14
kikokiko28: posts small blind 45
loseonteturn: posts big blind 90
*** HOLE CARDS ***
Dealt to Kevin12345Mc [7d 8h]
David peixe: folds 
xmen358: raises 90 to 180
Gomma133: folds 
Kevin12345Mc: folds 
VVS777: folds 
A5632: raises 360 to 540
kikokiko28: folds 
loseonteturn: folds 
xmen358: calls 360
*** FLOP *** [Td 5d Ks]
xmen358: checks 
A5632: bets 690
xmen358: folds 
Uncalled bet (690) returned to A5632
A5632 collected 1327 from pot
A5632: doesn't show hand 
*** SUMMARY ***
Total pot 1327 | Rake 0 
Board [Td 5d Ks]
Seat 1: VVS777 folded before Flop (didn't bet)
Seat 2: A5632 (button) collected (1327)
Seat 3: kikokiko28 (small blind) folded before Flop
Seat 4: loseonteturn (big blind) folded before Flop
Seat 5: David peixe folded before Flop (didn't bet)
Seat 6: xmen358 folded on the Flop
Seat 7: Gomma133 folded before Flop (didn't bet)
Seat 8: Kevin12345Mc folded before Flop (didn't bet)



PokerStars Hand #255106330298: Tournament #3862890532, $4.80+$5.00+$1.20 USD Hold'em No Limit - Level V (45/90) - 2025/03/02 17:16:07 WET [2025/03/02 12:16:07 ET]
Table '3862890532 246' 8-max Seat #3 is the button
Seat 1: VVS777 (4698 in chips, $5 bounty) 
Seat 2: A5632 (7649 in chips, $5 bounty) 
Seat 3: kikokiko28 (3955 in chips, $5 bounty) 
Seat 4: loseonteturn (7322 in chips, $5 bounty) 
Seat 5: David peixe (9538 in chips, $5 bounty) 
Seat 6: xmen358 (9348 in chips, $10 bounty) 
Seat 7: Gomma133 (8180 in chips, $7.50 bounty) 
Seat 8: Kevin12345Mc (6717 in chips, $5 bounty) 
VVS777: posts the ante 14
A5632: posts the ante 14
kikokiko28: posts the ante 14
loseonteturn: posts the ante 14
David peixe: posts the ante 14
xmen358: posts the ante 14
Gomma133: posts the ante 14
Kevin12345Mc: posts the ante 14
loseonteturn: posts small blind 45
David peixe: posts big blind 90
*** HOLE CARDS ***
Dealt to Kevin12345Mc [6s 6d]
xmen358: folds 
Gomma133: raises 90 to 180
Kevin12345Mc: calls 180
VVS777: folds 
A5632: folds 
kikokiko28: folds 
loseonteturn: folds 
David peixe: calls 90
*** FLOP *** [9s 5h Ac]
David peixe: checks 
Gomma133: checks 
Kevin12345Mc: checks 
*** TURN *** [9s 5h Ac] [7s]
David peixe: bets 523
Gomma133: calls 523
Kevin12345Mc: folds 
*** RIVER *** [9s 5h Ac 7s] [Qd]
David peixe: bets 1350
Gomma133: calls 1350
*** SHOW DOWN ***
David peixe: shows [Ad 9d] (two pair, Aces and Nines)
Gomma133: mucks hand 
David peixe collected 4443 from pot
*** SUMMARY ***
Total pot 4443 | Rake 0 
Board [9s 5h Ac 7s Qd]
Seat 1: VVS777 folded before Flop (didn't bet)
Seat 2: A5632 folded before Flop (didn't bet)
Seat 3: kikokiko28 (button) folded before Flop (didn't bet)
Seat 4: loseonteturn (small blind) folded before Flop
Seat 5: David peixe (big blind) showed [Ad 9d] and won (4443) with two pair, Aces and Nines
Seat 6: xmen358 folded before Flop (didn't bet)
Seat 7: Gomma133 mucked [Jd Jh]
Seat 8: Kevin12345Mc folded on the Turn



PokerStars Hand #255106360409: Tournament #3862890532, $4.80+$5.00+$1.20 USD Hold'em No Limit - Level VI (50/100) - 2025/03/02 17:17:49 WET [2025/03/02 12:17:49 ET]
Table '3862890532 246' 8-max Seat #4 is the button
Seat 1: VVS777 (4684 in chips, $5 bounty) 
Seat 2: A5632 (7635 in chips, $5 bounty) 
Seat 3: kikokiko28 (3941 in chips, $5 bounty) 
Seat 4: loseonteturn (7263 in chips, $5 bounty) 
Seat 5: David peixe (11914 in chips, $5 bounty) 
Seat 6: xmen358 (9334 in chips, $10 bounty) 
Seat 7: Gomma133 (6113 in chips, $7.50 bounty) 
Seat 8: Kevin12345Mc (6523 in chips, $5 bounty) 
VVS777: posts the ante 15
A5632: posts the ante 15
kikokiko28: posts the ante 15
loseonteturn: posts the ante 15
David peixe: posts the ante 15
xmen358: posts the ante 15
Gomma133: posts the ante 15
Kevin12345Mc: posts the ante 15
David peixe: posts small blind 50
xmen358: posts big blind 100
*** HOLE CARDS ***
Dealt to Kevin12345Mc [9h 6s]
Gomma133: raises 100 to 200
Kevin12345Mc: folds 
VVS777: folds 
A5632: folds 
kikokiko28: raises 400 to 600
loseonteturn: calls 600
David peixe: folds 
xmen358: folds 
Gomma133: calls 400
*** FLOP *** [3d Tc 8c]
Gomma133: checks 
kikokiko28: bets 1235
loseonteturn: folds 
Gomma133: folds 
Uncalled bet (1235) returned to kikokiko28
kikokiko28 collected 2070 from pot
*** SUMMARY ***
Total pot 2070 | Rake 0 
Board [3d Tc 8c]
Seat 1: VVS777 folded before Flop (didn't bet)
Seat 2: A5632 folded before Flop (didn't bet)
Seat 3: kikokiko28 collected (2070)
Seat 4: loseonteturn (button) folded on the Flop
Seat 5: David peixe (small blind) folded before Flop
Seat 6: xmen358 (big blind) folded before Flop
Seat 7: Gomma133 folded on the Flop
Seat 8: Kevin12345Mc folded before Flop (didn't bet)



PokerStars Hand #255106368078: Tournament #3862890532, $4.80+$5.00+$1.20 USD Hold'em No Limit - Level VI (50/100) - 2025/03/02 17:18:15 WET [2025/03/02 12:18:15 ET]
Table '3862890532 246' 8-max Seat #5 is the button
Seat 1: VVS777 (4669 in chips, $5 bounty) 
Seat 2: A5632 (7620 in chips, $5 bounty) 
Seat 3: kikokiko28 (5396 in chips, $5 bounty) 
Seat 4: loseonteturn (6648 in chips, $5 bounty) 
Seat 5: David peixe (11849 in chips, $5 bounty) 
Seat 6: xmen358 (9219 in chips, $10 bounty) 
Seat 7: Gomma133 (5498 in chips, $7.50 bounty) 
Seat 8: Kevin12345Mc (6508 in chips, $5 bounty) 
VVS777: posts the ante 15
A5632: posts the ante 15
kikokiko28: posts the ante 15
loseonteturn: posts the ante 15
David peixe: posts the ante 15
xmen358: posts the ante 15
Gomma133: posts the ante 15
Kevin12345Mc: posts the ante 15
xmen358: posts small blind 50
Gomma133: posts big blind 100
*** HOLE CARDS ***
Dealt to Kevin12345Mc [Td 6d]
Kevin12345Mc: folds 
VVS777: folds 
A5632: folds 
kikokiko28: raises 200 to 300
loseonteturn: folds 
David peixe: calls 300
xmen358: calls 250
Gomma133: calls 200
*** FLOP *** [Jh 5h Ks]
xmen358: checks 
Gomma133: checks 
kikokiko28: bets 560
David peixe: folds 
xmen358: folds 
Gomma133: folds 
Uncalled bet (560) returned to kikokiko28
kikokiko28 collected 1320 from pot
*** SUMMARY ***
Total pot 1320 | Rake 0 
Board [Jh 5h Ks]
Seat 1: VVS777 folded before Flop (didn't bet)
Seat 2: A5632 folded before Flop (didn't bet)
Seat 3: kikokiko28 collected (1320)
Seat 4: loseonteturn folded before Flop (didn't bet)
Seat 5: David peixe (button) folded on the Flop
Seat 6: xmen358 (small blind) folded on the Flop
Seat 7: Gomma133 (big blind) folded on the Flop
Seat 8: Kevin12345Mc folded before Flop (didn't bet)



PokerStars Hand #255106379997: Tournament #3862890532, $4.80+$5.00+$1.20 USD Hold'em No Limit - Level VI (50/100) - 2025/03/02 17:18:55 WET [2025/03/02 12:18:55 ET]
Table '3862890532 246' 8-max Seat #6 is the button
Seat 1: VVS777 (4654 in chips, $5 bounty) 
Seat 2: A5632 (7605 in chips, $5 bounty) 
Seat 3: kikokiko28 (6401 in chips, $5 bounty) 
Seat 4: loseonteturn (6633 in chips, $5 bounty) 
Seat 5: David peixe (11534 in chips, $5 bounty) 
Seat 6: xmen358 (8904 in chips, $10 bounty) 
Seat 7: Gomma133 (5183 in chips, $7.50 bounty) 
Seat 8: Kevin12345Mc (6493 in chips, $5 bounty) 
VVS777: posts the ante 15
A5632: posts the ante 15
kikokiko28: posts the ante 15
loseonteturn: posts the ante 15
David peixe: posts the ante 15
xmen358: posts the ante 15
Gomma133: posts the ante 15
Kevin12345Mc: posts the ante 15
Gomma133: posts small blind 50
Kevin12345Mc: posts big blind 100
*** HOLE CARDS ***
Dealt to Kevin12345Mc [3d Js]
VVS777: folds 
A5632: folds 
kikokiko28: folds 
loseonteturn: folds 
David peixe: folds 
xmen358: folds 
Gomma133: raises 200 to 300
Kevin12345Mc: folds 
Uncalled bet (200) returned to Gomma133
Gomma133 collected 320 from pot
Gomma133: doesn't show hand 
*** SUMMARY ***
Total pot 320 | Rake 0 
Seat 1: VVS777 folded before Flop (didn't bet)
Seat 2: A5632 folded before Flop (didn't bet)
Seat 3: kikokiko28 folded before Flop (didn't bet)
Seat 4: loseonteturn folded before Flop (didn't bet)
Seat 5: David peixe folded before Flop (didn't bet)
Seat 6: xmen358 (button) folded before Flop (didn't bet)
Seat 7: Gomma133 (small blind) collected (320)
Seat 8: Kevin12345Mc (big blind) folded before Flop



PokerStars Hand #255106383807: Tournament #3862890532, $4.80+$5.00+$1.20 USD Hold'em No Limit - Level VI (50/100) - 2025/03/02 17:19:09 WET [2025/03/02 12:19:09 ET]
Table '3862890532 246' 8-max Seat #7 is the button
Seat 1: VVS777 (4639 in chips, $5 bounty) 
Seat 2: A5632 (7590 in chips, $5 bounty) 
Seat 3: kikokiko28 (6386 in chips, $5 bounty) 
Seat 4: loseonteturn (6618 in chips, $5 bounty) 
Seat 5: David peixe (11519 in chips, $5 bounty) 
Seat 6: xmen358 (8889 in chips, $10 bounty) 
Seat 7: Gomma133 (5388 in chips, $7.50 bounty) 
Seat 8: Kevin12345Mc (6378 in chips, $5 bounty) 
VVS777: posts the ante 15
A5632: posts the ante 15
kikokiko28: posts the ante 15
loseonteturn: posts the ante 15
David peixe: posts the ante 15
xmen358: posts the ante 15
Gomma133: posts the ante 15
Kevin12345Mc: posts the ante 15
Kevin12345Mc: posts small blind 50
VVS777: posts big blind 100
*** HOLE CARDS ***
Dealt to Kevin12345Mc [Tc Ks]
A5632: folds 
kikokiko28: folds 
loseonteturn: folds 
David peixe: folds 
xmen358: folds 
Gomma133: raises 200 to 300
Kevin12345Mc: folds 
VVS777: folds 
Uncalled bet (200) returned to Gomma133
Gomma133 collected 370 from pot
Gomma133: doesn't show hand 
*** SUMMARY ***
Total pot 370 | Rake 0 
Seat 1: VVS777 (big blind) folded before Flop
Seat 2: A5632 folded before Flop (didn't bet)
Seat 3: kikokiko28 folded before Flop (didn't bet)
Seat 4: loseonteturn folded before Flop (didn't bet)
Seat 5: David peixe folded before Flop (didn't bet)
Seat 6: xmen358 folded before Flop (didn't bet)
Seat 7: Gomma133 (button) collected (370)
Seat 8: Kevin12345Mc (small blind) folded before Flop



PokerStars Hand #255106391394: Tournament #3862890532, $4.80+$5.00+$1.20 USD Hold'em No Limit - Level VI (50/100) - 2025/03/02 17:19:34 WET [2025/03/02 12:19:34 ET]
Table '3862890532 246' 8-max Seat #8 is the button
Seat 1: VVS777 (4524 in chips, $5 bounty) 
Seat 2: A5632 (7575 in chips, $5 bounty) 
Seat 3: kikokiko28 (6371 in chips, $5 bounty) 
Seat 4: loseonteturn (6603 in chips, $5 bounty) 
Seat 5: David peixe (11504 in chips, $5 bounty) 
Seat 6: xmen358 (8874 in chips, $10 bounty) 
Seat 7: Gomma133 (5643 in chips, $7.50 bounty) 
Seat 8: Kevin12345Mc (6313 in chips, $5 bounty) 
VVS777: posts the ante 15
A5632: posts the ante 15
kikokiko28: posts the ante 15
loseonteturn: posts the ante 15
David peixe: posts the ante 15
xmen358: posts the ante 15
Gomma133: posts the ante 15
Kevin12345Mc: posts the ante 15
VVS777: posts small blind 50
A5632: posts big blind 100
*** HOLE CARDS ***
Dealt to Kevin12345Mc [8d 2c]
kikokiko28: raises 100 to 200
loseonteturn: folds 
David peixe: folds 
xmen358: folds 
Gomma133: folds 
Kevin12345Mc: folds 
VVS777: folds 
A5632: calls 100
*** FLOP *** [4h 2s 4c]
A5632: checks 
kikokiko28: checks 
*** TURN *** [4h 2s 4c] [7s]
A5632: checks 
kikokiko28: checks 
*** RIVER *** [4h 2s 4c 7s] [Ad]
A5632: checks 
kikokiko28: checks 
*** SHOW DOWN ***
A5632: shows [Jh Qc] (a pair of Fours)
kikokiko28: mucks hand 
A5632 collected 570 from pot
*** SUMMARY ***
Total pot 570 | Rake 0 
Board [4h 2s 4c 7s Ad]
Seat 1: VVS777 (small blind) folded before Flop
Seat 2: A5632 (big blind) showed [Jh Qc] and won (570) with a pair of Fours
Seat 3: kikokiko28 mucked [Jd Tc]
Seat 4: loseonteturn folded before Flop (didn't bet)
Seat 5: David peixe folded before Flop (didn't bet)
Seat 6: xmen358 folded before Flop (didn't bet)
Seat 7: Gomma133 folded before Flop (didn't bet)
Seat 8: Kevin12345Mc (button) folded before Flop (didn't bet)



PokerStars Hand #255106400308: Tournament #3862890532, $4.80+$5.00+$1.20 USD Hold'em No Limit - Level VI (50/100) - 2025/03/02 17:20:05 WET [2025/03/02 12:20:05 ET]
Table '3862890532 246' 8-max Seat #1 is the button
Seat 1: VVS777 (4459 in chips, $5 bounty) 
Seat 2: A5632 (7930 in chips, $5 bounty) 
Seat 3: kikokiko28 (6156 in chips, $5 bounty) 
Seat 4: loseonteturn (6588 in chips, $5 bounty) 
Seat 5: David peixe (11489 in chips, $5 bounty) 
Seat 6: xmen358 (8859 in chips, $10 bounty) 
Seat 7: Gomma133 (5628 in chips, $7.50 bounty) 
Seat 8: Kevin12345Mc (6298 in chips, $5 bounty) 
VVS777: posts the ante 15
A5632: posts the ante 15
kikokiko28: posts the ante 15
loseonteturn: posts the ante 15
David peixe: posts the ante 15
xmen358: posts the ante 15
Gomma133: posts the ante 15
Kevin12345Mc: posts the ante 15
A5632: posts small blind 50
kikokiko28: posts big blind 100
*** HOLE CARDS ***
Dealt to Kevin12345Mc [Qs Ah]
loseonteturn: folds 
David peixe: folds 
xmen358: folds 
Gomma133: folds 
Kevin12345Mc: raises 130 to 230
VVS777: folds 
A5632: folds 
kikokiko28: folds 
Uncalled bet (130) returned to Kevin12345Mc
Kevin12345Mc collected 370 from pot
Kevin12345Mc: doesn't show hand 
*** SUMMARY ***
Total pot 370 | Rake 0 
Seat 1: VVS777 (button) folded before Flop (didn't bet)
Seat 2: A5632 (small blind) folded before Flop
Seat 3: kikokiko28 (big blind) folded before Flop
Seat 4: loseonteturn folded before Flop (didn't bet)
Seat 5: David peixe folded before Flop (didn't bet)
Seat 6: xmen358 folded before Flop (didn't bet)
Seat 7: Gomma133 folded before Flop (didn't bet)
Seat 8: Kevin12345Mc collected (370)



PokerStars Hand #255106407625: Tournament #3862890532, $4.80+$5.00+$1.20 USD Hold'em No Limit - Level VI (50/100) - 2025/03/02 17:20:30 WET [2025/03/02 12:20:30 ET]
Table '3862890532 246' 8-max Seat #2 is the button
Seat 1: VVS777 (4444 in chips, $5 bounty) 
Seat 2: A5632 (7865 in chips, $5 bounty) 
Seat 3: kikokiko28 (6041 in chips, $5 bounty) 
Seat 4: loseonteturn (6573 in chips, $5 bounty) 
Seat 5: David peixe (11474 in chips, $5 bounty) 
Seat 6: xmen358 (8844 in chips, $10 bounty) 
Seat 7: Gomma133 (5613 in chips, $7.50 bounty) 
Seat 8: Kevin12345Mc (6553 in chips, $5 bounty) 
VVS777: posts the ante 15
A5632: posts the ante 15
kikokiko28: posts the ante 15
loseonteturn: posts the ante 15
David peixe: posts the ante 15
xmen358: posts the ante 15
Gomma133: posts the ante 15
Kevin12345Mc: posts the ante 15
kikokiko28: posts small blind 50
loseonteturn: posts big blind 100
*** HOLE CARDS ***
Dealt to Kevin12345Mc [7h 2c]
David peixe: raises 120 to 220
xmen358: folds 
Gomma133: folds 
Kevin12345Mc: folds 
VVS777: folds 
A5632: calls 220
kikokiko28: folds 
loseonteturn: raises 630 to 850
David peixe: raises 10609 to 11459 and is all-in
A5632: folds 
loseonteturn: folds 
Uncalled bet (10609) returned to David peixe
David peixe collected 2090 from pot
David peixe: doesn't show hand 
*** SUMMARY ***
Total pot 2090 | Rake 0 
Seat 1: VVS777 folded before Flop (didn't bet)
Seat 2: A5632 (button) folded before Flop
Seat 3: kikokiko28 (small blind) folded before Flop
Seat 4: loseonteturn (big blind) folded before Flop
Seat 5: David peixe collected (2090)
Seat 6: xmen358 folded before Flop (didn't bet)
Seat 7: Gomma133 folded before Flop (didn't bet)
Seat 8: Kevin12345Mc folded before Flop (didn't bet)



PokerStars Hand #255106419933: Tournament #3862890532, $4.80+$5.00+$1.20 USD Hold'em No Limit - Level VI (50/100) - 2025/03/02 17:21:11 WET [2025/03/02 12:21:11 ET]
Table '3862890532 246' 8-max Seat #3 is the button
Seat 1: VVS777 (4429 in chips, $5 bounty) 
Seat 2: A5632 (7630 in chips, $5 bounty) 
Seat 3: kikokiko28 (5976 in chips, $5 bounty) 
Seat 4: loseonteturn (5708 in chips, $5 bounty) 
Seat 5: David peixe (12699 in chips, $5 bounty) 
Seat 6: xmen358 (8829 in chips, $10 bounty) 
Seat 7: Gomma133 (5598 in chips, $7.50 bounty) 
Seat 8: Kevin12345Mc (6538 in chips, $5 bounty) 
VVS777: posts the ante 15
A5632: posts the ante 15
kikokiko28: posts the ante 15
loseonteturn: posts the ante 15
David peixe: posts the ante 15
xmen358: posts the ante 15
Gomma133: posts the ante 15
Kevin12345Mc: posts the ante 15
loseonteturn: posts small blind 50
David peixe: posts big blind 100
*** HOLE CARDS ***
Dealt to Kevin12345Mc [9h 6c]
xmen358: folds 
Gomma133: raises 100 to 200
Kevin12345Mc: folds 
VVS777: folds 
A5632: folds 
kikokiko28: raises 400 to 600
loseonteturn: folds 
David peixe: folds 
Gomma133: calls 400
*** FLOP *** [Ad As 8d]
Gomma133: checks 
kikokiko28: bets 635
Gomma133: folds 
Uncalled bet (635) returned to kikokiko28
kikokiko28 collected 1470 from pot
*** SUMMARY ***
Total pot 1470 | Rake 0 
Board [Ad As 8d]
Seat 1: VVS777 folded before Flop (didn't bet)
Seat 2: A5632 folded before Flop (didn't bet)
Seat 3: kikokiko28 (button) collected (1470)
Seat 4: loseonteturn (small blind) folded before Flop
Seat 5: David peixe (big blind) folded before Flop
Seat 6: xmen358 folded before Flop (didn't bet)
Seat 7: Gomma133 folded on the Flop
Seat 8: Kevin12345Mc folded before Flop (didn't bet)



PokerStars Hand #255106430095: Tournament #3862890532, $4.80+$5.00+$1.20 USD Hold'em No Limit - Level VI (50/100) - 2025/03/02 17:21:46 WET [2025/03/02 12:21:46 ET]
Table '3862890532 246' 8-max Seat #4 is the button
Seat 1: VVS777 (4414 in chips, $5 bounty) 
Seat 2: A5632 (7615 in chips, $5 bounty) 
Seat 3: kikokiko28 (6831 in chips, $5 bounty) 
Seat 4: loseonteturn (5643 in chips, $5 bounty) 
Seat 5: David peixe (12584 in chips, $5 bounty) 
Seat 6: xmen358 (8814 in chips, $10 bounty) 
Seat 7: Gomma133 (4983 in chips, $7.50 bounty) 
Seat 8: Kevin12345Mc (6523 in chips, $5 bounty) 
VVS777: posts the ante 15
A5632: posts the ante 15
kikokiko28: posts the ante 15
loseonteturn: posts the ante 15
David peixe: posts the ante 15
xmen358: posts the ante 15
Gomma133: posts the ante 15
Kevin12345Mc: posts the ante 15
David peixe: posts small blind 50
xmen358: posts big blind 100
*** HOLE CARDS ***
Dealt to Kevin12345Mc [7h Jd]
Gomma133: folds 
Kevin12345Mc: folds 
VVS777: raises 150 to 250
A5632: folds 
kikokiko28: calls 250
loseonteturn: folds 
David peixe: calls 200
xmen358: calls 150
*** FLOP *** [6h Qd Kh]
David peixe: checks 
xmen358: checks 
VVS777: checks 
kikokiko28: checks 
*** TURN *** [6h Qd Kh] [9c]
David peixe: checks 
xmen358: checks 
VVS777: checks 
kikokiko28: checks 
*** RIVER *** [6h Qd Kh 9c] [8s]
David peixe: checks 
xmen358: checks 
VVS777: checks 
kikokiko28: checks 
*** SHOW DOWN ***
David peixe: shows [3h 3d] (a pair of Threes)
xmen358: shows [9d Th] (a pair of Nines)
VVS777: mucks hand 
kikokiko28: mucks hand 
xmen358 collected 1120 from pot
*** SUMMARY ***
Total pot 1120 | Rake 0 
Board [6h Qd Kh 9c 8s]
Seat 1: VVS777 mucked [Ac Js]
Seat 2: A5632 folded before Flop (didn't bet)
Seat 3: kikokiko28 mucked [7s As]
Seat 4: loseonteturn (button) folded before Flop (didn't bet)
Seat 5: David peixe (small blind) showed [3h 3d] and lost with a pair of Threes
Seat 6: xmen358 (big blind) showed [9d Th] and won (1120) with a pair of Nines
Seat 7: Gomma133 folded before Flop (didn't bet)
Seat 8: Kevin12345Mc folded before Flop (didn't bet)



PokerStars Hand #255106447712: Tournament #3862890532, $4.80+$5.00+$1.20 USD Hold'em No Limit - Level VI (50/100) - 2025/03/02 17:22:45 WET [2025/03/02 12:22:45 ET]
Table '3862890532 246' 8-max Seat #5 is the button
Seat 1: VVS777 (4149 in chips, $5 bounty) 
Seat 2: A5632 (7600 in chips, $5 bounty) 
Seat 3: kikokiko28 (6566 in chips, $5 bounty) 
Seat 4: loseonteturn (5628 in chips, $5 bounty) 
Seat 5: David peixe (12319 in chips, $5 bounty) 
Seat 6: xmen358 (9669 in chips, $10 bounty) 
Seat 7: Gomma133 (4968 in chips, $7.50 bounty) 
Seat 8: Kevin12345Mc (6508 in chips, $5 bounty) 
VVS777: posts the ante 15
A5632: posts the ante 15
kikokiko28: posts the ante 15
loseonteturn: posts the ante 15
David peixe: posts the ante 15
xmen358: posts the ante 15
Gomma133: posts the ante 15
Kevin12345Mc: posts the ante 15
xmen358: posts small blind 50
Gomma133: posts big blind 100
*** HOLE CARDS ***
Dealt to Kevin12345Mc [4h 6d]
Kevin12345Mc: folds 
VVS777: folds 
A5632: raises 120 to 220
kikokiko28: folds 
loseonteturn: folds 
David peixe: folds 
xmen358: folds 
Gomma133: calls 120
*** FLOP *** [Ts 2c 8c]
Gomma133: checks 
A5632: bets 317
Gomma133: calls 317
*** TURN *** [Ts 2c 8c] [Th]
Gomma133: checks 
A5632: bets 647
Gomma133: calls 647
*** RIVER *** [Ts 2c 8c Th] [5h]
Gomma133: checks 
A5632: bets 6401 and is all-in
Gomma133: calls 3769 and is all-in
Uncalled bet (2632) returned to A5632
*** SHOW DOWN ***
A5632: shows [Tc Qs] (three of a kind, Tens)
Gomma133: shows [9h 2h] (two pair, Tens and Deuces)
A5632 collected 10076 from pot
A5632 wins $3.75 for eliminating Gomma133 and their own bounty increases by $3.75 to $8.75
Gomma133 finished the tournament
*** SUMMARY ***
Total pot 10076 | Rake 0 
Board [Ts 2c 8c Th 5h]
Seat 1: VVS777 folded before Flop (didn't bet)
Seat 2: A5632 showed [Tc Qs] and won (10076) with three of a kind, Tens
Seat 3: kikokiko28 folded before Flop (didn't bet)
Seat 4: loseonteturn folded before Flop (didn't bet)
Seat 5: David peixe (button) folded before Flop (didn't bet)
Seat 6: xmen358 (small blind) folded before Flop
Seat 7: Gomma133 (big blind) showed [9h 2h] and lost with two pair, Tens and Deuces
Seat 8: Kevin12345Mc folded before Flop (didn't bet)



PokerStars Hand #255106468634: Tournament #3862890532, $4.80+$5.00+$1.20 USD Hold'em No Limit - Level VI (50/100) - 2025/03/02 17:23:57 WET [2025/03/02 12:23:57 ET]
Table '3862890532 246' 8-max Seat #6 is the button
Seat 1: VVS777 (4134 in chips, $5 bounty) 
Seat 2: A5632 (12708 in chips, $8.75 bounty) 
Seat 3: kikokiko28 (6551 in chips, $5 bounty) 
Seat 4: loseonteturn (5613 in chips, $5 bounty) 
Seat 5: David peixe (12304 in chips, $5 bounty) 
Seat 6: xmen358 (9604 in chips, $10 bounty) 
Seat 8: Kevin12345Mc (6493 in chips, $5 bounty) 
VVS777: posts the ante 15
A5632: posts the ante 15
kikokiko28: posts the ante 15
loseonteturn: posts the ante 15
David peixe: posts the ante 15
xmen358: posts the ante 15
Kevin12345Mc: posts the ante 15
Kevin12345Mc: posts small blind 50
VVS777: posts big blind 100
*** HOLE CARDS ***
Dealt to Kevin12345Mc [8c Td]
marck1son is disconnected 
A5632: folds 
kikokiko28: folds 
loseonteturn: folds 
David peixe: folds 
xmen358: folds 
Kevin12345Mc: calls 50
VVS777: raises 250 to 350
Kevin12345Mc: folds 
Uncalled bet (250) returned to VVS777
VVS777 collected 305 from pot
VVS777: doesn't show hand 
*** SUMMARY ***
Total pot 305 | Rake 0 
Seat 1: VVS777 (big blind) collected (305)
Seat 2: A5632 folded before Flop (didn't bet)
Seat 3: kikokiko28 folded before Flop (didn't bet)
Seat 4: loseonteturn folded before Flop (didn't bet)
Seat 5: David peixe folded before Flop (didn't bet)
Seat 6: xmen358 (button) folded before Flop (didn't bet)
Seat 8: Kevin12345Mc (small blind) folded before Flop



PokerStars Hand #255106476493: Tournament #3862890532, $4.80+$5.00+$1.20 USD Hold'em No Limit - Level VI (50/100) - 2025/03/02 17:24:23 WET [2025/03/02 12:24:23 ET]
Table '3862890532 246' 8-max Seat #8 is the button
Seat 1: VVS777 (4324 in chips, $5 bounty) 
Seat 2: A5632 (12693 in chips, $8.75 bounty) 
Seat 3: kikokiko28 (6536 in chips, $5 bounty) 
Seat 4: loseonteturn (5598 in chips, $5 bounty) 
Seat 5: David peixe (12289 in chips, $5 bounty) 
Seat 6: xmen358 (9589 in chips, $10 bounty) 
Seat 7: marck1son (5000 in chips, $5 bounty) 
Seat 8: Kevin12345Mc (6378 in chips, $5 bounty) 
VVS777: posts the ante 15
A5632: posts the ante 15
kikokiko28: posts the ante 15
loseonteturn: posts the ante 15
David peixe: posts the ante 15
xmen358: posts the ante 15
marck1son: posts the ante 15
Kevin12345Mc: posts the ante 15
VVS777: posts small blind 50
A5632: posts big blind 100
*** HOLE CARDS ***
Dealt to Kevin12345Mc [7h 6c]
kikokiko28: folds 
loseonteturn: folds 
David peixe: folds 
xmen358: raises 100 to 200
marck1son: folds 
Kevin12345Mc: folds 
VVS777: folds 
A5632: raises 400 to 600
xmen358: calls 400
*** FLOP *** [7s Ts Ks]
A5632: bets 480
xmen358: calls 480
*** TURN *** [7s Ts Ks] [4c]
A5632: checks 
xmen358: checks 
*** RIVER *** [7s Ts Ks 4c] [6d]
A5632: checks 
xmen358: bets 2330
A5632: calls 2330
*** SHOW DOWN ***
xmen358: shows [4s As] (a flush, Ace high)
A5632: mucks hand 
xmen358 collected 6990 from pot
*** SUMMARY ***
Total pot 6990 | Rake 0 
Board [7s Ts Ks 4c 6d]
Seat 1: VVS777 (small blind) folded before Flop
Seat 2: A5632 (big blind) mucked [Ah Kc]
Seat 3: kikokiko28 folded before Flop (didn't bet)
Seat 4: loseonteturn folded before Flop (didn't bet)
Seat 5: David peixe folded before Flop (didn't bet)
Seat 6: xmen358 showed [4s As] and won (6990) with a flush, Ace high
Seat 7: marck1son folded before Flop (didn't bet)
Seat 8: Kevin12345Mc (button) folded before Flop (didn't bet)



PokerStars Hand #255106491038: Tournament #3862890532, $4.80+$5.00+$1.20 USD Hold'em No Limit - Level VI (50/100) - 2025/03/02 17:25:13 WET [2025/03/02 12:25:13 ET]
Table '3862890532 246' 8-max Seat #1 is the button
Seat 1: VVS777 (4259 in chips, $5 bounty) 
Seat 2: A5632 (9268 in chips, $8.75 bounty) 
Seat 3: kikokiko28 (6521 in chips, $5 bounty) 
Seat 4: loseonteturn (5583 in chips, $5 bounty) 
Seat 5: David peixe (12274 in chips, $5 bounty) 
Seat 6: xmen358 (13154 in chips, $10 bounty) 
Seat 7: marck1son (4985 in chips, $5 bounty) 
Seat 8: Kevin12345Mc (6363 in chips, $5 bounty) 
VVS777: posts the ante 15
A5632: posts the ante 15
kikokiko28: posts the ante 15
loseonteturn: posts the ante 15
David peixe: posts the ante 15
xmen358: posts the ante 15
marck1son: posts the ante 15
Kevin12345Mc: posts the ante 15
A5632: posts small blind 50
kikokiko28: posts big blind 100
*** HOLE CARDS ***
Dealt to Kevin12345Mc [5h Th]
loseonteturn: folds 
David peixe: folds 
xmen358: raises 100 to 200
marck1son: folds 
Kevin12345Mc: folds 
VVS777: calls 200
A5632: folds 
kikokiko28: calls 100
*** FLOP *** [Ks Jd 8c]
kikokiko28: checks 
xmen358: bets 385
VVS777: calls 385
kikokiko28: folds 
*** TURN *** [Ks Jd 8c] [6c]
xmen358: bets 1540
VVS777: folds 
Uncalled bet (1540) returned to xmen358
xmen358 collected 1540 from pot
xmen358: doesn't show hand 
*** SUMMARY ***
Total pot 1540 | Rake 0 
Board [Ks Jd 8c 6c]
Seat 1: VVS777 (button) folded on the Turn
Seat 2: A5632 (small blind) folded before Flop
Seat 3: kikokiko28 (big blind) folded on the Flop
Seat 4: loseonteturn folded before Flop (didn't bet)
Seat 5: David peixe folded before Flop (didn't bet)
Seat 6: xmen358 collected (1540)
Seat 7: marck1son folded before Flop (didn't bet)
Seat 8: Kevin12345Mc folded before Flop (didn't bet)



PokerStars Hand #255106507734: Tournament #3862890532, $4.80+$5.00+$1.20 USD Hold'em No Limit - Level VII (60/120) - 2025/03/02 17:26:10 WET [2025/03/02 12:26:10 ET]
Table '3862890532 246' 8-max Seat #2 is the button
Seat 1: VVS777 (3659 in chips, $5 bounty) 
Seat 2: A5632 (9203 in chips, $8.75 bounty) 
Seat 3: kikokiko28 (6306 in chips, $5 bounty) 
Seat 4: loseonteturn (5568 in chips, $5 bounty) 
Seat 5: David peixe (12259 in chips, $5 bounty) 
Seat 6: xmen358 (14094 in chips, $10 bounty) 
Seat 7: marck1son (4970 in chips, $5 bounty) 
Seat 8: Kevin12345Mc (6348 in chips, $5 bounty) 
VVS777: posts the ante 18
A5632: posts the ante 18
kikokiko28: posts the ante 18
loseonteturn: posts the ante 18
David peixe: posts the ante 18
xmen358: posts the ante 18
marck1son: posts the ante 18
Kevin12345Mc: posts the ante 18
kikokiko28: posts small blind 60
loseonteturn: posts big blind 120
*** HOLE CARDS ***
Dealt to Kevin12345Mc [3s Qh]
David peixe: folds 
xmen358: raises 120 to 240
marck1son: folds 
Kevin12345Mc: folds 
VVS777: folds 
A5632: calls 240
kikokiko28: calls 180
loseonteturn: folds 
*** FLOP *** [Ah 7d 5c]
kikokiko28: checks 
xmen358: bets 984
A5632: folds 
kikokiko28: folds 
Uncalled bet (984) returned to xmen358
xmen358 collected 984 from pot
xmen358: doesn't show hand 
*** SUMMARY ***
Total pot 984 | Rake 0 
Board [Ah 7d 5c]
Seat 1: VVS777 folded before Flop (didn't bet)
Seat 2: A5632 (button) folded on the Flop
Seat 3: kikokiko28 (small blind) folded on the Flop
Seat 4: loseonteturn (big blind) folded before Flop
Seat 5: David peixe folded before Flop (didn't bet)
Seat 6: xmen358 collected (984)
Seat 7: marck1son folded before Flop (didn't bet)
Seat 8: Kevin12345Mc folded before Flop (didn't bet)



PokerStars Hand #255106518467: Tournament #3862890532, $4.80+$5.00+$1.20 USD Hold'em No Limit - Level VII (60/120) - 2025/03/02 17:26:46 WET [2025/03/02 12:26:46 ET]
Table '3862890532 246' 8-max Seat #3 is the button
Seat 1: VVS777 (3641 in chips, $5 bounty) 
Seat 2: A5632 (8945 in chips, $8.75 bounty) 
Seat 3: kikokiko28 (6048 in chips, $5 bounty) 
Seat 4: loseonteturn (5430 in chips, $5 bounty) 
Seat 5: David peixe (12241 in chips, $5 bounty) 
Seat 6: xmen358 (14820 in chips, $10 bounty) 
Seat 7: marck1son (4952 in chips, $5 bounty) 
Seat 8: Kevin12345Mc (6330 in chips, $5 bounty) 
VVS777: posts the ante 18
A5632: posts the ante 18
kikokiko28: posts the ante 18
loseonteturn: posts the ante 18
David peixe: posts the ante 18
xmen358: posts the ante 18
marck1son: posts the ante 18
Kevin12345Mc: posts the ante 18
loseonteturn: posts small blind 60
David peixe: posts big blind 120
*** HOLE CARDS ***
Dealt to Kevin12345Mc [Tc Ks]
xmen358: folds 
marck1son: folds 
Kevin12345Mc: folds 
VVS777: folds 
A5632: raises 144 to 264
kikokiko28: folds 
loseonteturn: folds 
David peixe: calls 144
*** FLOP *** [7h Ts 9h]
David peixe: checks 
A5632: checks 
*** TURN *** [7h Ts 9h] [3s]
David peixe: bets 549
A5632: calls 549
*** RIVER *** [7h Ts 9h 3s] [7d]
David peixe: checks 
A5632: checks 
*** SHOW DOWN ***
David peixe: shows [8h Ac] (a pair of Sevens)
A5632: shows [As 5s] (a pair of Sevens)
David peixe collected 915 from pot
A5632 collected 915 from pot
*** SUMMARY ***
Total pot 1830 | Rake 0 
Board [7h Ts 9h 3s 7d]
Seat 1: VVS777 folded before Flop (didn't bet)
Seat 2: A5632 showed [As 5s] and won (915) with a pair of Sevens
Seat 3: kikokiko28 (button) folded before Flop (didn't bet)
Seat 4: loseonteturn (small blind) folded before Flop
Seat 5: David peixe (big blind) showed [8h Ac] and won (915) with a pair of Sevens
Seat 6: xmen358 folded before Flop (didn't bet)
Seat 7: marck1son folded before Flop (didn't bet)
Seat 8: Kevin12345Mc folded before Flop (didn't bet)



PokerStars Hand #255106532768: Tournament #3862890532, $4.80+$5.00+$1.20 USD Hold'em No Limit - Level VII (60/120) - 2025/03/02 17:27:35 WET [2025/03/02 12:27:35 ET]
Table '3862890532 246' 8-max Seat #4 is the button
Seat 1: VVS777 (3623 in chips, $5 bounty) 
Seat 2: A5632 (9029 in chips, $8.75 bounty) 
Seat 3: kikokiko28 (6030 in chips, $5 bounty) 
Seat 4: loseonteturn (5352 in chips, $5 bounty) 
Seat 5: David peixe (12325 in chips, $5 bounty) 
Seat 6: xmen358 (14802 in chips, $10 bounty) 
Seat 7: marck1son (4934 in chips, $5 bounty) 
Seat 8: Kevin12345Mc (6312 in chips, $5 bounty) 
VVS777: posts the ante 18
A5632: posts the ante 18
kikokiko28: posts the ante 18
loseonteturn: posts the ante 18
David peixe: posts the ante 18
xmen358: posts the ante 18
marck1son: posts the ante 18
Kevin12345Mc: posts the ante 18
David peixe: posts small blind 60
xmen358: posts big blind 120
*** HOLE CARDS ***
Dealt to Kevin12345Mc [Qc 7s]
marck1son: folds 
Kevin12345Mc: folds 
VVS777: folds 
A5632: folds 
kikokiko28 has timed out
kikokiko28: folds 
kikokiko28 is sitting out
loseonteturn: folds 
David peixe: calls 60
xmen358: checks 
*** FLOP *** [2h Kc 3d]
David peixe: bets 120
xmen358: calls 120
*** TURN *** [2h Kc 3d] [3s]
David peixe: checks 
xmen358: bets 312
David peixe: folds 
Uncalled bet (312) returned to xmen358
xmen358 collected 624 from pot
xmen358: doesn't show hand 
kikokiko28 has returned
*** SUMMARY ***
Total pot 624 | Rake 0 
Board [2h Kc 3d 3s]
Seat 1: VVS777 folded before Flop (didn't bet)
Seat 2: A5632 folded before Flop (didn't bet)
Seat 3: kikokiko28 folded before Flop (didn't bet)
Seat 4: loseonteturn (button) folded before Flop (didn't bet)
Seat 5: David peixe (small blind) folded on the Turn
Seat 6: xmen358 (big blind) collected (624)
Seat 7: marck1son folded before Flop (didn't bet)
Seat 8: Kevin12345Mc folded before Flop (didn't bet)



PokerStars Hand #255106554864: Tournament #3862890532, $4.80+$5.00+$1.20 USD Hold'em No Limit - Level VII (60/120) - 2025/03/02 17:28:50 WET [2025/03/02 12:28:50 ET]
Table '3862890532 246' 8-max Seat #5 is the button
Seat 1: VVS777 (3605 in chips, $5 bounty) 
Seat 2: A5632 (9011 in chips, $8.75 bounty) 
Seat 3: kikokiko28 (6012 in chips, $5 bounty) 
Seat 4: loseonteturn (5334 in chips, $5 bounty) 
Seat 5: David peixe (12067 in chips, $5 bounty) 
Seat 6: xmen358 (15168 in chips, $10 bounty) 
Seat 7: marck1son (4916 in chips, $5 bounty) 
Seat 8: Kevin12345Mc (6294 in chips, $5 bounty) 
VVS777: posts the ante 18
A5632: posts the ante 18
kikokiko28: posts the ante 18
loseonteturn: posts the ante 18
David peixe: posts the ante 18
xmen358: posts the ante 18
marck1son: posts the ante 18
Kevin12345Mc: posts the ante 18
xmen358: posts small blind 60
marck1son: posts big blind 120
*** HOLE CARDS ***
Dealt to Kevin12345Mc [2h Tc]
Kevin12345Mc: folds 
VVS777: folds 
A5632: raises 120 to 240
kikokiko28: folds 
loseonteturn: folds 
David peixe: calls 240
xmen358: calls 180
marck1son: calls 120
*** FLOP *** [4h Qc Kc]
xmen358: checks 
marck1son: checks 
A5632: checks 
David peixe: checks 
*** TURN *** [4h Qc Kc] [5c]
xmen358: checks 
marck1son: checks 
A5632: bets 574
David peixe: folds 
xmen358: folds 
marck1son: folds 
Uncalled bet (574) returned to A5632
A5632 collected 1104 from pot
A5632: doesn't show hand 
*** SUMMARY ***
Total pot 1104 | Rake 0 
Board [4h Qc Kc 5c]
Seat 1: VVS777 folded before Flop (didn't bet)
Seat 2: A5632 collected (1104)
Seat 3: kikokiko28 folded before Flop (didn't bet)
Seat 4: loseonteturn folded before Flop (didn't bet)
Seat 5: David peixe (button) folded on the Turn
Seat 6: xmen358 (small blind) folded on the Turn
Seat 7: marck1son (big blind) folded on the Turn
Seat 8: Kevin12345Mc folded before Flop (didn't bet)



PokerStars Hand #255106572245: Tournament #3862890532, $4.80+$5.00+$1.20 USD Hold'em No Limit - Level VII (60/120) - 2025/03/02 17:29:50 WET [2025/03/02 12:29:50 ET]
Table '3862890532 246' 8-max Seat #6 is the button
Seat 1: VVS777 (3587 in chips, $5 bounty) 
Seat 2: A5632 (9857 in chips, $8.75 bounty) 
Seat 3: kikokiko28 (5994 in chips, $5 bounty) 
Seat 4: loseonteturn (5316 in chips, $5 bounty) 
Seat 5: David peixe (11809 in chips, $5 bounty) 
Seat 6: xmen358 (14910 in chips, $10 bounty) 
Seat 7: marck1son (4658 in chips, $5 bounty) 
Seat 8: Kevin12345Mc (6276 in chips, $5 bounty) 
VVS777: posts the ante 18
A5632: posts the ante 18
kikokiko28: posts the ante 18
loseonteturn: posts the ante 18
David peixe: posts the ante 18
xmen358: posts the ante 18
marck1son: posts the ante 18
Kevin12345Mc: posts the ante 18
marck1son: posts small blind 60
Kevin12345Mc: posts big blind 120
*** HOLE CARDS ***
Dealt to Kevin12345Mc [As 4h]
VVS777: folds 
A5632: folds 
kikokiko28: folds 
loseonteturn: folds 
David peixe: folds 
xmen358: folds 
marck1son: calls 60
Kevin12345Mc: checks 
*** FLOP *** [6d 5d 9d]
marck1son: bets 120
Kevin12345Mc: calls 120
*** TURN *** [6d 5d 9d] [4c]
marck1son: checks 
Kevin12345Mc: checks 
*** RIVER *** [6d 5d 9d 4c] [Ah]
marck1son: checks 
Kevin12345Mc: bets 412
marck1son: calls 412
*** SHOW DOWN ***
Kevin12345Mc: shows [As 4h] (two pair, Aces and Fours)
marck1son: mucks hand 
Kevin12345Mc collected 1448 from pot
*** SUMMARY ***
Total pot 1448 | Rake 0 
Board [6d 5d 9d 4c Ah]
Seat 1: VVS777 folded before Flop (didn't bet)
Seat 2: A5632 folded before Flop (didn't bet)
Seat 3: kikokiko28 folded before Flop (didn't bet)
Seat 4: loseonteturn folded before Flop (didn't bet)
Seat 5: David peixe folded before Flop (didn't bet)
Seat 6: xmen358 (button) folded before Flop (didn't bet)
Seat 7: marck1son (small blind) mucked [7d 6h]
Seat 8: Kevin12345Mc (big blind) showed [As 4h] and won (1448) with two pair, Aces and Fours



PokerStars Hand #255106585866: Tournament #3862890532, $4.80+$5.00+$1.20 USD Hold'em No Limit - Level VII (60/120) - 2025/03/02 17:30:35 WET [2025/03/02 12:30:35 ET]
Table '3862890532 246' 8-max Seat #7 is the button
Seat 1: VVS777 (3569 in chips, $5 bounty) 
Seat 2: A5632 (9839 in chips, $8.75 bounty) 
Seat 3: kikokiko28 (5976 in chips, $5 bounty) 
Seat 4: loseonteturn (5298 in chips, $5 bounty) 
Seat 5: David peixe (11791 in chips, $5 bounty) 
Seat 6: xmen358 (14892 in chips, $10 bounty) 
Seat 7: marck1son (3988 in chips, $5 bounty) 
Seat 8: Kevin12345Mc (7054 in chips, $5 bounty) 
VVS777: posts the ante 18
A5632: posts the ante 18
kikokiko28: posts the ante 18
loseonteturn: posts the ante 18
David peixe: posts the ante 18
xmen358: posts the ante 18
marck1son: posts the ante 18
Kevin12345Mc: posts the ante 18
Kevin12345Mc: posts small blind 60
VVS777: posts big blind 120
*** HOLE CARDS ***
Dealt to Kevin12345Mc [Qh 3d]
A5632: folds 
kikokiko28: folds 
loseonteturn: folds 
David peixe: folds 
xmen358: folds 
marck1son: folds 
Kevin12345Mc: folds 
Uncalled bet (60) returned to VVS777
VVS777 collected 264 from pot
VVS777: doesn't show hand 
*** SUMMARY ***
Total pot 264 | Rake 0 
Seat 1: VVS777 (big blind) collected (264)
Seat 2: A5632 folded before Flop (didn't bet)
Seat 3: kikokiko28 folded before Flop (didn't bet)
Seat 4: loseonteturn folded before Flop (didn't bet)
Seat 5: David peixe folded before Flop (didn't bet)
Seat 6: xmen358 folded before Flop (didn't bet)
Seat 7: marck1son (button) folded before Flop (didn't bet)
Seat 8: Kevin12345Mc (small blind) folded before Flop



PokerStars Hand #255106590676: Tournament #3862890532, $4.80+$5.00+$1.20 USD Hold'em No Limit - Level VII (60/120) - 2025/03/02 17:30:51 WET [2025/03/02 12:30:51 ET]
Table '3862890532 246' 8-max Seat #8 is the button
Seat 1: VVS777 (3755 in chips, $5 bounty) 
Seat 2: A5632 (9821 in chips, $8.75 bounty) 
Seat 3: kikokiko28 (5958 in chips, $5 bounty) 
Seat 4: loseonteturn (5280 in chips, $5 bounty) 
Seat 5: David peixe (11773 in chips, $5 bounty) 
Seat 6: xmen358 (14874 in chips, $10 bounty) 
Seat 7: marck1son (3970 in chips, $5 bounty) 
Seat 8: Kevin12345Mc (6976 in chips, $5 bounty) 
VVS777: posts the ante 18
A5632: posts the ante 18
kikokiko28: posts the ante 18
loseonteturn: posts the ante 18
David peixe: posts the ante 18
xmen358: posts the ante 18
marck1son: posts the ante 18
Kevin12345Mc: posts the ante 18
VVS777: posts small blind 60
A5632: posts big blind 120
*** HOLE CARDS ***
Dealt to Kevin12345Mc [3h 7c]
kikokiko28: folds 
loseonteturn: folds 
David peixe: raises 132 to 252
xmen358: folds 
marck1son: folds 
Kevin12345Mc: folds 
VVS777: folds 
A5632: folds 
Uncalled bet (132) returned to David peixe
David peixe collected 444 from pot
David peixe: doesn't show hand 
*** SUMMARY ***
Total pot 444 | Rake 0 
Seat 1: VVS777 (small blind) folded before Flop
Seat 2: A5632 (big blind) folded before Flop
Seat 3: kikokiko28 folded before Flop (didn't bet)
Seat 4: loseonteturn folded before Flop (didn't bet)
Seat 5: David peixe collected (444)
Seat 6: xmen358 folded before Flop (didn't bet)
Seat 7: marck1son folded before Flop (didn't bet)
Seat 8: Kevin12345Mc (button) folded before Flop (didn't bet)



PokerStars Hand #255106598972: Tournament #3862890532, $4.80+$5.00+$1.20 USD Hold'em No Limit - Level VII (60/120) - 2025/03/02 17:31:19 WET [2025/03/02 12:31:19 ET]
Table '3862890532 246' 8-max Seat #1 is the button
Seat 1: VVS777 (3677 in chips, $5 bounty) 
Seat 2: A5632 (9683 in chips, $8.75 bounty) 
Seat 3: kikokiko28 (5940 in chips, $5 bounty) 
Seat 4: loseonteturn (5262 in chips, $5 bounty) 
Seat 5: David peixe (12079 in chips, $5 bounty) 
Seat 6: xmen358 (14856 in chips, $10 bounty) 
Seat 7: marck1son (3952 in chips, $5 bounty) 
Seat 8: Kevin12345Mc (6958 in chips, $5 bounty) 
VVS777: posts the ante 18
A5632: posts the ante 18
kikokiko28: posts the ante 18
loseonteturn: posts the ante 18
David peixe: posts the ante 18
xmen358: posts the ante 18
marck1son: posts the ante 18
Kevin12345Mc: posts the ante 18
A5632: posts small blind 60
kikokiko28: posts big blind 120
*** HOLE CARDS ***
Dealt to Kevin12345Mc [Kc 9h]
loseonteturn: folds 
David peixe: folds 
xmen358: folds 
marck1son: folds 
Kevin12345Mc: raises 156 to 276
VVS777: folds 
A5632: folds 
kikokiko28: calls 156
*** FLOP *** [9d 6d As]
kikokiko28: checks 
Kevin12345Mc: bets 249
kikokiko28: calls 249
*** TURN *** [9d 6d As] [4c]
kikokiko28: checks 
Kevin12345Mc: checks 
*** RIVER *** [9d 6d As 4c] [Qs]
kikokiko28: checks 
Kevin12345Mc: checks 
*** SHOW DOWN ***
kikokiko28: shows [6c 5c] (a pair of Sixes)
Kevin12345Mc: shows [Kc 9h] (a pair of Nines)
Kevin12345Mc collected 1254 from pot
*** SUMMARY ***
Total pot 1254 | Rake 0 
Board [9d 6d As 4c Qs]
Seat 1: VVS777 (button) folded before Flop (didn't bet)
Seat 2: A5632 (small blind) folded before Flop
Seat 3: kikokiko28 (big blind) showed [6c 5c] and lost with a pair of Sixes
Seat 4: loseonteturn folded before Flop (didn't bet)
Seat 5: David peixe folded before Flop (didn't bet)
Seat 6: xmen358 folded before Flop (didn't bet)
Seat 7: marck1son folded before Flop (didn't bet)
Seat 8: Kevin12345Mc showed [Kc 9h] and won (1254) with a pair of Nines



PokerStars Hand #255106611427: Tournament #3862890532, $4.80+$5.00+$1.20 USD Hold'em No Limit - Level VII (60/120) - 2025/03/02 17:31:59 WET [2025/03/02 12:31:59 ET]
Table '3862890532 246' 8-max Seat #2 is the button
Seat 1: VVS777 (3659 in chips, $5 bounty) 
Seat 2: A5632 (9605 in chips, $8.75 bounty) 
Seat 3: kikokiko28 (5397 in chips, $5 bounty) 
Seat 4: loseonteturn (5244 in chips, $5 bounty) 
Seat 5: David peixe (12061 in chips, $5 bounty) 
Seat 6: xmen358 (14838 in chips, $10 bounty) 
Seat 7: marck1son (3934 in chips, $5 bounty) 
Seat 8: Kevin12345Mc (7669 in chips, $5 bounty) 
VVS777: posts the ante 18
A5632: posts the ante 18
kikokiko28: posts the ante 18
loseonteturn: posts the ante 18
David peixe: posts the ante 18
xmen358: posts the ante 18
marck1son: posts the ante 18
Kevin12345Mc: posts the ante 18
kikokiko28: posts small blind 60
loseonteturn: posts big blind 120
*** HOLE CARDS ***
Dealt to Kevin12345Mc [2s 7h]
David peixe: folds 
xmen358: folds 
marck1son: folds 
Kevin12345Mc: folds 
VVS777: raises 180 to 300
A5632: folds 
kikokiko28: folds 
loseonteturn: calls 180
*** FLOP *** [8c 6h 3h]
loseonteturn: checks 
VVS777: bets 233
loseonteturn: raises 607 to 840
VVS777: calls 607
*** TURN *** [8c 6h 3h] [4h]
loseonteturn: checks 
VVS777: checks 
*** RIVER *** [8c 6h 3h 4h] [Qs]
loseonteturn: checks 
VVS777: bets 2501 and is all-in
loseonteturn: folds 
Uncalled bet (2501) returned to VVS777
VVS777 collected 2484 from pot
VVS777: doesn't show hand 
*** SUMMARY ***
Total pot 2484 | Rake 0 
Board [8c 6h 3h 4h Qs]
Seat 1: VVS777 collected (2484)
Seat 2: A5632 (button) folded before Flop (didn't bet)
Seat 3: kikokiko28 (small blind) folded before Flop
Seat 4: loseonteturn (big blind) folded on the River
Seat 5: David peixe folded before Flop (didn't bet)
Seat 6: xmen358 folded before Flop (didn't bet)
Seat 7: marck1son folded before Flop (didn't bet)
Seat 8: Kevin12345Mc folded before Flop (didn't bet)



PokerStars Hand #255106640849: Tournament #3862890532, $4.80+$5.00+$1.20 USD Hold'em No Limit - Level VIII (70/140) - 2025/03/02 17:33:37 WET [2025/03/02 12:33:37 ET]
Table '3862890532 246' 8-max Seat #3 is the button
Seat 1: VVS777 (4985 in chips, $5 bounty) 
Seat 2: A5632 (9587 in chips, $8.75 bounty) 
Seat 3: kikokiko28 (5319 in chips, $5 bounty) 
Seat 4: loseonteturn (4086 in chips, $5 bounty) 
Seat 5: David peixe (12043 in chips, $5 bounty) 
Seat 6: xmen358 (14820 in chips, $10 bounty) 
Seat 7: marck1son (3916 in chips, $5 bounty) 
Seat 8: Kevin12345Mc (7651 in chips, $5 bounty) 
VVS777: posts the ante 21
A5632: posts the ante 21
kikokiko28: posts the ante 21
loseonteturn: posts the ante 21
David peixe: posts the ante 21
xmen358: posts the ante 21
marck1son: posts the ante 21
Kevin12345Mc: posts the ante 21
loseonteturn: posts small blind 70
David peixe: posts big blind 140
*** HOLE CARDS ***
Dealt to Kevin12345Mc [5h Ad]
xmen358: folds 
marck1son: folds 
Kevin12345Mc: folds 
VVS777: folds 
A5632: folds 
kikokiko28: folds 
loseonteturn: calls 70
David peixe: checks 
*** FLOP *** [9c 4d Td]
loseonteturn: checks 
David peixe: checks 
*** TURN *** [9c 4d Td] [4s]
loseonteturn: bets 224
David peixe: folds 
Uncalled bet (224) returned to loseonteturn
loseonteturn collected 448 from pot
loseonteturn: doesn't show hand 
*** SUMMARY ***
Total pot 448 | Rake 0 
Board [9c 4d Td 4s]
Seat 1: VVS777 folded before Flop (didn't bet)
Seat 2: A5632 folded before Flop (didn't bet)
Seat 3: kikokiko28 (button) folded before Flop (didn't bet)
Seat 4: loseonteturn (small blind) collected (448)
Seat 5: David peixe (big blind) folded on the Turn
Seat 6: xmen358 folded before Flop (didn't bet)
Seat 7: marck1son folded before Flop (didn't bet)
Seat 8: Kevin12345Mc folded before Flop (didn't bet)



PokerStars Hand #255106648838: Tournament #3862890532, $4.80+$5.00+$1.20 USD Hold'em No Limit - Level VIII (70/140) - 2025/03/02 17:34:03 WET [2025/03/02 12:34:03 ET]
Table '3862890532 246' 8-max Seat #4 is the button
Seat 1: VVS777 (4964 in chips, $5 bounty) 
Seat 2: A5632 (9566 in chips, $8.75 bounty) 
Seat 3: kikokiko28 (5298 in chips, $5 bounty) 
Seat 4: loseonteturn (4373 in chips, $5 bounty) 
Seat 5: David peixe (11882 in chips, $5 bounty) 
Seat 6: xmen358 (14799 in chips, $10 bounty) 
Seat 7: marck1son (3895 in chips, $5 bounty) 
Seat 8: Kevin12345Mc (7630 in chips, $5 bounty) 
VVS777: posts the ante 21
A5632: posts the ante 21
kikokiko28: posts the ante 21
loseonteturn: posts the ante 21
David peixe: posts the ante 21
xmen358: posts the ante 21
marck1son: posts the ante 21
Kevin12345Mc: posts the ante 21
David peixe: posts small blind 70
xmen358: posts big blind 140
*** HOLE CARDS ***
Dealt to Kevin12345Mc [4h Ts]
marck1son: folds 
Kevin12345Mc: folds 
VVS777: raises 168 to 308
A5632: folds 
kikokiko28: calls 308
loseonteturn: folds 
David peixe: calls 238
xmen358: calls 168
*** FLOP *** [6d Ah 9s]
David peixe: checks 
xmen358: checks 
VVS777: checks 
kikokiko28: checks 
*** TURN *** [6d Ah 9s] [4s]
David peixe: checks 
xmen358: checks 
VVS777: checks 
kikokiko28: bets 840
David peixe: folds 
xmen358: folds 
VVS777: folds 
Uncalled bet (840) returned to kikokiko28
kikokiko28 collected 1400 from pot
*** SUMMARY ***
Total pot 1400 | Rake 0 
Board [6d Ah 9s 4s]
Seat 1: VVS777 folded on the Turn
Seat 2: A5632 folded before Flop (didn't bet)
Seat 3: kikokiko28 collected (1400)
Seat 4: loseonteturn (button) folded before Flop (didn't bet)
Seat 5: David peixe (small blind) folded on the Turn
Seat 6: xmen358 (big blind) folded on the Turn
Seat 7: marck1son folded before Flop (didn't bet)
Seat 8: Kevin12345Mc folded before Flop (didn't bet)



PokerStars Hand #255106669145: Tournament #3862890532, $4.80+$5.00+$1.20 USD Hold'em No Limit - Level VIII (70/140) - 2025/03/02 17:35:09 WET [2025/03/02 12:35:09 ET]
Table '3862890532 246' 8-max Seat #5 is the button
Seat 1: VVS777 (4635 in chips, $5 bounty) 
Seat 2: A5632 (9545 in chips, $8.75 bounty) 
Seat 3: kikokiko28 (6369 in chips, $5 bounty) 
Seat 4: loseonteturn (4352 in chips, $5 bounty) 
Seat 5: David peixe (11553 in chips, $5 bounty) 
Seat 6: xmen358 (14470 in chips, $10 bounty) 
Seat 7: marck1son (3874 in chips, $5 bounty) 
Seat 8: Kevin12345Mc (7609 in chips, $5 bounty) 
VVS777: posts the ante 21
A5632: posts the ante 21
kikokiko28: posts the ante 21
loseonteturn: posts the ante 21
David peixe: posts the ante 21
xmen358: posts the ante 21
marck1son: posts the ante 21
Kevin12345Mc: posts the ante 21
xmen358: posts small blind 70
marck1son: posts big blind 140
*** HOLE CARDS ***
Dealt to Kevin12345Mc [Jh Ts]
Kevin12345Mc: folds 
VVS777: folds 
A5632: folds 
kikokiko28: folds 
loseonteturn: folds 
David peixe: raises 154 to 294
xmen358: folds 
marck1son: folds 
Uncalled bet (154) returned to David peixe
David peixe collected 518 from pot
David peixe: doesn't show hand 
*** SUMMARY ***
Total pot 518 | Rake 0 
Seat 1: VVS777 folded before Flop (didn't bet)
Seat 2: A5632 folded before Flop (didn't bet)
Seat 3: kikokiko28 folded before Flop (didn't bet)
Seat 4: loseonteturn folded before Flop (didn't bet)
Seat 5: David peixe (button) collected (518)
Seat 6: xmen358 (small blind) folded before Flop
Seat 7: marck1son (big blind) folded before Flop
Seat 8: Kevin12345Mc folded before Flop (didn't bet)



PokerStars Hand #255106676583: Tournament #3862890532, $4.80+$5.00+$1.20 USD Hold'em No Limit - Level VIII (70/140) - 2025/03/02 17:35:34 WET [2025/03/02 12:35:34 ET]
Table '3862890532 246' 8-max Seat #6 is the button
Seat 1: VVS777 (4614 in chips, $5 bounty) 
Seat 2: A5632 (9524 in chips, $8.75 bounty) 
Seat 3: kikokiko28 (6348 in chips, $5 bounty) 
Seat 4: loseonteturn (4331 in chips, $5 bounty) 
Seat 5: David peixe (11910 in chips, $5 bounty) 
Seat 6: xmen358 (14379 in chips, $10 bounty) 
Seat 7: marck1son (3713 in chips, $5 bounty) 
Seat 8: Kevin12345Mc (7588 in chips, $5 bounty) 
VVS777: posts the ante 21
A5632: posts the ante 21
kikokiko28: posts the ante 21
loseonteturn: posts the ante 21
David peixe: posts the ante 21
xmen358: posts the ante 21
marck1son: posts the ante 21
Kevin12345Mc: posts the ante 21
marck1son: posts small blind 70
Kevin12345Mc: posts big blind 140
*** HOLE CARDS ***
Dealt to Kevin12345Mc [Js 9s]
VVS777: folds 
A5632: folds 
kikokiko28: folds 
loseonteturn: folds 
David peixe: folds 
xmen358: folds 
marck1son: calls 70
Kevin12345Mc: checks 
*** FLOP *** [4h 6h 5s]
marck1son: checks 
Kevin12345Mc: checks 
*** TURN *** [4h 6h 5s] [9d]
marck1son: bets 140
Kevin12345Mc: calls 140
*** RIVER *** [4h 6h 5s 9d] [3c]
marck1son: checks 
Kevin12345Mc: bets 240
marck1son: calls 240
*** SHOW DOWN ***
Kevin12345Mc: shows [Js 9s] (a pair of Nines)
marck1son: mucks hand 
Kevin12345Mc collected 1208 from pot
*** SUMMARY ***
Total pot 1208 | Rake 0 
Board [4h 6h 5s 9d 3c]
Seat 1: VVS777 folded before Flop (didn't bet)
Seat 2: A5632 folded before Flop (didn't bet)
Seat 3: kikokiko28 folded before Flop (didn't bet)
Seat 4: loseonteturn folded before Flop (didn't bet)
Seat 5: David peixe folded before Flop (didn't bet)
Seat 6: xmen358 (button) folded before Flop (didn't bet)
Seat 7: marck1son (small blind) mucked [Kc 8s]
Seat 8: Kevin12345Mc (big blind) showed [Js 9s] and won (1208) with a pair of Nines



PokerStars Hand #255106694244: Tournament #3862890532, $4.80+$5.00+$1.20 USD Hold'em No Limit - Level VIII (70/140) - 2025/03/02 17:36:31 WET [2025/03/02 12:36:31 ET]
Table '3862890532 246' 8-max Seat #7 is the button
Seat 1: VVS777 (4593 in chips, $5 bounty) 
Seat 2: A5632 (9503 in chips, $8.75 bounty) 
Seat 3: kikokiko28 (6327 in chips, $5 bounty) 
Seat 4: loseonteturn (4310 in chips, $5 bounty) 
Seat 5: David peixe (11889 in chips, $5 bounty) 
Seat 6: xmen358 (14358 in chips, $10 bounty) 
Seat 7: marck1son (3172 in chips, $5 bounty) 
Seat 8: Kevin12345Mc (8255 in chips, $5 bounty) 
VVS777: posts the ante 21
A5632: posts the ante 21
kikokiko28: posts the ante 21
loseonteturn: posts the ante 21
David peixe: posts the ante 21
xmen358: posts the ante 21
marck1son: posts the ante 21
Kevin12345Mc: posts the ante 21
Kevin12345Mc: posts small blind 70
VVS777: posts big blind 140
*** HOLE CARDS ***
Dealt to Kevin12345Mc [9d As]
A5632: folds 
kikokiko28: folds 
loseonteturn: folds 
David peixe: folds 
xmen358: folds 
marck1son: raises 140 to 280
Kevin12345Mc: raises 7954 to 8234 and is all-in
VVS777: folds 
marck1son: folds 
Uncalled bet (7954) returned to Kevin12345Mc
Kevin12345Mc collected 868 from pot
Kevin12345Mc: doesn't show hand 
*** SUMMARY ***
Total pot 868 | Rake 0 
Seat 1: VVS777 (big blind) folded before Flop
Seat 2: A5632 folded before Flop (didn't bet)
Seat 3: kikokiko28 folded before Flop (didn't bet)
Seat 4: loseonteturn folded before Flop (didn't bet)
Seat 5: David peixe folded before Flop (didn't bet)
Seat 6: xmen358 folded before Flop (didn't bet)
Seat 7: marck1son (button) folded before Flop
Seat 8: Kevin12345Mc (small blind) collected (868)



PokerStars Hand #255106703463: Tournament #3862890532, $4.80+$5.00+$1.20 USD Hold'em No Limit - Level VIII (70/140) - 2025/03/02 17:37:01 WET [2025/03/02 12:37:01 ET]
Table '3862890532 246' 8-max Seat #8 is the button
Seat 1: VVS777 (4432 in chips, $5 bounty) 
Seat 2: A5632 (9482 in chips, $8.75 bounty) 
Seat 3: kikokiko28 (6306 in chips, $5 bounty) 
Seat 4: loseonteturn (4289 in chips, $5 bounty) 
Seat 5: David peixe (11868 in chips, $5 bounty) 
Seat 6: xmen358 (14337 in chips, $10 bounty) 
Seat 7: marck1son (2871 in chips, $5 bounty) 
Seat 8: Kevin12345Mc (8822 in chips, $5 bounty) 
VVS777: posts the ante 21
A5632: posts the ante 21
kikokiko28: posts the ante 21
loseonteturn: posts the ante 21
David peixe: posts the ante 21
xmen358: posts the ante 21
marck1son: posts the ante 21
Kevin12345Mc: posts the ante 21
VVS777: posts small blind 70
A5632: posts big blind 140
*** HOLE CARDS ***
Dealt to Kevin12345Mc [6c 9c]
kikokiko28: raises 140 to 280
loseonteturn: folds 
David peixe: folds 
xmen358: folds 
marck1son: folds 
Kevin12345Mc: folds 
VVS777: folds 
A5632: folds 
Uncalled bet (140) returned to kikokiko28
kikokiko28 collected 518 from pot
*** SUMMARY ***
Total pot 518 | Rake 0 
Seat 1: VVS777 (small blind) folded before Flop
Seat 2: A5632 (big blind) folded before Flop
Seat 3: kikokiko28 collected (518)
Seat 4: loseonteturn folded before Flop (didn't bet)
Seat 5: David peixe folded before Flop (didn't bet)
Seat 6: xmen358 folded before Flop (didn't bet)
Seat 7: marck1son folded before Flop (didn't bet)
Seat 8: Kevin12345Mc (button) folded before Flop (didn't bet)



PokerStars Hand #255106708875: Tournament #3862890532, $4.80+$5.00+$1.20 USD Hold'em No Limit - Level VIII (70/140) - 2025/03/02 17:37:19 WET [2025/03/02 12:37:19 ET]
Table '3862890532 246' 8-max Seat #1 is the button
Seat 1: VVS777 (4341 in chips, $5 bounty) 
Seat 2: A5632 (9321 in chips, $8.75 bounty) 
Seat 3: kikokiko28 (6663 in chips, $5 bounty) 
Seat 4: loseonteturn (4268 in chips, $5 bounty) 
Seat 5: David peixe (11847 in chips, $5 bounty) 
Seat 6: xmen358 (14316 in chips, $10 bounty) 
Seat 7: marck1son (2850 in chips, $5 bounty) 
Seat 8: Kevin12345Mc (8801 in chips, $5 bounty) 
VVS777: posts the ante 21
A5632: posts the ante 21
kikokiko28: posts the ante 21
loseonteturn: posts the ante 21
David peixe: posts the ante 21
xmen358: posts the ante 21
marck1son: posts the ante 21
Kevin12345Mc: posts the ante 21
A5632: posts small blind 70
kikokiko28: posts big blind 140
*** HOLE CARDS ***
Dealt to Kevin12345Mc [2d 5h]
loseonteturn: folds 
David peixe: raises 154 to 294
xmen358: folds 
marck1son: folds 
Kevin12345Mc: folds 
VVS777: folds 
A5632: folds 
kikokiko28: folds 
Uncalled bet (154) returned to David peixe
David peixe collected 518 from pot
David peixe: doesn't show hand 
*** SUMMARY ***
Total pot 518 | Rake 0 
Seat 1: VVS777 (button) folded before Flop (didn't bet)
Seat 2: A5632 (small blind) folded before Flop
Seat 3: kikokiko28 (big blind) folded before Flop
Seat 4: loseonteturn folded before Flop (didn't bet)
Seat 5: David peixe collected (518)
Seat 6: xmen358 folded before Flop (didn't bet)
Seat 7: marck1son folded before Flop (didn't bet)
Seat 8: Kevin12345Mc folded before Flop (didn't bet)



PokerStars Hand #255106717088: Tournament #3862890532, $4.80+$5.00+$1.20 USD Hold'em No Limit - Level VIII (70/140) - 2025/03/02 17:37:46 WET [2025/03/02 12:37:46 ET]
Table '3862890532 246' 8-max Seat #2 is the button
Seat 1: VVS777 (4320 in chips, $5 bounty) 
Seat 2: A5632 (9230 in chips, $8.75 bounty) 
Seat 3: kikokiko28 (6502 in chips, $5 bounty) 
Seat 4: loseonteturn (4247 in chips, $5 bounty) 
Seat 5: David peixe (12204 in chips, $5 bounty) 
Seat 6: xmen358 (14295 in chips, $10 bounty) 
Seat 7: marck1son (2829 in chips, $5 bounty) 
Seat 8: Kevin12345Mc (8780 in chips, $5 bounty) 
VVS777: posts the ante 21
A5632: posts the ante 21
kikokiko28: posts the ante 21
loseonteturn: posts the ante 21
David peixe: posts the ante 21
xmen358: posts the ante 21
marck1son: posts the ante 21
Kevin12345Mc: posts the ante 21
kikokiko28: posts small blind 70
loseonteturn: posts big blind 140
*** HOLE CARDS ***
Dealt to Kevin12345Mc [Qc 5s]
David peixe: folds 
xmen358: folds 
marck1son: raises 140 to 280
Kevin12345Mc: folds 
VVS777: folds 
A5632: folds 
kikokiko28: folds 
loseonteturn: calls 140
*** FLOP *** [4d 6c 4c]
loseonteturn: checks 
marck1son: checks 
*** TURN *** [4d 6c 4c] [7d]
loseonteturn: checks 
marck1son: checks 
*** RIVER *** [4d 6c 4c 7d] [6d]
loseonteturn: checks 
marck1son: checks 
*** SHOW DOWN ***
loseonteturn: shows [Qd 9h] (two pair, Sixes and Fours)
marck1son: shows [Tc Kc] (two pair, Sixes and Fours - King kicker)
marck1son collected 798 from pot
*** SUMMARY ***
Total pot 798 | Rake 0 
Board [4d 6c 4c 7d 6d]
Seat 1: VVS777 folded before Flop (didn't bet)
Seat 2: A5632 (button) folded before Flop (didn't bet)
Seat 3: kikokiko28 (small blind) folded before Flop
Seat 4: loseonteturn (big blind) showed [Qd 9h] and lost with two pair, Sixes and Fours
Seat 5: David peixe folded before Flop (didn't bet)
Seat 6: xmen358 folded before Flop (didn't bet)
Seat 7: marck1son showed [Tc Kc] and won (798) with two pair, Sixes and Fours
Seat 8: Kevin12345Mc folded before Flop (didn't bet)



PokerStars Hand #255106730778: Tournament #3862890532, $4.80+$5.00+$1.20 USD Hold'em No Limit - Level VIII (70/140) - 2025/03/02 17:38:30 WET [2025/03/02 12:38:30 ET]
Table '3862890532 246' 8-max Seat #3 is the button
Seat 1: VVS777 (4299 in chips, $5 bounty) 
Seat 2: A5632 (9209 in chips, $8.75 bounty) 
Seat 3: kikokiko28 (6411 in chips, $5 bounty) 
Seat 4: loseonteturn (3946 in chips, $5 bounty) 
Seat 5: David peixe (12183 in chips, $5 bounty) 
Seat 6: xmen358 (14274 in chips, $10 bounty) 
Seat 7: marck1son (3326 in chips, $5 bounty) 
Seat 8: Kevin12345Mc (8759 in chips, $5 bounty) 
VVS777: posts the ante 21
A5632: posts the ante 21
kikokiko28: posts the ante 21
loseonteturn: posts the ante 21
David peixe: posts the ante 21
xmen358: posts the ante 21
marck1son: posts the ante 21
Kevin12345Mc: posts the ante 21
loseonteturn: posts small blind 70
David peixe: posts big blind 140
*** HOLE CARDS ***
Dealt to Kevin12345Mc [Qh 8c]
xmen358: folds 
marck1son: folds 
Kevin12345Mc: folds 
VVS777: folds 
A5632: folds 
kikokiko28: raises 140 to 280
loseonteturn: raises 560 to 840
David peixe: folds 
kikokiko28: folds 
Uncalled bet (560) returned to loseonteturn
loseonteturn collected 868 from pot
loseonteturn: doesn't show hand 
*** SUMMARY ***
Total pot 868 | Rake 0 
Seat 1: VVS777 folded before Flop (didn't bet)
Seat 2: A5632 folded before Flop (didn't bet)
Seat 3: kikokiko28 (button) folded before Flop
Seat 4: loseonteturn (small blind) collected (868)
Seat 5: David peixe (big blind) folded before Flop
Seat 6: xmen358 folded before Flop (didn't bet)
Seat 7: marck1son folded before Flop (didn't bet)
Seat 8: Kevin12345Mc folded before Flop (didn't bet)



PokerStars Hand #255106747129: Tournament #3862890532, $4.80+$5.00+$1.20 USD Hold'em No Limit - Level VIII (70/140) - 2025/03/02 17:39:23 WET [2025/03/02 12:39:23 ET]
Table '3862890532 246' 8-max Seat #4 is the button
Seat 1: VVS777 (4278 in chips, $5 bounty) 
Seat 2: A5632 (9188 in chips, $8.75 bounty) 
Seat 3: kikokiko28 (6110 in chips, $5 bounty) 
Seat 4: loseonteturn (4513 in chips, $5 bounty) 
Seat 5: David peixe (12022 in chips, $5 bounty) 
Seat 6: xmen358 (14253 in chips, $10 bounty) 
Seat 7: marck1son (3305 in chips, $5 bounty) 
Seat 8: Kevin12345Mc (8738 in chips, $5 bounty) 
VVS777: posts the ante 21
A5632: posts the ante 21
kikokiko28: posts the ante 21
loseonteturn: posts the ante 21
David peixe: posts the ante 21
xmen358: posts the ante 21
marck1son: posts the ante 21
Kevin12345Mc: posts the ante 21
David peixe: posts small blind 70
xmen358: posts big blind 140
*** HOLE CARDS ***
Dealt to Kevin12345Mc [Tc Ah]
marck1son: raises 140 to 280
Kevin12345Mc: folds 
VVS777: calls 280
A5632: folds 
kikokiko28: folds 
loseonteturn: folds 
David peixe: raises 1190 to 1470
xmen358: folds 
marck1son: folds 
VVS777: folds 
Uncalled bet (1190) returned to David peixe
David peixe collected 1148 from pot
David peixe: doesn't show hand 
*** SUMMARY ***
Total pot 1148 | Rake 0 
Seat 1: VVS777 folded before Flop
Seat 2: A5632 folded before Flop (didn't bet)
Seat 3: kikokiko28 folded before Flop (didn't bet)
Seat 4: loseonteturn (button) folded before Flop (didn't bet)
Seat 5: David peixe (small blind) collected (1148)
Seat 6: xmen358 (big blind) folded before Flop
Seat 7: marck1son folded before Flop
Seat 8: Kevin12345Mc folded before Flop (didn't bet)



PokerStars Hand #255106756969: Tournament #3862890532, $4.80+$5.00+$1.20 USD Hold'em No Limit - Level VIII (70/140) - 2025/03/02 17:39:56 WET [2025/03/02 12:39:56 ET]
Table '3862890532 246' 8-max Seat #5 is the button
Seat 1: VVS777 (3977 in chips, $5 bounty) 
Seat 2: A5632 (9167 in chips, $8.75 bounty) 
Seat 3: kikokiko28 (6089 in chips, $5 bounty) 
Seat 4: loseonteturn (4492 in chips, $5 bounty) 
Seat 5: David peixe (12869 in chips, $5 bounty) 
Seat 6: xmen358 (14092 in chips, $10 bounty) 
Seat 7: marck1son (3004 in chips, $5 bounty) 
Seat 8: Kevin12345Mc (8717 in chips, $5 bounty) 
VVS777: posts the ante 21
A5632: posts the ante 21
kikokiko28: posts the ante 21
loseonteturn: posts the ante 21
David peixe: posts the ante 21
xmen358: posts the ante 21
marck1son: posts the ante 21
Kevin12345Mc: posts the ante 21
xmen358: posts small blind 70
marck1son: posts big blind 140
*** HOLE CARDS ***
Dealt to Kevin12345Mc [Jd 7c]
Kevin12345Mc: folds 
VVS777: folds 
A5632: folds 
kikokiko28: folds 
loseonteturn: folds 
David peixe: raises 154 to 294
xmen358: folds 
marck1son: folds 
Uncalled bet (154) returned to David peixe
David peixe collected 518 from pot
David peixe: doesn't show hand 
*** SUMMARY ***
Total pot 518 | Rake 0 
Seat 1: VVS777 folded before Flop (didn't bet)
Seat 2: A5632 folded before Flop (didn't bet)
Seat 3: kikokiko28 folded before Flop (didn't bet)
Seat 4: loseonteturn folded before Flop (didn't bet)
Seat 5: David peixe (button) collected (518)
Seat 6: xmen358 (small blind) folded before Flop
Seat 7: marck1son (big blind) folded before Flop
Seat 8: Kevin12345Mc folded before Flop (didn't bet)



PokerStars Hand #255106762969: Tournament #3862890532, $4.80+$5.00+$1.20 USD Hold'em No Limit - Level VIII (70/140) - 2025/03/02 17:40:16 WET [2025/03/02 12:40:16 ET]
Table '3862890532 246' 8-max Seat #6 is the button
Seat 1: VVS777 (3956 in chips, $5 bounty) 
Seat 2: A5632 (9146 in chips, $8.75 bounty) 
Seat 3: kikokiko28 (6068 in chips, $5 bounty) 
Seat 4: loseonteturn (4471 in chips, $5 bounty) 
Seat 5: David peixe (13226 in chips, $5 bounty) 
Seat 6: xmen358 (14001 in chips, $10 bounty) 
Seat 7: marck1son (2843 in chips, $5 bounty) 
Seat 8: Kevin12345Mc (8696 in chips, $5 bounty) 
VVS777: posts the ante 21
A5632: posts the ante 21
kikokiko28: posts the ante 21
loseonteturn: posts the ante 21
David peixe: posts the ante 21
xmen358: posts the ante 21
marck1son: posts the ante 21
Kevin12345Mc: posts the ante 21
marck1son: posts small blind 70
Kevin12345Mc: posts big blind 140
*** HOLE CARDS ***
Dealt to Kevin12345Mc [2s 2d]
VVS777: folds 
A5632: raises 140 to 280
kikokiko28: calls 280
loseonteturn: raises 700 to 980
David peixe: folds 
xmen358: folds 
marck1son: folds 
Kevin12345Mc: folds 
A5632: calls 700
kikokiko28: folds 
*** FLOP *** [8h Jd 6h]
A5632: bets 8145 and is all-in
loseonteturn: calls 3470 and is all-in
Uncalled bet (4675) returned to A5632
*** TURN *** [8h Jd 6h] [6d]
*** RIVER *** [8h Jd 6h 6d] [4s]
*** SHOW DOWN ***
A5632: shows [7h 9h] (a pair of Sixes)
loseonteturn: shows [Ah Qh] (a pair of Sixes - Ace kicker)
loseonteturn collected 9558 from pot
*** SUMMARY ***
Total pot 9558 | Rake 0 
Board [8h Jd 6h 6d 4s]
Seat 1: VVS777 folded before Flop (didn't bet)
Seat 2: A5632 showed [7h 9h] and lost with a pair of Sixes
Seat 3: kikokiko28 folded before Flop
Seat 4: loseonteturn showed [Ah Qh] and won (9558) with a pair of Sixes
Seat 5: David peixe folded before Flop (didn't bet)
Seat 6: xmen358 (button) folded before Flop (didn't bet)
Seat 7: marck1son (small blind) folded before Flop
Seat 8: Kevin12345Mc (big blind) folded before Flop



PokerStars Hand #255106774627: Tournament #3862890532, $4.80+$5.00+$1.20 USD Hold'em No Limit - Level VIII (70/140) - 2025/03/02 17:40:54 WET [2025/03/02 12:40:54 ET]
Table '3862890532 246' 8-max Seat #7 is the button
Seat 1: VVS777 (3935 in chips, $5 bounty) 
Seat 2: A5632 (4675 in chips, $8.75 bounty) 
Seat 3: kikokiko28 (5767 in chips, $5 bounty) 
Seat 4: loseonteturn (9558 in chips, $5 bounty) 
Seat 5: David peixe (13205 in chips, $5 bounty) 
Seat 6: xmen358 (13980 in chips, $10 bounty) 
Seat 7: marck1son (2752 in chips, $5 bounty) 
Seat 8: Kevin12345Mc (8535 in chips, $5 bounty) 
VVS777: posts the ante 21
A5632: posts the ante 21
kikokiko28: posts the ante 21
loseonteturn: posts the ante 21
David peixe: posts the ante 21
xmen358: posts the ante 21
marck1son: posts the ante 21
Kevin12345Mc: posts the ante 21
Kevin12345Mc: posts small blind 70
VVS777: posts big blind 140
*** HOLE CARDS ***
Dealt to Kevin12345Mc [Ts 9d]
A5632: folds 
kikokiko28: folds 
loseonteturn: folds 
David peixe: folds 
xmen358: folds 
marck1son: folds 
Kevin12345Mc: calls 70
VVS777: raises 350 to 490
Kevin12345Mc: calls 350
*** FLOP *** [6h 5c Js]
Kevin12345Mc: checks 
VVS777: bets 333
Kevin12345Mc: folds 
Uncalled bet (333) returned to VVS777
VVS777 collected 1148 from pot
VVS777: doesn't show hand 
*** SUMMARY ***
Total pot 1148 | Rake 0 
Board [6h 5c Js]
Seat 1: VVS777 (big blind) collected (1148)
Seat 2: A5632 folded before Flop (didn't bet)
Seat 3: kikokiko28 folded before Flop (didn't bet)
Seat 4: loseonteturn folded before Flop (didn't bet)
Seat 5: David peixe folded before Flop (didn't bet)
Seat 6: xmen358 folded before Flop (didn't bet)
Seat 7: marck1son (button) folded before Flop (didn't bet)
Seat 8: Kevin12345Mc (small blind) folded on the Flop



PokerStars Hand #255106783608: Tournament #3862890532, $4.80+$5.00+$1.20 USD Hold'em No Limit - Level VIII (70/140) - 2025/03/02 17:41:23 WET [2025/03/02 12:41:23 ET]
Table '3862890532 246' 8-max Seat #8 is the button
Seat 1: VVS777 (4572 in chips, $5 bounty) 
Seat 2: A5632 (4654 in chips, $8.75 bounty) 
Seat 3: kikokiko28 (5746 in chips, $5 bounty) 
Seat 4: loseonteturn (9537 in chips, $5 bounty) 
Seat 5: David peixe (13184 in chips, $5 bounty) 
Seat 6: xmen358 (13959 in chips, $10 bounty) 
Seat 7: marck1son (2731 in chips, $5 bounty) 
Seat 8: Kevin12345Mc (8024 in chips, $5 bounty) 
VVS777: posts the ante 21
A5632: posts the ante 21
kikokiko28: posts the ante 21
loseonteturn: posts the ante 21
David peixe: posts the ante 21
xmen358: posts the ante 21
marck1son: posts the ante 21
Kevin12345Mc: posts the ante 21
VVS777: posts small blind 70
A5632: posts big blind 140
*** HOLE CARDS ***
Dealt to Kevin12345Mc [Js Kc]
kikokiko28: raises 140 to 280
loseonteturn: folds 
David peixe: raises 630 to 910
xmen358: folds 
marck1son: folds 
Kevin12345Mc: folds 
VVS777: folds 
A5632: folds 
kikokiko28: folds 
Uncalled bet (630) returned to David peixe
David peixe collected 938 from pot
David peixe: doesn't show hand 
*** SUMMARY ***
Total pot 938 | Rake 0 
Seat 1: VVS777 (small blind) folded before Flop
Seat 2: A5632 (big blind) folded before Flop
Seat 3: kikokiko28 folded before Flop
Seat 4: loseonteturn folded before Flop (didn't bet)
Seat 5: David peixe collected (938)
Seat 6: xmen358 folded before Flop (didn't bet)
Seat 7: marck1son folded before Flop (didn't bet)
Seat 8: Kevin12345Mc (button) folded before Flop (didn't bet)



PokerStars Hand #255106790360: Tournament #3862890532, $4.80+$5.00+$1.20 USD Hold'em No Limit - Level IX (80/160) - 2025/03/02 17:41:45 WET [2025/03/02 12:41:45 ET]
Table '3862890532 246' 8-max Seat #1 is the button
Seat 1: VVS777 (4481 in chips, $5 bounty) 
Seat 2: A5632 (4493 in chips, $8.75 bounty) 
Seat 3: kikokiko28 (5445 in chips, $5 bounty) 
Seat 4: loseonteturn (9516 in chips, $5 bounty) 
Seat 5: David peixe (13821 in chips, $5 bounty) 
Seat 6: xmen358 (13938 in chips, $10 bounty) 
Seat 7: marck1son (2710 in chips, $5 bounty) 
Seat 8: Kevin12345Mc (8003 in chips, $5 bounty) 
VVS777: posts the ante 24
A5632: posts the ante 24
kikokiko28: posts the ante 24
loseonteturn: posts the ante 24
David peixe: posts the ante 24
xmen358: posts the ante 24
marck1son: posts the ante 24
Kevin12345Mc: posts the ante 24
A5632: posts small blind 80
kikokiko28: posts big blind 160
*** HOLE CARDS ***
Dealt to Kevin12345Mc [9s 4h]
loseonteturn: folds 
David peixe: folds 
xmen358: raises 160 to 320
marck1son: folds 
Kevin12345Mc: folds 
VVS777: raises 480 to 800
A5632: folds 
kikokiko28: calls 640
xmen358: calls 480
*** FLOP *** [Ks Qd Js]
kikokiko28: checks 
xmen358: checks 
VVS777: bets 800
kikokiko28: folds 
xmen358: calls 800
*** TURN *** [Ks Qd Js] [Jc]
xmen358: checks 
VVS777: bets 2857 and is all-in
xmen358: calls 2857
*** RIVER *** [Ks Qd Js Jc] [7h]
*** SHOW DOWN ***
xmen358: shows [9d Kd] (two pair, Kings and Jacks)
VVS777: shows [Kc Qs] (two pair, Kings and Queens)
VVS777 collected 9986 from pot
*** SUMMARY ***
Total pot 9986 | Rake 0 
Board [Ks Qd Js Jc 7h]
Seat 1: VVS777 (button) showed [Kc Qs] and won (9986) with two pair, Kings and Queens
Seat 2: A5632 (small blind) folded before Flop
Seat 3: kikokiko28 (big blind) folded on the Flop
Seat 4: loseonteturn folded before Flop (didn't bet)
Seat 5: David peixe folded before Flop (didn't bet)
Seat 6: xmen358 showed [9d Kd] and lost with two pair, Kings and Jacks
Seat 7: marck1son folded before Flop (didn't bet)
Seat 8: Kevin12345Mc folded before Flop (didn't bet)



PokerStars Hand #255106809917: Tournament #3862890532, $4.80+$5.00+$1.20 USD Hold'em No Limit - Level IX (80/160) - 2025/03/02 17:42:49 WET [2025/03/02 12:42:49 ET]
Table '3862890532 246' 8-max Seat #2 is the button
Seat 1: VVS777 (9986 in chips, $5 bounty) 
Seat 2: A5632 (4389 in chips, $8.75 bounty) 
Seat 3: kikokiko28 (4621 in chips, $5 bounty) 
Seat 4: loseonteturn (9492 in chips, $5 bounty) 
Seat 5: David peixe (13797 in chips, $5 bounty) 
Seat 6: xmen358 (9457 in chips, $10 bounty) 
Seat 7: marck1son (2686 in chips, $5 bounty) 
Seat 8: Kevin12345Mc (7979 in chips, $5 bounty) 
VVS777: posts the ante 24
A5632: posts the ante 24
kikokiko28: posts the ante 24
loseonteturn: posts the ante 24
David peixe: posts the ante 24
xmen358: posts the ante 24
marck1son: posts the ante 24
Kevin12345Mc: posts the ante 24
kikokiko28: posts small blind 80
loseonteturn: posts big blind 160
*** HOLE CARDS ***
Dealt to Kevin12345Mc [4s Ah]
David peixe: raises 176 to 336
xmen358: folds 
marck1son: folds 
Kevin12345Mc: folds 
VVS777: folds 
A5632: folds 
kikokiko28: calls 256
loseonteturn: calls 176
*** FLOP *** [9c 3s 7c]
kikokiko28: checks 
loseonteturn: checks 
David peixe: checks 
*** TURN *** [9c 3s 7c] [Jd]
kikokiko28: checks 
loseonteturn: checks 
David peixe: checks 
*** RIVER *** [9c 3s 7c Jd] [5d]
kikokiko28: bets 480
loseonteturn: folds 
David peixe: calls 480
*** SHOW DOWN ***
kikokiko28: shows [Jh 2h] (a pair of Jacks)
David peixe: mucks hand 
kikokiko28 collected 2160 from pot
*** SUMMARY ***
Total pot 2160 | Rake 0 
Board [9c 3s 7c Jd 5d]
Seat 1: VVS777 folded before Flop (didn't bet)
Seat 2: A5632 (button) folded before Flop (didn't bet)
Seat 3: kikokiko28 (small blind) showed [Jh 2h] and won (2160) with a pair of Jacks
Seat 4: loseonteturn (big blind) folded on the River
Seat 5: David peixe mucked [8c 8s]
Seat 6: xmen358 folded before Flop (didn't bet)
Seat 7: marck1son folded before Flop (didn't bet)
Seat 8: Kevin12345Mc folded before Flop (didn't bet)



PokerStars Hand #255106825143: Tournament #3862890532, $4.80+$5.00+$1.20 USD Hold'em No Limit - Level IX (80/160) - 2025/03/02 17:43:40 WET [2025/03/02 12:43:40 ET]
Table '3862890532 246' 8-max Seat #3 is the button
Seat 1: VVS777 (9962 in chips, $5 bounty) 
Seat 2: A5632 (4365 in chips, $8.75 bounty) 
Seat 3: kikokiko28 (5941 in chips, $5 bounty) 
Seat 4: loseonteturn (9132 in chips, $5 bounty) 
Seat 5: David peixe (12957 in chips, $5 bounty) 
Seat 6: xmen358 (9433 in chips, $10 bounty) 
Seat 7: marck1son (2662 in chips, $5 bounty) 
Seat 8: Kevin12345Mc (7955 in chips, $5 bounty) 
VVS777: posts the ante 24
A5632: posts the ante 24
kikokiko28: posts the ante 24
loseonteturn: posts the ante 24
David peixe: posts the ante 24
xmen358: posts the ante 24
marck1son: posts the ante 24
Kevin12345Mc: posts the ante 24
loseonteturn: posts small blind 80
David peixe: posts big blind 160
*** HOLE CARDS ***
Dealt to Kevin12345Mc [Qs 9s]
xmen358: folds 
marck1son: folds 
Kevin12345Mc: raises 208 to 368
VVS777: folds 
A5632: folds 
kikokiko28: calls 368
loseonteturn: raises 1072 to 1440
David peixe: folds 
Kevin12345Mc: folds 
kikokiko28: folds 
Uncalled bet (1072) returned to loseonteturn
loseonteturn collected 1456 from pot
loseonteturn: doesn't show hand 
*** SUMMARY ***
Total pot 1456 | Rake 0 
Seat 1: VVS777 folded before Flop (didn't bet)
Seat 2: A5632 folded before Flop (didn't bet)
Seat 3: kikokiko28 (button) folded before Flop
Seat 4: loseonteturn (small blind) collected (1456)
Seat 5: David peixe (big blind) folded before Flop
Seat 6: xmen358 folded before Flop (didn't bet)
Seat 7: marck1son folded before Flop (didn't bet)
Seat 8: Kevin12345Mc folded before Flop



PokerStars Hand #255106838125: Tournament #3862890532, $4.80+$5.00+$1.20 USD Hold'em No Limit - Level IX (80/160) - 2025/03/02 17:44:22 WET [2025/03/02 12:44:22 ET]
Table '3862890532 246' 8-max Seat #4 is the button
Seat 1: VVS777 (9938 in chips, $5 bounty) 
Seat 2: A5632 (4341 in chips, $8.75 bounty) 
Seat 3: kikokiko28 (5549 in chips, $5 bounty) 
Seat 4: loseonteturn (10196 in chips, $5 bounty) 
Seat 5: David peixe (12773 in chips, $5 bounty) 
Seat 6: xmen358 (9409 in chips, $10 bounty) 
Seat 7: marck1son (2638 in chips, $5 bounty) 
Seat 8: Kevin12345Mc (7563 in chips, $5 bounty) 
VVS777: posts the ante 24
A5632: posts the ante 24
kikokiko28: posts the ante 24
loseonteturn: posts the ante 24
David peixe: posts the ante 24
xmen358: posts the ante 24
marck1son: posts the ante 24
Kevin12345Mc: posts the ante 24
David peixe: posts small blind 80
xmen358: posts big blind 160
*** HOLE CARDS ***
Dealt to Kevin12345Mc [4s 5d]
marck1son: folds 
Kevin12345Mc: folds 
VVS777: raises 240 to 400
A5632: folds 
kikokiko28: folds 
loseonteturn: folds 
David peixe: calls 320
xmen358: calls 240
*** FLOP *** [4d Kc Ac]
David peixe: checks 
xmen358: checks 
VVS777: bets 696
David peixe: folds 
xmen358: calls 696
*** TURN *** [4d Kc Ac] [6s]
xmen358: checks 
VVS777: bets 2400
xmen358: folds 
Uncalled bet (2400) returned to VVS777
VVS777 collected 2784 from pot
VVS777: doesn't show hand 
*** SUMMARY ***
Total pot 2784 | Rake 0 
Board [4d Kc Ac 6s]
Seat 1: VVS777 collected (2784)
Seat 2: A5632 folded before Flop (didn't bet)
Seat 3: kikokiko28 folded before Flop (didn't bet)
Seat 4: loseonteturn (button) folded before Flop (didn't bet)
Seat 5: David peixe (small blind) folded on the Flop
Seat 6: xmen358 (big blind) folded on the Turn
Seat 7: marck1son folded before Flop (didn't bet)
Seat 8: Kevin12345Mc folded before Flop (didn't bet)



PokerStars Hand #255106854631: Tournament #3862890532, $4.80+$5.00+$1.20 USD Hold'em No Limit - Level IX (80/160) - 2025/03/02 17:45:16 WET [2025/03/02 12:45:16 ET]
Table '3862890532 246' 8-max Seat #5 is the button
Seat 1: VVS777 (11602 in chips, $5 bounty) 
Seat 2: A5632 (4317 in chips, $8.75 bounty) 
Seat 3: kikokiko28 (5525 in chips, $5 bounty) 
Seat 4: loseonteturn (10172 in chips, $5 bounty) 
Seat 5: David peixe (12349 in chips, $5 bounty) 
Seat 6: xmen358 (8289 in chips, $10 bounty) 
Seat 7: marck1son (2614 in chips, $5 bounty) 
Seat 8: Kevin12345Mc (7539 in chips, $5 bounty) 
VVS777: posts the ante 24
A5632: posts the ante 24
kikokiko28: posts the ante 24
loseonteturn: posts the ante 24
David peixe: posts the ante 24
xmen358: posts the ante 24
marck1son: posts the ante 24
Kevin12345Mc: posts the ante 24
xmen358: posts small blind 80
marck1son: posts big blind 160
*** HOLE CARDS ***
Dealt to Kevin12345Mc [Tc 5s]
Kevin12345Mc: folds 
VVS777: folds 
A5632: folds 
kikokiko28: raises 160 to 320
loseonteturn: folds 
David peixe: folds 
xmen358: folds 
marck1son: calls 160
*** FLOP *** [8h 8d 6h]
marck1son: checks 
kikokiko28: bets 320
marck1son: raises 1950 to 2270 and is all-in
kikokiko28: folds 
Uncalled bet (1950) returned to marck1son
marck1son collected 1552 from pot
marck1son: doesn't show hand 
*** SUMMARY ***
Total pot 1552 | Rake 0 
Board [8h 8d 6h]
Seat 1: VVS777 folded before Flop (didn't bet)
Seat 2: A5632 folded before Flop (didn't bet)
Seat 3: kikokiko28 folded on the Flop
Seat 4: loseonteturn folded before Flop (didn't bet)
Seat 5: David peixe (button) folded before Flop (didn't bet)
Seat 6: xmen358 (small blind) folded before Flop
Seat 7: marck1son (big blind) collected (1552)
Seat 8: Kevin12345Mc folded before Flop (didn't bet)



PokerStars Hand #255106864564: Tournament #3862890532, $4.80+$5.00+$1.20 USD Hold'em No Limit - Level IX (80/160) - 2025/03/02 17:45:49 WET [2025/03/02 12:45:49 ET]
Table '3862890532 246' 8-max Seat #6 is the button
Seat 1: VVS777 (11578 in chips, $5 bounty) 
Seat 2: A5632 (4293 in chips, $8.75 bounty) 
Seat 3: kikokiko28 (4861 in chips, $5 bounty) 
Seat 4: loseonteturn (10148 in chips, $5 bounty) 
Seat 5: David peixe (12325 in chips, $5 bounty) 
Seat 6: xmen358 (8185 in chips, $10 bounty) 
Seat 7: marck1son (3502 in chips, $5 bounty) 
Seat 8: Kevin12345Mc (7515 in chips, $5 bounty) 
VVS777: posts the ante 24
A5632: posts the ante 24
kikokiko28: posts the ante 24
loseonteturn: posts the ante 24
David peixe: posts the ante 24
xmen358: posts the ante 24
marck1son: posts the ante 24
Kevin12345Mc: posts the ante 24
marck1son: posts small blind 80
Kevin12345Mc: posts big blind 160
*** HOLE CARDS ***
Dealt to Kevin12345Mc [Qd 4c]
VVS777: folds 
A5632: folds 
kikokiko28: folds 
loseonteturn: folds 
David peixe: folds 
xmen358: folds 
marck1son: calls 80
Kevin12345Mc: checks 
*** FLOP *** [Kd 9d As]
marck1son: bets 160
Kevin12345Mc: folds 
Uncalled bet (160) returned to marck1son
marck1son collected 512 from pot
marck1son: doesn't show hand 
*** SUMMARY ***
Total pot 512 | Rake 0 
Board [Kd 9d As]
Seat 1: VVS777 folded before Flop (didn't bet)
Seat 2: A5632 folded before Flop (didn't bet)
Seat 3: kikokiko28 folded before Flop (didn't bet)
Seat 4: loseonteturn folded before Flop (didn't bet)
Seat 5: David peixe folded before Flop (didn't bet)
Seat 6: xmen358 (button) folded before Flop (didn't bet)
Seat 7: marck1son (small blind) collected (512)
Seat 8: Kevin12345Mc (big blind) folded on the Flop



PokerStars Hand #255106879472: Tournament #3862890532, $4.80+$5.00+$1.20 USD Hold'em No Limit - Level IX (80/160) - 2025/03/02 17:46:38 WET [2025/03/02 12:46:38 ET]
Table '3862890532 246' 8-max Seat #7 is the button
Seat 1: VVS777 (11554 in chips, $5 bounty) 
Seat 2: A5632 (4269 in chips, $8.75 bounty) 
Seat 3: kikokiko28 (4837 in chips, $5 bounty) 
Seat 4: loseonteturn (10124 in chips, $5 bounty) 
Seat 5: David peixe (12301 in chips, $5 bounty) 
Seat 6: xmen358 (8161 in chips, $10 bounty) 
Seat 7: marck1son (3830 in chips, $5 bounty) 
Seat 8: Kevin12345Mc (7331 in chips, $5 bounty) 
VVS777: posts the ante 24
A5632: posts the ante 24
kikokiko28: posts the ante 24
loseonteturn: posts the ante 24
David peixe: posts the ante 24
xmen358: posts the ante 24
marck1son: posts the ante 24
Kevin12345Mc: posts the ante 24
Kevin12345Mc: posts small blind 80
VVS777: posts big blind 160
*** HOLE CARDS ***
Dealt to Kevin12345Mc [Qs 7h]
A5632: folds 
kikokiko28: raises 160 to 320
loseonteturn: folds 
David peixe: calls 320
xmen358: folds 
marck1son: folds 
Kevin12345Mc: folds 
VVS777: raises 1280 to 1600
kikokiko28: raises 3213 to 4813 and is all-in
David peixe: raises 7464 to 12277 and is all-in
VVS777: calls 9930 and is all-in
Uncalled bet (747) returned to David peixe
*** FLOP *** [5d 2h 9c]
*** TURN *** [5d 2h 9c] [6c]
*** RIVER *** [5d 2h 9c 6c] [4d]
*** SHOW DOWN ***
VVS777: shows [Ks Kc] (a pair of Kings)
David peixe: shows [Jc Jh] (a pair of Jacks)
VVS777 collected 13434 from side pot
kikokiko28: shows [Kd As] (high card Ace)
VVS777 collected 14711 from main pot
VVS777 wins $2.50 for eliminating kikokiko28 and their own bounty increases by $2.50 to $7.50
kikokiko28 finished the tournament
*** SUMMARY ***
Total pot 28145 Main pot 14711. Side pot 13434. | Rake 0 
Board [5d 2h 9c 6c 4d]
Seat 1: VVS777 (big blind) showed [Ks Kc] and won (28145) with a pair of Kings
Seat 2: A5632 folded before Flop (didn't bet)
Seat 3: kikokiko28 showed [Kd As] and lost with high card Ace
Seat 4: loseonteturn folded before Flop (didn't bet)
Seat 5: David peixe showed [Jc Jh] and lost with a pair of Jacks
Seat 6: xmen358 folded before Flop (didn't bet)
Seat 7: marck1son (button) folded before Flop (didn't bet)
Seat 8: Kevin12345Mc (small blind) folded before Flop



PokerStars Hand #255106892559: Tournament #3862890532, $4.80+$5.00+$1.20 USD Hold'em No Limit - Level IX (80/160) - 2025/03/02 17:47:22 WET [2025/03/02 12:47:22 ET]
Table '3862890532 246' 8-max Seat #8 is the button
Seat 1: VVS777 (28145 in chips, $7.50 bounty) 
Seat 2: A5632 (4245 in chips, $8.75 bounty) 
Seat 4: loseonteturn (10100 in chips, $5 bounty) 
Seat 5: David peixe (747 in chips, $5 bounty) 
Seat 6: xmen358 (8137 in chips, $10 bounty) 
Seat 7: marck1son (3806 in chips, $5 bounty) 
Seat 8: Kevin12345Mc (7227 in chips, $5 bounty) 
VVS777: posts the ante 24
A5632: posts the ante 24
loseonteturn: posts the ante 24
David peixe: posts the ante 24
xmen358: posts the ante 24
marck1son: posts the ante 24
Kevin12345Mc: posts the ante 24
VVS777: posts small blind 80
A5632: posts big blind 160
*** HOLE CARDS ***
Dealt to Kevin12345Mc [5d Js]
loseonteturn: folds 
incjr is disconnected 
David peixe: folds 
xmen358: folds 
marck1son: raises 160 to 320
Kevin12345Mc: folds 
VVS777: folds 
A5632: raises 3901 to 4221 and is all-in
marck1son: calls 3462 and is all-in
Uncalled bet (439) returned to A5632
*** FLOP *** [Th 3d 2s]
*** TURN *** [Th 3d 2s] [Qd]
*** RIVER *** [Th 3d 2s Qd] [6d]
*** SHOW DOWN ***
A5632: shows [7s 7h] (a pair of Sevens)
marck1son: shows [Td Tc] (three of a kind, Tens)
marck1son collected 7812 from pot
*** SUMMARY ***
Total pot 7812 | Rake 0 
Board [Th 3d 2s Qd 6d]
Seat 1: VVS777 (small blind) folded before Flop
Seat 2: A5632 (big blind) showed [7s 7h] and lost with a pair of Sevens
Seat 4: loseonteturn folded before Flop (didn't bet)
Seat 5: David peixe folded before Flop (didn't bet)
Seat 6: xmen358 folded before Flop (didn't bet)
Seat 7: marck1son showed [Td Tc] and won (7812) with three of a kind, Tens
Seat 8: Kevin12345Mc (button) folded before Flop (didn't bet)



PokerStars Hand #255106905147: Tournament #3862890532, $4.80+$5.00+$1.20 USD Hold'em No Limit - Level IX (80/160) - 2025/03/02 17:48:04 WET [2025/03/02 12:48:04 ET]
Table '3862890532 246' 8-max Seat #1 is the button
Seat 1: VVS777 (28041 in chips, $7.50 bounty) 
Seat 2: A5632 (439 in chips, $8.75 bounty) 
Seat 3: incjr (5000 in chips, $5 bounty) 
Seat 4: loseonteturn (10076 in chips, $5 bounty) 
Seat 5: David peixe (723 in chips, $5 bounty) 
Seat 6: xmen358 (8113 in chips, $10 bounty) 
Seat 7: marck1son (7812 in chips, $5 bounty) 
Seat 8: Kevin12345Mc (7203 in chips, $5 bounty) 
VVS777: posts the ante 24
A5632: posts the ante 24
incjr: posts the ante 24
loseonteturn: posts the ante 24
David peixe: posts the ante 24
xmen358: posts the ante 24
marck1son: posts the ante 24
Kevin12345Mc: posts the ante 24
A5632: posts small blind 80
incjr: posts big blind 160
*** HOLE CARDS ***
Dealt to Kevin12345Mc [6s 4h]
loseonteturn: folds 
David peixe: folds 
xmen358: folds 
marck1son: calls 160
Kevin12345Mc: folds 
VVS777: folds 
A5632: folds 
incjr: checks 
*** FLOP *** [Jc 5h Ac]
incjr: checks 
marck1son: bets 160
incjr: folds 
Uncalled bet (160) returned to marck1son
marck1son collected 592 from pot
marck1son: doesn't show hand 
*** SUMMARY ***
Total pot 592 | Rake 0 
Board [Jc 5h Ac]
Seat 1: VVS777 (button) folded before Flop (didn't bet)
Seat 2: A5632 (small blind) folded before Flop
Seat 3: incjr (big blind) folded on the Flop
Seat 4: loseonteturn folded before Flop (didn't bet)
Seat 5: David peixe folded before Flop (didn't bet)
Seat 6: xmen358 folded before Flop (didn't bet)
Seat 7: marck1son collected (592)
Seat 8: Kevin12345Mc folded before Flop (didn't bet)



PokerStars Hand #255106913709: Tournament #3862890532, $4.80+$5.00+$1.20 USD Hold'em No Limit - Level IX (80/160) - 2025/03/02 17:48:32 WET [2025/03/02 12:48:32 ET]
Table '3862890532 246' 8-max Seat #2 is the button
Seat 1: VVS777 (28017 in chips, $7.50 bounty) 
Seat 2: A5632 (335 in chips, $8.75 bounty) 
Seat 3: incjr (4816 in chips, $5 bounty) 
Seat 4: loseonteturn (10052 in chips, $5 bounty) 
Seat 5: David peixe (699 in chips, $5 bounty) 
Seat 6: xmen358 (8089 in chips, $10 bounty) 
Seat 7: marck1son (8220 in chips, $5 bounty) 
Seat 8: Kevin12345Mc (7179 in chips, $5 bounty) 
VVS777: posts the ante 24
A5632: posts the ante 24
incjr: posts the ante 24
loseonteturn: posts the ante 24
David peixe: posts the ante 24
xmen358: posts the ante 24
marck1son: posts the ante 24
Kevin12345Mc: posts the ante 24
incjr: posts small blind 80
loseonteturn: posts big blind 160
*** HOLE CARDS ***
Dealt to Kevin12345Mc [8c Js]
David peixe: folds 
xmen358: folds 
marck1son: folds 
Kevin12345Mc: folds 
VVS777: raises 240 to 400
A5632: folds 
incjr: folds 
loseonteturn: folds 
Uncalled bet (240) returned to VVS777
VVS777 collected 592 from pot
VVS777: doesn't show hand 
*** SUMMARY ***
Total pot 592 | Rake 0 
Seat 1: VVS777 collected (592)
Seat 2: A5632 (button) folded before Flop (didn't bet)
Seat 3: incjr (small blind) folded before Flop
Seat 4: loseonteturn (big blind) folded before Flop
Seat 5: David peixe folded before Flop (didn't bet)
Seat 6: xmen358 folded before Flop (didn't bet)
Seat 7: marck1son folded before Flop (didn't bet)
Seat 8: Kevin12345Mc folded before Flop (didn't bet)



PokerStars Hand #255106920859: Tournament #3862890532, $4.80+$5.00+$1.20 USD Hold'em No Limit - Level IX (80/160) - 2025/03/02 17:48:56 WET [2025/03/02 12:48:56 ET]
Table '3862890532 246' 8-max Seat #3 is the button
Seat 1: VVS777 (28425 in chips, $7.50 bounty) 
Seat 2: A5632 (311 in chips, $8.75 bounty) 
Seat 3: incjr (4712 in chips, $5 bounty) 
Seat 4: loseonteturn (9868 in chips, $5 bounty) 
Seat 5: David peixe (675 in chips, $5 bounty) 
Seat 6: xmen358 (8065 in chips, $10 bounty) 
Seat 7: marck1son (8196 in chips, $5 bounty) 
Seat 8: Kevin12345Mc (7155 in chips, $5 bounty) 
VVS777: posts the ante 24
A5632: posts the ante 24
incjr: posts the ante 24
loseonteturn: posts the ante 24
David peixe: posts the ante 24
xmen358: posts the ante 24
marck1son: posts the ante 24
Kevin12345Mc: posts the ante 24
loseonteturn: posts small blind 80
David peixe: posts big blind 160
*** HOLE CARDS ***
Dealt to Kevin12345Mc [4h Tc]
xmen358: folds 
marck1son: raises 160 to 320
Kevin12345Mc: folds 
VVS777: folds 
A5632: calls 287 and is all-in
incjr: calls 320
loseonteturn: folds 
David peixe: calls 160
*** FLOP *** [9s 8d 4s]
David peixe: checks 
marck1son: checks 
incjr: bets 760
David peixe: folds 
marck1son: calls 760
*** TURN *** [9s 8d 4s] [7h]
marck1son: checks 
incjr: bets 1520
marck1son: folds 
Uncalled bet (1520) returned to incjr
*** RIVER *** [9s 8d 4s 7h] [Jh]
*** SHOW DOWN ***
incjr: shows [8h Js] (two pair, Jacks and Eights)
incjr collected 1619 from side pot
A5632: shows [6c 9h] (a pair of Nines)
incjr collected 1420 from main pot
incjr wins $4.38 for eliminating A5632 and their own bounty increases by $4.37 to $9.37
A5632 finished the tournament
*** SUMMARY ***
Total pot 3039 Main pot 1420. Side pot 1619. | Rake 0 
Board [9s 8d 4s 7h Jh]
Seat 1: VVS777 folded before Flop (didn't bet)
Seat 2: A5632 showed [6c 9h] and lost with a pair of Nines
Seat 3: incjr (button) showed [8h Js] and won (3039) with two pair, Jacks and Eights
Seat 4: loseonteturn (small blind) folded before Flop
Seat 5: David peixe (big blind) folded on the Flop
Seat 6: xmen358 folded before Flop (didn't bet)
Seat 7: marck1son folded on the Turn
Seat 8: Kevin12345Mc folded before Flop (didn't bet)



PokerStars Hand #255106944832: Tournament #3862890532, $4.80+$5.00+$1.20 USD Hold'em No Limit - Level X (90/180) - 2025/03/02 17:50:15 WET [2025/03/02 12:50:15 ET]
Table '3862890532 246' 8-max Seat #4 is the button
Seat 1: VVS777 (28401 in chips, $7.50 bounty) 
Seat 3: incjr (6647 in chips, $9.37 bounty) 
Seat 4: loseonteturn (9764 in chips, $5 bounty) 
Seat 5: David peixe (331 in chips, $5 bounty) 
Seat 6: xmen358 (8041 in chips, $10 bounty) 
Seat 7: marck1son (7092 in chips, $5 bounty) 
Seat 8: Kevin12345Mc (7131 in chips, $5 bounty) 
VVS777: posts the ante 27
incjr: posts the ante 27
loseonteturn: posts the ante 27
David peixe: posts the ante 27
xmen358: posts the ante 27
marck1son: posts the ante 27
Kevin12345Mc: posts the ante 27
David peixe: posts small blind 90
xmen358: posts big blind 180
*** HOLE CARDS ***
Dealt to Kevin12345Mc [Ts Ac]
marck1son: folds 
Kevin12345Mc: raises 216 to 396
VVS777: folds 
incjr: folds 
loseonteturn: folds 
David peixe: folds 
xmen358: calls 216
*** FLOP *** [3d 6c Kh]
xmen358: checks 
Kevin12345Mc: bets 353
xmen358: calls 353
*** TURN *** [3d 6c Kh] [Jd]
xmen358: checks 
Kevin12345Mc: checks 
*** RIVER *** [3d 6c Kh Jd] [7d]
xmen358: bets 1777
Kevin12345Mc: folds 
Uncalled bet (1777) returned to xmen358
xmen358 collected 1777 from pot
xmen358: doesn't show hand 
*** SUMMARY ***
Total pot 1777 | Rake 0 
Board [3d 6c Kh Jd 7d]
Seat 1: VVS777 folded before Flop (didn't bet)
Seat 3: incjr folded before Flop (didn't bet)
Seat 4: loseonteturn (button) folded before Flop (didn't bet)
Seat 5: David peixe (small blind) folded before Flop
Seat 6: xmen358 (big blind) collected (1777)
Seat 7: marck1son folded before Flop (didn't bet)
Seat 8: Kevin12345Mc folded on the River



PokerStars Hand #255106959044: Tournament #3862890532, $4.80+$5.00+$1.20 USD Hold'em No Limit - Level X (90/180) - 2025/03/02 17:51:02 WET [2025/03/02 12:51:02 ET]
Table '3862890532 246' 8-max Seat #5 is the button
Seat 1: VVS777 (28374 in chips, $7.50 bounty) 
Seat 3: incjr (6620 in chips, $9.37 bounty) 
Seat 4: loseonteturn (9737 in chips, $5 bounty) 
Seat 5: David peixe (214 in chips, $5 bounty) 
Seat 6: xmen358 (9042 in chips, $10 bounty) 
Seat 7: marck1son (7065 in chips, $5 bounty) 
Seat 8: Kevin12345Mc (6355 in chips, $5 bounty) 
VVS777: posts the ante 27
incjr: posts the ante 27
loseonteturn: posts the ante 27
David peixe: posts the ante 27
xmen358: posts the ante 27
marck1son: posts the ante 27
Kevin12345Mc: posts the ante 27
xmen358: posts small blind 90
marck1son: posts big blind 180
*** HOLE CARDS ***
Dealt to Kevin12345Mc [Ks 2d]
Kevin12345Mc: folds 
VVS777: folds 
incjr: folds 
neoGR is disconnected 
loseonteturn: raises 270 to 450
David peixe: folds 
xmen358: folds 
marck1son: calls 270
*** FLOP *** [5c Kh Ac]
marck1son: checks 
loseonteturn: bets 630
marck1son: calls 630
*** TURN *** [5c Kh Ac] [6h]
marck1son: checks 
loseonteturn: bets 1530
marck1son: folds 
Uncalled bet (1530) returned to loseonteturn
loseonteturn collected 2439 from pot
loseonteturn: doesn't show hand 
*** SUMMARY ***
Total pot 2439 | Rake 0 
Board [5c Kh Ac 6h]
Seat 1: VVS777 folded before Flop (didn't bet)
Seat 3: incjr folded before Flop (didn't bet)
Seat 4: loseonteturn collected (2439)
Seat 5: David peixe (button) folded before Flop (didn't bet)
Seat 6: xmen358 (small blind) folded before Flop
Seat 7: marck1son (big blind) folded on the Turn
Seat 8: Kevin12345Mc folded before Flop (didn't bet)



PokerStars Hand #255106984738: Tournament #3862890532, $4.80+$5.00+$1.20 USD Hold'em No Limit - Level X (90/180) - 2025/03/02 17:52:27 WET [2025/03/02 12:52:27 ET]
Table '3862890532 246' 8-max Seat #6 is the button
Seat 1: VVS777 (28347 in chips, $7.50 bounty) 
Seat 2: neoGR (20197 in chips, $12.50 bounty) 
Seat 3: incjr (6593 in chips, $9.37 bounty) 
Seat 4: loseonteturn (11069 in chips, $5 bounty) 
Seat 5: David peixe (187 in chips, $5 bounty) 
Seat 6: xmen358 (8925 in chips, $10 bounty) 
Seat 7: marck1son (5958 in chips, $5 bounty) 
Seat 8: Kevin12345Mc (6328 in chips, $5 bounty) 
VVS777: posts the ante 27
neoGR: posts the ante 27
incjr: posts the ante 27
loseonteturn: posts the ante 27
David peixe: posts the ante 27
xmen358: posts the ante 27
marck1son: posts the ante 27
Kevin12345Mc: posts the ante 27
marck1son: posts small blind 90
Kevin12345Mc: posts big blind 180
*** HOLE CARDS ***
Dealt to Kevin12345Mc [4d 2h]
VVS777: folds 
neoGR: folds 
incjr: folds 
loseonteturn: folds 
David peixe: folds 
xmen358: folds 
marck1son: raises 360 to 540
Kevin12345Mc: folds 
Uncalled bet (360) returned to marck1son
marck1son collected 576 from pot
marck1son: doesn't show hand 
*** SUMMARY ***
Total pot 576 | Rake 0 
Seat 1: VVS777 folded before Flop (didn't bet)
Seat 2: neoGR folded before Flop (didn't bet)
Seat 3: incjr folded before Flop (didn't bet)
Seat 4: loseonteturn folded before Flop (didn't bet)
Seat 5: David peixe folded before Flop (didn't bet)
Seat 6: xmen358 (button) folded before Flop (didn't bet)
Seat 7: marck1son (small blind) collected (576)
Seat 8: Kevin12345Mc (big blind) folded before Flop



PokerStars Hand #255106993608: Tournament #3862890532, $4.80+$5.00+$1.20 USD Hold'em No Limit - Level X (90/180) - 2025/03/02 17:52:57 WET [2025/03/02 12:52:57 ET]
Table '3862890532 246' 8-max Seat #7 is the button
Seat 1: VVS777 (28320 in chips, $7.50 bounty) 
Seat 2: neoGR (20170 in chips, $12.50 bounty) 
Seat 3: incjr (6566 in chips, $9.37 bounty) 
Seat 4: loseonteturn (11042 in chips, $5 bounty) 
Seat 5: David peixe (160 in chips, $5 bounty) 
Seat 6: xmen358 (8898 in chips, $10 bounty) 
Seat 7: marck1son (6327 in chips, $5 bounty) 
Seat 8: Kevin12345Mc (6121 in chips, $5 bounty) 
VVS777: posts the ante 27
neoGR: posts the ante 27
incjr: posts the ante 27
loseonteturn: posts the ante 27
David peixe: posts the ante 27
xmen358: posts the ante 27
marck1son: posts the ante 27
Kevin12345Mc: posts the ante 27
Kevin12345Mc: posts small blind 90
VVS777: posts big blind 180
*** HOLE CARDS ***
Dealt to Kevin12345Mc [6c 5d]
neoGR: folds 
incjr: folds 
loseonteturn: folds 
David peixe: folds 
xmen358: folds 
marck1son: folds 
Kevin12345Mc: folds 
Uncalled bet (90) returned to VVS777
VVS777 collected 396 from pot
VVS777: doesn't show hand 
*** SUMMARY ***
Total pot 396 | Rake 0 
Seat 1: VVS777 (big blind) collected (396)
Seat 2: neoGR folded before Flop (didn't bet)
Seat 3: incjr folded before Flop (didn't bet)
Seat 4: loseonteturn folded before Flop (didn't bet)
Seat 5: David peixe folded before Flop (didn't bet)
Seat 6: xmen358 folded before Flop (didn't bet)
Seat 7: marck1son (button) folded before Flop (didn't bet)
Seat 8: Kevin12345Mc (small blind) folded before Flop



PokerStars Hand #255106998142: Tournament #3862890532, $4.80+$5.00+$1.20 USD Hold'em No Limit - Level X (90/180) - 2025/03/02 17:53:12 WET [2025/03/02 12:53:12 ET]
Table '3862890532 246' 8-max Seat #8 is the button
Seat 1: VVS777 (28599 in chips, $7.50 bounty) 
Seat 2: neoGR (20143 in chips, $12.50 bounty) 
Seat 3: incjr (6539 in chips, $9.37 bounty) 
Seat 4: loseonteturn (11015 in chips, $5 bounty) 
Seat 5: David peixe (133 in chips, $5 bounty) 
Seat 6: xmen358 (8871 in chips, $10 bounty) 
Seat 7: marck1son (6300 in chips, $5 bounty) 
Seat 8: Kevin12345Mc (6004 in chips, $5 bounty) 
VVS777: posts the ante 27
neoGR: posts the ante 27
incjr: posts the ante 27
loseonteturn: posts the ante 27
David peixe: posts the ante 27
xmen358: posts the ante 27
marck1son: posts the ante 27
Kevin12345Mc: posts the ante 27
VVS777: posts small blind 90
neoGR: posts big blind 180
*** HOLE CARDS ***
Dealt to Kevin12345Mc [5h Qh]
incjr: folds 
loseonteturn: folds 
David peixe: folds 
xmen358: folds 
marck1son: raises 180 to 360
Kevin12345Mc: folds 
VVS777: folds 
neoGR: calls 180
*** FLOP *** [3d 7d 9d]
neoGR: checks 
marck1son: checks 
*** TURN *** [3d 7d 9d] [4c]
neoGR: checks 
marck1son: checks 
*** RIVER *** [3d 7d 9d 4c] [7c]
neoGR: checks 
marck1son: checks 
*** SHOW DOWN ***
neoGR: shows [Jc 3c] (two pair, Sevens and Threes)
marck1son: mucks hand 
neoGR collected 1026 from pot
*** SUMMARY ***
Total pot 1026 | Rake 0 
Board [3d 7d 9d 4c 7c]
Seat 1: VVS777 (small blind) folded before Flop
Seat 2: neoGR (big blind) showed [Jc 3c] and won (1026) with two pair, Sevens and Threes
Seat 3: incjr folded before Flop (didn't bet)
Seat 4: loseonteturn folded before Flop (didn't bet)
Seat 5: David peixe folded before Flop (didn't bet)
Seat 6: xmen358 folded before Flop (didn't bet)
Seat 7: marck1son mucked [Ac Kd]
Seat 8: Kevin12345Mc (button) folded before Flop (didn't bet)



PokerStars Hand #255107010743: Tournament #3862890532, $4.80+$5.00+$1.20 USD Hold'em No Limit - Level X (90/180) - 2025/03/02 17:53:54 WET [2025/03/02 12:53:54 ET]
Table '3862890532 246' 8-max Seat #1 is the button
Seat 1: VVS777 (28482 in chips, $7.50 bounty) 
Seat 2: neoGR (20782 in chips, $12.50 bounty) 
Seat 3: incjr (6512 in chips, $9.37 bounty) 
Seat 4: loseonteturn (10988 in chips, $5 bounty) 
Seat 5: David peixe (106 in chips, $5 bounty) 
Seat 6: xmen358 (8844 in chips, $10 bounty) 
Seat 7: marck1son (5913 in chips, $5 bounty) 
Seat 8: Kevin12345Mc (5977 in chips, $5 bounty) 
VVS777: posts the ante 27
neoGR: posts the ante 27
incjr: posts the ante 27
loseonteturn: posts the ante 27
David peixe: posts the ante 27
xmen358: posts the ante 27
marck1son: posts the ante 27
Kevin12345Mc: posts the ante 27
neoGR: posts small blind 90
incjr: posts big blind 180
*** HOLE CARDS ***
Dealt to Kevin12345Mc [4c 7s]
loseonteturn: folds 
David peixe: folds 
xmen358: folds 
marck1son: folds 
Kevin12345Mc: folds 
VVS777: raises 270 to 450
neoGR: folds 
incjr: calls 270
*** FLOP *** [3c Tc 6h]
incjr: checks 
VVS777: bets 360
incjr: calls 360
*** TURN *** [3c Tc 6h] [5h]
incjr: checks 
VVS777: checks 
*** RIVER *** [3c Tc 6h 5h] [Jc]
incjr: checks 
VVS777: bets 963
incjr: folds 
Uncalled bet (963) returned to VVS777
VVS777 collected 1926 from pot
VVS777: doesn't show hand 
*** SUMMARY ***
Total pot 1926 | Rake 0 
Board [3c Tc 6h 5h Jc]
Seat 1: VVS777 (button) collected (1926)
Seat 2: neoGR (small blind) folded before Flop
Seat 3: incjr (big blind) folded on the River
Seat 4: loseonteturn folded before Flop (didn't bet)
Seat 5: David peixe folded before Flop (didn't bet)
Seat 6: xmen358 folded before Flop (didn't bet)
Seat 7: marck1son folded before Flop (didn't bet)
Seat 8: Kevin12345Mc folded before Flop (didn't bet)



PokerStars Hand #255107026330: Tournament #3862890532, $4.80+$5.00+$1.20 USD Hold'em No Limit - Level X (90/180) - 2025/03/02 17:54:45 WET [2025/03/02 12:54:45 ET]
Table '3862890532 246' 8-max Seat #2 is the button
Seat 1: VVS777 (29571 in chips, $7.50 bounty) 
Seat 2: neoGR (20665 in chips, $12.50 bounty) 
Seat 3: incjr (5675 in chips, $9.37 bounty) 
Seat 4: loseonteturn (10961 in chips, $5 bounty) 
Seat 5: David peixe (79 in chips, $5 bounty) 
Seat 6: xmen358 (8817 in chips, $10 bounty) 
Seat 7: marck1son (5886 in chips, $5 bounty) 
Seat 8: Kevin12345Mc (5950 in chips, $5 bounty) 
VVS777: posts the ante 27
neoGR: posts the ante 27
incjr: posts the ante 27
loseonteturn: posts the ante 27
David peixe: posts the ante 27
xmen358: posts the ante 27
marck1son: posts the ante 27
Kevin12345Mc: posts the ante 27
incjr: posts small blind 90
loseonteturn: posts big blind 180
*** HOLE CARDS ***
Dealt to Kevin12345Mc [6d Th]
David peixe: folds 
xmen358: folds 
marck1son: folds 
Kevin12345Mc: folds 
VVS777: raises 270 to 450
neoGR: folds 
incjr: calls 360
loseonteturn: raises 1350 to 1800
VVS777: folds 
incjr: folds 
Uncalled bet (1350) returned to loseonteturn
loseonteturn collected 1566 from pot
loseonteturn: doesn't show hand 
*** SUMMARY ***
Total pot 1566 | Rake 0 
Seat 1: VVS777 folded before Flop
Seat 2: neoGR (button) folded before Flop (didn't bet)
Seat 3: incjr (small blind) folded before Flop
Seat 4: loseonteturn (big blind) collected (1566)
Seat 5: David peixe folded before Flop (didn't bet)
Seat 6: xmen358 folded before Flop (didn't bet)
Seat 7: marck1son folded before Flop (didn't bet)
Seat 8: Kevin12345Mc folded before Flop (didn't bet)



PokerStars Hand #255107138822: Tournament #3862890532, $4.80+$5.00+$1.20 USD Hold'em No Limit - Level X (90/180) - 2025/03/02 18:03:03 WET [2025/03/02 13:03:03 ET]
Table '3862890532 246' 8-max Seat #3 is the button
Seat 1: VVS777 (29094 in chips, $7.50 bounty) 
Seat 2: neoGR (20638 in chips, $12.50 bounty) 
Seat 3: incjr (5198 in chips, $9.37 bounty) 
Seat 4: loseonteturn (12050 in chips, $5 bounty) 
Seat 5: David peixe (52 in chips, $5 bounty) 
Seat 6: xmen358 (8790 in chips, $10 bounty) 
Seat 7: marck1son (5859 in chips, $5 bounty) 
Seat 8: Kevin12345Mc (5923 in chips, $5 bounty) 
VVS777: posts the ante 27
neoGR: posts the ante 27
incjr: posts the ante 27
loseonteturn: posts the ante 27
David peixe: posts the ante 27
xmen358: posts the ante 27
marck1son: posts the ante 27
Kevin12345Mc: posts the ante 27
loseonteturn: posts small blind 90
David peixe: posts big blind 25 and is all-in
*** HOLE CARDS ***
Dealt to Kevin12345Mc [3d Qh]
xmen358: raises 270 to 360
marck1son: folds 
Kevin12345Mc: folds 
VVS777: folds 
neoGR: raises 810 to 1170
incjr: folds 
loseonteturn: folds 
xmen358: calls 810
*** FLOP *** [7c Jc Kh]
xmen358: checks 
neoGR: bets 1080
xmen358: raises 6513 to 7593 and is all-in
neoGR: calls 6513
*** TURN *** [7c Jc Kh] [Qs]
*** RIVER *** [7c Jc Kh Qs] [Th]
*** SHOW DOWN ***
xmen358: shows [6d Kc] (a pair of Kings)
neoGR: shows [Ad Ks] (a straight, Ten to Ace)
neoGR collected 17541 from side pot
David peixe: shows [Ts 2d] (a pair of Tens)
neoGR collected 316 from main pot
neoGR wins $2.50 for eliminating David peixe and their own bounty increases by $2.50 to $15
neoGR wins $5 for eliminating xmen358 and their own bounty increases by $5 to $20
xmen358 finished the tournament
David peixe finished the tournament
Razzmus is disconnected 
*** SUMMARY ***
Total pot 17857 Main pot 316. Side pot 17541. | Rake 0 
Board [7c Jc Kh Qs Th]
Seat 1: VVS777 folded before Flop (didn't bet)
Seat 2: neoGR showed [Ad Ks] and won (17857) with a straight, Ten to Ace
Seat 3: incjr (button) folded before Flop (didn't bet)
Seat 4: loseonteturn (small blind) folded before Flop
Seat 5: David peixe (big blind) showed [Ts 2d] and lost with a pair of Tens
Seat 6: xmen358 showed [6d Kc] and lost with a pair of Kings
Seat 7: marck1son folded before Flop (didn't bet)
Seat 8: Kevin12345Mc folded before Flop (didn't bet)



PokerStars Hand #255107153526: Tournament #3862890532, $4.80+$5.00+$1.20 USD Hold'em No Limit - Level X (90/180) - 2025/03/02 18:03:49 WET [2025/03/02 13:03:49 ET]
Table '3862890532 246' 8-max Seat #4 is the button
Seat 1: VVS777 (29067 in chips, $7.50 bounty) 
Seat 2: neoGR (29705 in chips, $20 bounty) 
Seat 3: incjr (5171 in chips, $9.37 bounty) 
Seat 4: loseonteturn (11933 in chips, $5 bounty) 
Seat 6: Razzmus (4892 in chips) out of hand (moved from another table into small blind)
Seat 7: marck1son (5832 in chips, $5 bounty) 
Seat 8: Kevin12345Mc (5896 in chips, $5 bounty) 
Razzmus will be allowed to play after the button
VVS777: posts the ante 27
neoGR: posts the ante 27
incjr: posts the ante 27
loseonteturn: posts the ante 27
marck1son: posts the ante 27
Kevin12345Mc: posts the ante 27
marck1son: posts small blind 90
Kevin12345Mc: posts big blind 180
*** HOLE CARDS ***
Dealt to Kevin12345Mc [Ac Ts]
VVS777: folds 
neoGR: raises 180 to 360
incjr: folds 
loseonteturn: folds 
marck1son: folds 
Kevin12345Mc: calls 180
*** FLOP *** [Ad Jd 5h]
Kevin12345Mc: checks 
neoGR: bets 379
Kevin12345Mc: calls 379
*** TURN *** [Ad Jd 5h] [4c]
Kevin12345Mc: checks 
neoGR: checks 
*** RIVER *** [Ad Jd 5h 4c] [8s]
Kevin12345Mc: bets 571
neoGR: folds 
Uncalled bet (571) returned to Kevin12345Mc
Kevin12345Mc collected 1730 from pot
Kevin12345Mc: doesn't show hand 
*** SUMMARY ***
Total pot 1730 | Rake 0 
Board [Ad Jd 5h 4c 8s]
Seat 1: VVS777 folded before Flop (didn't bet)
Seat 2: neoGR folded on the River
Seat 3: incjr folded before Flop (didn't bet)
Seat 4: loseonteturn (button) folded before Flop (didn't bet)
Seat 7: marck1son (small blind) folded before Flop
Seat 8: Kevin12345Mc (big blind) collected (1730)



PokerStars Hand #255107170123: Tournament #3862890532, $4.80+$5.00+$1.20 USD Hold'em No Limit - Level X (90/180) - 2025/03/02 18:04:43 WET [2025/03/02 13:04:43 ET]
Table '3862890532 246' 8-max Seat #7 is the button
Seat 1: VVS777 (29040 in chips, $7.50 bounty) 
Seat 2: neoGR (28939 in chips, $20 bounty) 
Seat 3: incjr (5144 in chips, $9.37 bounty) 
Seat 4: loseonteturn (11906 in chips, $5 bounty) 
Seat 5: mrbt2511 (5000 in chips, $5 bounty) 
Seat 6: Razzmus (4892 in chips, $5 bounty) 
Seat 7: marck1son (5715 in chips, $5 bounty) 
Seat 8: Kevin12345Mc (6860 in chips, $5 bounty) 
VVS777: posts the ante 27
neoGR: posts the ante 27
incjr: posts the ante 27
loseonteturn: posts the ante 27
mrbt2511: posts the ante 27
Razzmus: posts the ante 27
marck1son: posts the ante 27
Kevin12345Mc: posts the ante 27
Kevin12345Mc: posts small blind 90
VVS777: posts big blind 180
*** HOLE CARDS ***
Dealt to Kevin12345Mc [Jc Qc]
neoGR: folds 
incjr: folds 
loseonteturn: folds 
mrbt2511: folds 
Razzmus: raises 207 to 387
marck1son: folds 
Kevin12345Mc: calls 297
VVS777: raises 1233 to 1620
Razzmus: folds 
Kevin12345Mc: calls 1233
*** FLOP *** [4s Qs 5d]
Kevin12345Mc: checks 
VVS777: bets 900
Kevin12345Mc: raises 4313 to 5213 and is all-in
VVS777: folds 
Uncalled bet (4313) returned to Kevin12345Mc
Kevin12345Mc collected 5643 from pot
Kevin12345Mc: doesn't show hand 
*** SUMMARY ***
Total pot 5643 | Rake 0 
Board [4s Qs 5d]
Seat 1: VVS777 (big blind) folded on the Flop
Seat 2: neoGR folded before Flop (didn't bet)
Seat 3: incjr folded before Flop (didn't bet)
Seat 4: loseonteturn folded before Flop (didn't bet)
Seat 5: mrbt2511 folded before Flop (didn't bet)
Seat 6: Razzmus folded before Flop
Seat 7: marck1son (button) folded before Flop (didn't bet)
Seat 8: Kevin12345Mc (small blind) collected (5643)



PokerStars Hand #255107209042: Tournament #3862890532, $4.80+$5.00+$1.20 USD Hold'em No Limit - Level XI (100/200) - 2025/03/02 18:06:43 WET [2025/03/02 13:06:43 ET]
Table '3862890532 246' 8-max Seat #8 is the button
Seat 1: VVS777 (26493 in chips, $7.50 bounty) 
Seat 2: neoGR (28912 in chips, $20 bounty) 
Seat 3: incjr (5117 in chips, $9.37 bounty) 
Seat 4: loseonteturn (11879 in chips, $5 bounty) 
Seat 5: mrbt2511 (4973 in chips, $5 bounty) 
Seat 6: Razzmus (4478 in chips, $5 bounty) 
Seat 7: marck1son (5688 in chips, $5 bounty) 
Seat 8: Kevin12345Mc (9956 in chips, $5 bounty) 
VVS777: posts the ante 30
neoGR: posts the ante 30
incjr: posts the ante 30
loseonteturn: posts the ante 30
mrbt2511: posts the ante 30
Razzmus: posts the ante 30
marck1son: posts the ante 30
Kevin12345Mc: posts the ante 30
VVS777: posts small blind 100
neoGR: posts big blind 200
*** HOLE CARDS ***
Dealt to Kevin12345Mc [Qc 3h]
incjr: folds 
loseonteturn: folds 
mrbt2511: folds 
Razzmus: folds 
marck1son: raises 200 to 400
Kevin12345Mc: folds 
VVS777: folds 
neoGR: calls 200
*** FLOP *** [Jd 3c 5c]
neoGR: checks 
marck1son: checks 
*** TURN *** [Jd 3c 5c] [Ac]
neoGR: checks 
marck1son: bets 400
neoGR: folds 
Uncalled bet (400) returned to marck1son
marck1son collected 1140 from pot
marck1son: doesn't show hand 
*** SUMMARY ***
Total pot 1140 | Rake 0 
Board [Jd 3c 5c Ac]
Seat 1: VVS777 (small blind) folded before Flop
Seat 2: neoGR (big blind) folded on the Turn
Seat 3: incjr folded before Flop (didn't bet)
Seat 4: loseonteturn folded before Flop (didn't bet)
Seat 5: mrbt2511 folded before Flop (didn't bet)
Seat 6: Razzmus folded before Flop (didn't bet)
Seat 7: marck1son collected (1140)
Seat 8: Kevin12345Mc (button) folded before Flop (didn't bet)



PokerStars Hand #255107224256: Tournament #3862890532, $4.80+$5.00+$1.20 USD Hold'em No Limit - Level XI (100/200) - 2025/03/02 18:07:31 WET [2025/03/02 13:07:31 ET]
Table '3862890532 246' 8-max Seat #1 is the button
Seat 1: VVS777 (26363 in chips, $7.50 bounty) 
Seat 2: neoGR (28482 in chips, $20 bounty) 
Seat 3: incjr (5087 in chips, $9.37 bounty) 
Seat 4: loseonteturn (11849 in chips, $5 bounty) 
Seat 5: mrbt2511 (4943 in chips, $5 bounty) 
Seat 6: Razzmus (4448 in chips, $5 bounty) 
Seat 7: marck1son (6398 in chips, $5 bounty) 
Seat 8: Kevin12345Mc (9926 in chips, $5 bounty) 
VVS777: posts the ante 30
neoGR: posts the ante 30
incjr: posts the ante 30
loseonteturn: posts the ante 30
mrbt2511: posts the ante 30
Razzmus: posts the ante 30
marck1son: posts the ante 30
Kevin12345Mc: posts the ante 30
neoGR: posts small blind 100
incjr: posts big blind 200
*** HOLE CARDS ***
Dealt to Kevin12345Mc [9d Ad]
loseonteturn: folds 
mrbt2511: raises 200 to 400
Razzmus: folds 
marck1son: folds 
Kevin12345Mc: calls 400
VVS777: folds 
neoGR: folds 
incjr: calls 200
*** FLOP *** [Ah 2h Qc]
incjr: checks 
mrbt2511: checks 
Kevin12345Mc: checks 
*** TURN *** [Ah 2h Qc] [9s]
incjr: checks 
mrbt2511: bets 500
Kevin12345Mc: raises 1038 to 1538
incjr: folds 
mrbt2511: calls 1038
*** RIVER *** [Ah 2h Qc 9s] [Tc]
mrbt2511: checks 
Kevin12345Mc: bets 4616
mrbt2511: folds 
Uncalled bet (4616) returned to Kevin12345Mc
Kevin12345Mc collected 4616 from pot
Kevin12345Mc: doesn't show hand 
*** SUMMARY ***
Total pot 4616 | Rake 0 
Board [Ah 2h Qc 9s Tc]
Seat 1: VVS777 (button) folded before Flop (didn't bet)
Seat 2: neoGR (small blind) folded before Flop
Seat 3: incjr (big blind) folded on the Turn
Seat 4: loseonteturn folded before Flop (didn't bet)
Seat 5: mrbt2511 folded on the River
Seat 6: Razzmus folded before Flop (didn't bet)
Seat 7: marck1son folded before Flop (didn't bet)
Seat 8: Kevin12345Mc collected (4616)



PokerStars Hand #255107251731: Tournament #3862890532, $4.80+$5.00+$1.20 USD Hold'em No Limit - Level XI (100/200) - 2025/03/02 18:08:58 WET [2025/03/02 13:08:58 ET]
Table '3862890532 246' 8-max Seat #2 is the button
Seat 1: VVS777 (26333 in chips, $7.50 bounty) 
Seat 2: neoGR (28352 in chips, $20 bounty) 
Seat 3: incjr (4657 in chips, $9.37 bounty) 
Seat 4: loseonteturn (11819 in chips, $5 bounty) 
Seat 5: mrbt2511 (2975 in chips, $5 bounty) 
Seat 6: Razzmus (4418 in chips, $5 bounty) 
Seat 7: marck1son (6368 in chips, $5 bounty) 
Seat 8: Kevin12345Mc (12574 in chips, $5 bounty) 
VVS777: posts the ante 30
neoGR: posts the ante 30
incjr: posts the ante 30
loseonteturn: posts the ante 30
mrbt2511: posts the ante 30
Razzmus: posts the ante 30
marck1son: posts the ante 30
Kevin12345Mc: posts the ante 30
incjr: posts small blind 100
loseonteturn: posts big blind 200
*** HOLE CARDS ***
Dealt to Kevin12345Mc [5c 4c]
mrbt2511: folds 
Razzmus: folds 
marck1son: folds 
Kevin12345Mc: folds 
VVS777: raises 300 to 500
neoGR: folds 
incjr: calls 400
loseonteturn: folds 
*** FLOP *** [7h 4d 3c]
incjr: checks 
VVS777: bets 600
incjr: folds 
Uncalled bet (600) returned to VVS777
VVS777 collected 1440 from pot
VVS777: doesn't show hand 
*** SUMMARY ***
Total pot 1440 | Rake 0 
Board [7h 4d 3c]
Seat 1: VVS777 collected (1440)
Seat 2: neoGR (button) folded before Flop (didn't bet)
Seat 3: incjr (small blind) folded on the Flop
Seat 4: loseonteturn (big blind) folded before Flop
Seat 5: mrbt2511 folded before Flop (didn't bet)
Seat 6: Razzmus folded before Flop (didn't bet)
Seat 7: marck1son folded before Flop (didn't bet)
Seat 8: Kevin12345Mc folded before Flop (didn't bet)



PokerStars Hand #255107264285: Tournament #3862890532, $4.80+$5.00+$1.20 USD Hold'em No Limit - Level XI (100/200) - 2025/03/02 18:09:37 WET [2025/03/02 13:09:37 ET]
Table '3862890532 246' 8-max Seat #3 is the button
Seat 1: VVS777 (27243 in chips, $7.50 bounty) 
Seat 2: neoGR (28322 in chips, $20 bounty) 
Seat 3: incjr (4127 in chips, $9.37 bounty) 
Seat 4: loseonteturn (11589 in chips, $5 bounty) 
Seat 5: mrbt2511 (2945 in chips, $5 bounty) 
Seat 6: Razzmus (4388 in chips, $5 bounty) 
Seat 7: marck1son (6338 in chips, $5 bounty) 
Seat 8: Kevin12345Mc (12544 in chips, $5 bounty) 
VVS777: posts the ante 30
neoGR: posts the ante 30
incjr: posts the ante 30
loseonteturn: posts the ante 30
mrbt2511: posts the ante 30
Razzmus: posts the ante 30
marck1son: posts the ante 30
Kevin12345Mc: posts the ante 30
loseonteturn: posts small blind 100
mrbt2511: posts big blind 200
*** HOLE CARDS ***
Dealt to Kevin12345Mc [Td 5s]
Razzmus: raises 230 to 430
marck1son: folds 
Kevin12345Mc: folds 
VVS777: calls 430
neoGR: folds 
incjr: folds 
loseonteturn: raises 1570 to 2000
mrbt2511: folds 
Razzmus: raises 2358 to 4358 and is all-in
VVS777: folds 
loseonteturn: calls 2358
*** FLOP *** [5d Jh 6c]
*** TURN *** [5d Jh 6c] [3s]
*** RIVER *** [5d Jh 6c 3s] [7s]
*** SHOW DOWN ***
loseonteturn: shows [As Kh] (high card Ace)
Razzmus: shows [Ad Ah] (a pair of Aces)
Razzmus collected 9586 from pot
*** SUMMARY ***
Total pot 9586 | Rake 0 
Board [5d Jh 6c 3s 7s]
Seat 1: VVS777 folded before Flop
Seat 2: neoGR folded before Flop (didn't bet)
Seat 3: incjr (button) folded before Flop (didn't bet)
Seat 4: loseonteturn (small blind) showed [As Kh] and lost with high card Ace
Seat 5: mrbt2511 (big blind) folded before Flop
Seat 6: Razzmus showed [Ad Ah] and won (9586) with a pair of Aces
Seat 7: marck1son folded before Flop (didn't bet)
Seat 8: Kevin12345Mc folded before Flop (didn't bet)



PokerStars Hand #255107282157: Tournament #3862890532, $4.80+$5.00+$1.20 USD Hold'em No Limit - Level XI (100/200) - 2025/03/02 18:10:32 WET [2025/03/02 13:10:32 ET]
Table '3862890532 246' 8-max Seat #4 is the button
Seat 1: VVS777 (26783 in chips, $7.50 bounty) 
Seat 2: neoGR (28292 in chips, $20 bounty) 
Seat 3: incjr (4097 in chips, $9.37 bounty) 
Seat 4: loseonteturn (7201 in chips, $5 bounty) 
Seat 5: mrbt2511 (2715 in chips, $5 bounty) 
Seat 6: Razzmus (9586 in chips, $5 bounty) 
Seat 7: marck1son (6308 in chips, $5 bounty) 
Seat 8: Kevin12345Mc (12514 in chips, $5 bounty) 
VVS777: posts the ante 30
neoGR: posts the ante 30
incjr: posts the ante 30
loseonteturn: posts the ante 30
mrbt2511: posts the ante 30
Razzmus: posts the ante 30
marck1son: posts the ante 30
Kevin12345Mc: posts the ante 30
mrbt2511: posts small blind 100
Razzmus: posts big blind 200
*** HOLE CARDS ***
Dealt to Kevin12345Mc [5d Ac]
marck1son: folds 
Kevin12345Mc: folds 
VVS777: folds 
neoGR: folds 
incjr: folds 
loseonteturn: folds 
mrbt2511: folds 
Uncalled bet (100) returned to Razzmus
Razzmus collected 440 from pot
Razzmus: doesn't show hand 
*** SUMMARY ***
Total pot 440 | Rake 0 
Seat 1: VVS777 folded before Flop (didn't bet)
Seat 2: neoGR folded before Flop (didn't bet)
Seat 3: incjr folded before Flop (didn't bet)
Seat 4: loseonteturn (button) folded before Flop (didn't bet)
Seat 5: mrbt2511 (small blind) folded before Flop
Seat 6: Razzmus (big blind) collected (440)
Seat 7: marck1son folded before Flop (didn't bet)
Seat 8: Kevin12345Mc folded before Flop (didn't bet)



PokerStars Hand #255107291455: Tournament #3862890532, $4.80+$5.00+$1.20 USD Hold'em No Limit - Level XI (100/200) - 2025/03/02 18:11:01 WET [2025/03/02 13:11:01 ET]
Table '3862890532 246' 8-max Seat #5 is the button
Seat 1: VVS777 (26753 in chips, $7.50 bounty) 
Seat 2: neoGR (28262 in chips, $20 bounty) 
Seat 3: incjr (4067 in chips, $9.37 bounty) 
Seat 4: loseonteturn (7171 in chips, $5 bounty) 
Seat 5: mrbt2511 (2585 in chips, $5 bounty) 
Seat 6: Razzmus (9896 in chips, $5 bounty) 
Seat 7: marck1son (6278 in chips, $5 bounty) 
Seat 8: Kevin12345Mc (12484 in chips, $5 bounty) 
VVS777: posts the ante 30
neoGR: posts the ante 30
incjr: posts the ante 30
loseonteturn: posts the ante 30
mrbt2511: posts the ante 30
Razzmus: posts the ante 30
marck1son: posts the ante 30
Kevin12345Mc: posts the ante 30
Razzmus: posts small blind 100
marck1son: posts big blind 200
*** HOLE CARDS ***
Dealt to Kevin12345Mc [2d 8h]
Kevin12345Mc: folds 
VVS777: folds 
neoGR: folds 
incjr: folds 
loseonteturn: folds 
mrbt2511: folds 
Razzmus: folds 
Uncalled bet (100) returned to marck1son
marck1son collected 440 from pot
marck1son: doesn't show hand 
*** SUMMARY ***
Total pot 440 | Rake 0 
Seat 1: VVS777 folded before Flop (didn't bet)
Seat 2: neoGR folded before Flop (didn't bet)
Seat 3: incjr folded before Flop (didn't bet)
Seat 4: loseonteturn folded before Flop (didn't bet)
Seat 5: mrbt2511 (button) folded before Flop (didn't bet)
Seat 6: Razzmus (small blind) folded before Flop
Seat 7: marck1son (big blind) collected (440)
Seat 8: Kevin12345Mc folded before Flop (didn't bet)



PokerStars Hand #255107295790: Tournament #3862890532, $4.80+$5.00+$1.20 USD Hold'em No Limit - Level XI (100/200) - 2025/03/02 18:11:15 WET [2025/03/02 13:11:15 ET]
Table '3862890532 246' 8-max Seat #6 is the button
Seat 1: VVS777 (26723 in chips, $7.50 bounty) 
Seat 2: neoGR (28232 in chips, $20 bounty) 
Seat 3: incjr (4037 in chips, $9.37 bounty) 
Seat 4: loseonteturn (7141 in chips, $5 bounty) 
Seat 5: mrbt2511 (2555 in chips, $5 bounty) 
Seat 6: Razzmus (9766 in chips, $5 bounty) 
Seat 7: marck1son (6588 in chips, $5 bounty) 
Seat 8: Kevin12345Mc (12454 in chips, $5 bounty) 
VVS777: posts the ante 30
neoGR: posts the ante 30
incjr: posts the ante 30
loseonteturn: posts the ante 30
mrbt2511: posts the ante 30
Razzmus: posts the ante 30
marck1son: posts the ante 30
Kevin12345Mc: posts the ante 30
marck1son: posts small blind 100
Kevin12345Mc: posts big blind 200
*** HOLE CARDS ***
Dealt to Kevin12345Mc [Ts 5s]
VVS777: folds 
neoGR: folds 
incjr: folds 
loseonteturn: folds 
mrbt2511: folds 
Razzmus: folds 
marck1son: raises 400 to 600
Kevin12345Mc: calls 400
*** FLOP *** [Tc 2d 2h]
marck1son: bets 720
Kevin12345Mc: calls 720
*** TURN *** [Tc 2d 2h] [Ah]
marck1son: checks 
Kevin12345Mc: checks 
*** RIVER *** [Tc 2d 2h Ah] [9d]
marck1son: checks 
Kevin12345Mc: bets 950
marck1son: calls 950
*** SHOW DOWN ***
Kevin12345Mc: shows [Ts 5s] (two pair, Tens and Deuces)
marck1son: shows [Qd Qh] (two pair, Queens and Deuces)
marck1son collected 4780 from pot
*** SUMMARY ***
Total pot 4780 | Rake 0 
Board [Tc 2d 2h Ah 9d]
Seat 1: VVS777 folded before Flop (didn't bet)
Seat 2: neoGR folded before Flop (didn't bet)
Seat 3: incjr folded before Flop (didn't bet)
Seat 4: loseonteturn folded before Flop (didn't bet)
Seat 5: mrbt2511 folded before Flop (didn't bet)
Seat 6: Razzmus (button) folded before Flop (didn't bet)
Seat 7: marck1son (small blind) showed [Qd Qh] and won (4780) with two pair, Queens and Deuces
Seat 8: Kevin12345Mc (big blind) showed [Ts 5s] and lost with two pair, Tens and Deuces



PokerStars Hand #255107309547: Tournament #3862890532, $4.80+$5.00+$1.20 USD Hold'em No Limit - Level XI (100/200) - 2025/03/02 18:11:58 WET [2025/03/02 13:11:58 ET]
Table '3862890532 246' 8-max Seat #7 is the button
Seat 1: VVS777 (26693 in chips, $7.50 bounty) 
Seat 2: neoGR (28202 in chips, $20 bounty) 
Seat 3: incjr (4007 in chips, $9.37 bounty) 
Seat 4: loseonteturn (7111 in chips, $5 bounty) 
Seat 5: mrbt2511 (2525 in chips, $5 bounty) 
Seat 6: Razzmus (9736 in chips, $5 bounty) 
Seat 7: marck1son (9068 in chips, $5 bounty) 
Seat 8: Kevin12345Mc (10154 in chips, $5 bounty) 
VVS777: posts the ante 30
neoGR: posts the ante 30
incjr: posts the ante 30
loseonteturn: posts the ante 30
mrbt2511: posts the ante 30
Razzmus: posts the ante 30
marck1son: posts the ante 30
Kevin12345Mc: posts the ante 30
Kevin12345Mc: posts small blind 100
VVS777: posts big blind 200
*** HOLE CARDS ***
Dealt to Kevin12345Mc [Ac 3h]
neoGR: folds 
incjr: folds 
loseonteturn: folds 
mrbt2511: folds 
Razzmus: raises 230 to 430
marck1son: folds 
Kevin12345Mc: folds 
VVS777: calls 230
*** FLOP *** [6h 2d 2h]
VVS777: checks 
Razzmus: bets 468
VVS777: raises 932 to 1400
Razzmus: folds 
Uncalled bet (932) returned to VVS777
VVS777 collected 2136 from pot
VVS777: doesn't show hand 
*** SUMMARY ***
Total pot 2136 | Rake 0 
Board [6h 2d 2h]
Seat 1: VVS777 (big blind) collected (2136)
Seat 2: neoGR folded before Flop (didn't bet)
Seat 3: incjr folded before Flop (didn't bet)
Seat 4: loseonteturn folded before Flop (didn't bet)
Seat 5: mrbt2511 folded before Flop (didn't bet)
Seat 6: Razzmus folded on the Flop
Seat 7: marck1son (button) folded before Flop (didn't bet)
Seat 8: Kevin12345Mc (small blind) folded before Flop



PokerStars Hand #255107329476: Tournament #3862890532, $4.80+$5.00+$1.20 USD Hold'em No Limit - Level XI (100/200) - 2025/03/02 18:13:00 WET [2025/03/02 13:13:00 ET]
Table '3862890532 246' 8-max Seat #8 is the button
Seat 1: VVS777 (27901 in chips, $7.50 bounty) 
Seat 2: neoGR (28172 in chips, $20 bounty) 
Seat 3: incjr (3977 in chips, $9.37 bounty) 
Seat 4: loseonteturn (7081 in chips, $5 bounty) 
Seat 5: mrbt2511 (2495 in chips, $5 bounty) 
Seat 6: Razzmus (8808 in chips, $5 bounty) 
Seat 7: marck1son (9038 in chips, $5 bounty) 
Seat 8: Kevin12345Mc (10024 in chips, $5 bounty) 
VVS777: posts the ante 30
neoGR: posts the ante 30
incjr: posts the ante 30
loseonteturn: posts the ante 30
mrbt2511: posts the ante 30
Razzmus: posts the ante 30
marck1son: posts the ante 30
Kevin12345Mc: posts the ante 30
VVS777: posts small blind 100
neoGR: posts big blind 200
*** HOLE CARDS ***
Dealt to Kevin12345Mc [2c 9h]
incjr: raises 200 to 400
loseonteturn: folds 
mrbt2511: folds 
Razzmus: folds 
marck1son: folds 
Kevin12345Mc: folds 
VVS777: folds 
neoGR: calls 200
*** FLOP *** [9c 7d As]
neoGR: checks 
incjr: checks 
*** TURN *** [9c 7d As] [Kc]
neoGR: checks 
incjr: checks 
*** RIVER *** [9c 7d As Kc] [2s]
neoGR: checks 
incjr: checks 
*** SHOW DOWN ***
neoGR: shows [6d 6s] (a pair of Sixes)
incjr: shows [Ks Jd] (a pair of Kings)
incjr collected 1140 from pot
*** SUMMARY ***
Total pot 1140 | Rake 0 
Board [9c 7d As Kc 2s]
Seat 1: VVS777 (small blind) folded before Flop
Seat 2: neoGR (big blind) showed [6d 6s] and lost with a pair of Sixes
Seat 3: incjr showed [Ks Jd] and won (1140) with a pair of Kings
Seat 4: loseonteturn folded before Flop (didn't bet)
Seat 5: mrbt2511 folded before Flop (didn't bet)
Seat 6: Razzmus folded before Flop (didn't bet)
Seat 7: marck1son folded before Flop (didn't bet)
Seat 8: Kevin12345Mc (button) folded before Flop (didn't bet)



PokerStars Hand #255107342135: Tournament #3862890532, $4.80+$5.00+$1.20 USD Hold'em No Limit - Level XII (125/250) - 2025/03/02 18:13:40 WET [2025/03/02 13:13:40 ET]
Table '3862890532 246' 8-max Seat #1 is the button
Seat 1: VVS777 (27771 in chips, $7.50 bounty) 
Seat 2: neoGR (27742 in chips, $20 bounty) 
Seat 3: incjr (4687 in chips, $9.37 bounty) 
Seat 4: loseonteturn (7051 in chips, $5 bounty) 
Seat 5: mrbt2511 (2465 in chips, $5 bounty) 
Seat 6: Razzmus (8778 in chips, $5 bounty) 
Seat 7: marck1son (9008 in chips, $5 bounty) 
Seat 8: Kevin12345Mc (9994 in chips, $5 bounty) 
VVS777: posts the ante 36
neoGR: posts the ante 36
incjr: posts the ante 36
loseonteturn: posts the ante 36
mrbt2511: posts the ante 36
Razzmus: posts the ante 36
marck1son: posts the ante 36
Kevin12345Mc: posts the ante 36
neoGR: posts small blind 125
incjr: posts big blind 250
*** HOLE CARDS ***
Dealt to Kevin12345Mc [Kd Jd]
loseonteturn: folds 
mrbt2511: folds 
Razzmus: folds 
marck1son: folds 
Kevin12345Mc: raises 300 to 550
VVS777: folds 
neoGR: calls 425
incjr: calls 300
*** FLOP *** [4c 5s 7s]
neoGR: checks 
incjr: bets 719
Kevin12345Mc: folds 
neoGR: calls 719
*** TURN *** [4c 5s 7s] [Qs]
neoGR: checks 
incjr: bets 1688
neoGR: folds 
Uncalled bet (1688) returned to incjr
incjr collected 3376 from pot
*** SUMMARY ***
Total pot 3376 | Rake 0 
Board [4c 5s 7s Qs]
Seat 1: VVS777 (button) folded before Flop (didn't bet)
Seat 2: neoGR (small blind) folded on the Turn
Seat 3: incjr (big blind) collected (3376)
Seat 4: loseonteturn folded before Flop (didn't bet)
Seat 5: mrbt2511 folded before Flop (didn't bet)
Seat 6: Razzmus folded before Flop (didn't bet)
Seat 7: marck1son folded before Flop (didn't bet)
Seat 8: Kevin12345Mc folded on the Flop



PokerStars Hand #255107362236: Tournament #3862890532, $4.80+$5.00+$1.20 USD Hold'em No Limit - Level XII (125/250) - 2025/03/02 18:14:42 WET [2025/03/02 13:14:42 ET]
Table '3862890532 246' 8-max Seat #2 is the button
Seat 1: VVS777 (27735 in chips, $7.50 bounty) 
Seat 2: neoGR (26437 in chips, $20 bounty) 
Seat 3: incjr (6758 in chips, $9.37 bounty) 
Seat 4: loseonteturn (7015 in chips, $5 bounty) 
Seat 5: mrbt2511 (2429 in chips, $5 bounty) 
Seat 6: Razzmus (8742 in chips, $5 bounty) 
Seat 7: marck1son (8972 in chips, $5 bounty) 
Seat 8: Kevin12345Mc (9408 in chips, $5 bounty) 
VVS777: posts the ante 36
neoGR: posts the ante 36
incjr: posts the ante 36
loseonteturn: posts the ante 36
mrbt2511: posts the ante 36
Razzmus: posts the ante 36
marck1son: posts the ante 36
Kevin12345Mc: posts the ante 36
incjr: posts small blind 125
loseonteturn: posts big blind 250
*** HOLE CARDS ***
Dealt to Kevin12345Mc [9h Th]
mrbt2511: folds 
Razzmus: folds 
marck1son: raises 250 to 500
Kevin12345Mc: calls 500
VVS777: raises 1750 to 2250
neoGR: folds 
incjr: folds 
loseonteturn: folds 
marck1son: folds 
Kevin12345Mc: folds 
Uncalled bet (1750) returned to VVS777
VVS777 collected 2163 from pot
VVS777: doesn't show hand 
*** SUMMARY ***
Total pot 2163 | Rake 0 
Seat 1: VVS777 collected (2163)
Seat 2: neoGR (button) folded before Flop (didn't bet)
Seat 3: incjr (small blind) folded before Flop
Seat 4: loseonteturn (big blind) folded before Flop
Seat 5: mrbt2511 folded before Flop (didn't bet)
Seat 6: Razzmus folded before Flop (didn't bet)
Seat 7: marck1son folded before Flop
Seat 8: Kevin12345Mc folded before Flop



PokerStars Hand #255107376895: Tournament #3862890532, $4.80+$5.00+$1.20 USD Hold'em No Limit - Level XII (125/250) - 2025/03/02 18:15:27 WET [2025/03/02 13:15:27 ET]
Table '3862890532 246' 8-max Seat #3 is the button
Seat 1: VVS777 (29362 in chips, $7.50 bounty) 
Seat 2: neoGR (26401 in chips, $20 bounty) 
Seat 3: incjr (6597 in chips, $9.37 bounty) 
Seat 4: loseonteturn (6729 in chips, $5 bounty) 
Seat 5: mrbt2511 (2393 in chips, $5 bounty) 
Seat 6: Razzmus (8706 in chips, $5 bounty) 
Seat 7: marck1son (8436 in chips, $5 bounty) 
Seat 8: Kevin12345Mc (8872 in chips, $5 bounty) 
VVS777: posts the ante 36
neoGR: posts the ante 36
incjr: posts the ante 36
loseonteturn: posts the ante 36
mrbt2511: posts the ante 36
Razzmus: posts the ante 36
marck1son: posts the ante 36
Kevin12345Mc: posts the ante 36
loseonteturn: posts small blind 125
mrbt2511: posts big blind 250
*** HOLE CARDS ***
Dealt to Kevin12345Mc [Kd Jh]
Razzmus: folds 
marck1son: folds 
Kevin12345Mc: raises 275 to 525
VVS777: folds 
neoGR: calls 525
incjr: folds 
loseonteturn: raises 1100 to 1625
mrbt2511: folds 
Kevin12345Mc: folds 
neoGR: folds 
Uncalled bet (1100) returned to loseonteturn
loseonteturn collected 2113 from pot
loseonteturn: doesn't show hand 
*** SUMMARY ***
Total pot 2113 | Rake 0 
Seat 1: VVS777 folded before Flop (didn't bet)
Seat 2: neoGR folded before Flop
Seat 3: incjr (button) folded before Flop (didn't bet)
Seat 4: loseonteturn (small blind) collected (2113)
Seat 5: mrbt2511 (big blind) folded before Flop
Seat 6: Razzmus folded before Flop (didn't bet)
Seat 7: marck1son folded before Flop (didn't bet)
Seat 8: Kevin12345Mc folded before Flop



PokerStars Hand #255107396843: Tournament #3862890532, $4.80+$5.00+$1.20 USD Hold'em No Limit - Level XII (125/250) - 2025/03/02 18:16:28 WET [2025/03/02 13:16:28 ET]
Table '3862890532 246' 8-max Seat #4 is the button
Seat 1: VVS777 (29326 in chips, $7.50 bounty) 
Seat 2: neoGR (25840 in chips, $20 bounty) 
Seat 3: incjr (6561 in chips, $9.37 bounty) 
Seat 4: loseonteturn (8281 in chips, $5 bounty) 
Seat 5: mrbt2511 (2107 in chips, $5 bounty) 
Seat 6: Razzmus (8670 in chips, $5 bounty) 
Seat 7: marck1son (8400 in chips, $5 bounty) 
Seat 8: Kevin12345Mc (8311 in chips, $5 bounty) 
VVS777: posts the ante 36
neoGR: posts the ante 36
incjr: posts the ante 36
loseonteturn: posts the ante 36
mrbt2511: posts the ante 36
Razzmus: posts the ante 36
marck1son: posts the ante 36
Kevin12345Mc: posts the ante 36
mrbt2511: posts small blind 125
Razzmus: posts big blind 250
*** HOLE CARDS ***
Dealt to Kevin12345Mc [9h 6s]
marck1son: folds 
Kevin12345Mc: folds 
VVS777: folds 
neoGR: raises 250 to 500
incjr: folds 
loseonteturn: calls 500
mrbt2511: folds 
Razzmus: folds 
*** FLOP *** [7d Kh 5d]
neoGR: bets 500
loseonteturn: raises 1000 to 1500
neoGR: raises 7250 to 8750
loseonteturn: calls 6245 and is all-in
Uncalled bet (1005) returned to neoGR
*** TURN *** [7d Kh 5d] [8h]
*** RIVER *** [7d Kh 5d 8h] [Jh]
*** SHOW DOWN ***
neoGR: shows [8d Kd] (two pair, Kings and Eights)
loseonteturn: shows [5h 5s] (three of a kind, Fives)
loseonteturn collected 17153 from pot
*** SUMMARY ***
Total pot 17153 | Rake 0 
Board [7d Kh 5d 8h Jh]
Seat 1: VVS777 folded before Flop (didn't bet)
Seat 2: neoGR showed [8d Kd] and lost with two pair, Kings and Eights
Seat 3: incjr folded before Flop (didn't bet)
Seat 4: loseonteturn (button) showed [5h 5s] and won (17153) with three of a kind, Fives
Seat 5: mrbt2511 (small blind) folded before Flop
Seat 6: Razzmus (big blind) folded before Flop
Seat 7: marck1son folded before Flop (didn't bet)
Seat 8: Kevin12345Mc folded before Flop (didn't bet)



PokerStars Hand #255107419135: Tournament #3862890532, $4.80+$5.00+$1.20 USD Hold'em No Limit - Level XII (125/250) - 2025/03/02 18:17:37 WET [2025/03/02 13:17:37 ET]
Table '3862890532 246' 8-max Seat #5 is the button
Seat 1: VVS777 (29290 in chips, $7.50 bounty) 
Seat 2: neoGR (17559 in chips, $20 bounty) 
Seat 3: incjr (6525 in chips, $9.37 bounty) 
Seat 4: loseonteturn (17153 in chips, $5 bounty) 
Seat 5: mrbt2511 (1946 in chips, $5 bounty) 
Seat 6: Razzmus (8384 in chips, $5 bounty) 
Seat 7: marck1son (8364 in chips, $5 bounty) 
Seat 8: Kevin12345Mc (8275 in chips, $5 bounty) 
VVS777: posts the ante 36
neoGR: posts the ante 36
incjr: posts the ante 36
loseonteturn: posts the ante 36
mrbt2511: posts the ante 36
Razzmus: posts the ante 36
marck1son: posts the ante 36
Kevin12345Mc: posts the ante 36
Razzmus: posts small blind 125
marck1son: posts big blind 250
*** HOLE CARDS ***
Dealt to Kevin12345Mc [Jd 2d]
Kevin12345Mc: folds 
VVS777: folds 
neoGR: folds 
incjr: folds 
loseonteturn: folds 
mrbt2511: raises 1660 to 1910 and is all-in
Razzmus: folds 
marck1son: calls 1660
*** FLOP *** [Kh 4h 3c]
*** TURN *** [Kh 4h 3c] [2h]
*** RIVER *** [Kh 4h 3c 2h] [9d]
*** SHOW DOWN ***
marck1son: shows [9h Ks] (two pair, Kings and Nines)
mrbt2511: shows [Ts 9s] (a pair of Nines)
marck1son collected 4233 from pot
marck1son wins $2.50 for eliminating mrbt2511 and their own bounty increases by $2.50 to $7.50
mrbt2511 finished the tournament in 1931st place
*** SUMMARY ***
Total pot 4233 | Rake 0 
Board [Kh 4h 3c 2h 9d]
Seat 1: VVS777 folded before Flop (didn't bet)
Seat 2: neoGR folded before Flop (didn't bet)
Seat 3: incjr folded before Flop (didn't bet)
Seat 4: loseonteturn folded before Flop (didn't bet)
Seat 5: mrbt2511 (button) showed [Ts 9s] and lost with a pair of Nines
Seat 6: Razzmus (small blind) folded before Flop
Seat 7: marck1son (big blind) showed [9h Ks] and won (4233) with two pair, Kings and Nines
Seat 8: Kevin12345Mc folded before Flop (didn't bet)



PokerStars Hand #255107432691: Tournament #3862890532, $4.80+$5.00+$1.20 USD Hold'em No Limit - Level XII (125/250) - 2025/03/02 18:18:19 WET [2025/03/02 13:18:19 ET]
Table '3862890532 246' 8-max Seat #6 is the button
Seat 1: VVS777 (29254 in chips, $7.50 bounty) 
Seat 2: neoGR (17523 in chips, $20 bounty) 
Seat 3: incjr (6489 in chips, $9.37 bounty) 
Seat 4: loseonteturn (17117 in chips, $5 bounty) 
Seat 6: Razzmus (8223 in chips, $5 bounty) 
Seat 7: marck1son (10651 in chips, $7.50 bounty) 
Seat 8: Kevin12345Mc (8239 in chips, $5 bounty) 
VVS777: posts the ante 36
neoGR: posts the ante 36
incjr: posts the ante 36
loseonteturn: posts the ante 36
Razzmus: posts the ante 36
marck1son: posts the ante 36
Kevin12345Mc: posts the ante 36
marck1son: posts small blind 125
Kevin12345Mc: posts big blind 250
*** HOLE CARDS ***
Dealt to Kevin12345Mc [8c 6d]
VVS777: folds 
Yaugun is disconnected 
neoGR: folds 
incjr: folds 
loseonteturn: folds 
Razzmus: raises 287 to 537
marck1son: folds 
Kevin12345Mc: folds 
Uncalled bet (287) returned to Razzmus
Razzmus collected 877 from pot
Razzmus: doesn't show hand 
*** SUMMARY ***
Total pot 877 | Rake 0 
Seat 1: VVS777 folded before Flop (didn't bet)
Seat 2: neoGR folded before Flop (didn't bet)
Seat 3: incjr folded before Flop (didn't bet)
Seat 4: loseonteturn folded before Flop (didn't bet)
Seat 6: Razzmus (button) collected (877)
Seat 7: marck1son (small blind) folded before Flop
Seat 8: Kevin12345Mc (big blind) folded before Flop



PokerStars Hand #255107441274: Tournament #3862890532, $4.80+$5.00+$1.20 USD Hold'em No Limit - Level XII (125/250) - 2025/03/02 18:18:45 WET [2025/03/02 13:18:45 ET]
Table '3862890532 246' 8-max Seat #7 is the button
Seat 1: VVS777 (29218 in chips, $7.50 bounty) 
Seat 2: neoGR (17487 in chips, $20 bounty) 
Seat 3: incjr (6453 in chips, $9.37 bounty) 
Seat 4: loseonteturn (17081 in chips, $5 bounty) 
Seat 5: Yaugun (29206 in chips, $8.75 bounty) 
Seat 6: Razzmus (8814 in chips, $5 bounty) 
Seat 7: marck1son (10490 in chips, $7.50 bounty) 
Seat 8: Kevin12345Mc (7953 in chips, $5 bounty) 
VVS777: posts the ante 36
neoGR: posts the ante 36
incjr: posts the ante 36
loseonteturn: posts the ante 36
Yaugun: posts the ante 36
Razzmus: posts the ante 36
marck1son: posts the ante 36
Kevin12345Mc: posts the ante 36
Kevin12345Mc: posts small blind 125
VVS777: posts big blind 250
*** HOLE CARDS ***
Dealt to Kevin12345Mc [Ac 8d]
neoGR: folds 
incjr: folds 
loseonteturn: folds 
Yaugun: raises 250 to 500
Razzmus: folds 
marck1son: folds 
Kevin12345Mc: folds 
VVS777: folds 
Uncalled bet (250) returned to Yaugun
Yaugun collected 913 from pot
Yaugun: doesn't show hand 
*** SUMMARY ***
Total pot 913 | Rake 0 
Seat 1: VVS777 (big blind) folded before Flop
Seat 2: neoGR folded before Flop (didn't bet)
Seat 3: incjr folded before Flop (didn't bet)
Seat 4: loseonteturn folded before Flop (didn't bet)
Seat 5: Yaugun collected (913)
Seat 6: Razzmus folded before Flop (didn't bet)
Seat 7: marck1son (button) folded before Flop (didn't bet)
Seat 8: Kevin12345Mc (small blind) folded before Flop



PokerStars Hand #255107457317: Tournament #3862890532, $4.80+$5.00+$1.20 USD Hold'em No Limit - Level XII (125/250) - 2025/03/02 18:19:35 WET [2025/03/02 13:19:35 ET]
Table '3862890532 246' 8-max Seat #8 is the button
Seat 1: VVS777 (28932 in chips, $7.50 bounty) 
Seat 2: neoGR (17451 in chips, $20 bounty) 
Seat 3: incjr (6417 in chips, $9.37 bounty) 
Seat 4: loseonteturn (17045 in chips, $5 bounty) 
Seat 5: Yaugun (29833 in chips, $8.75 bounty) 
Seat 6: Razzmus (8778 in chips, $5 bounty) 
Seat 7: marck1son (10454 in chips, $7.50 bounty) 
Seat 8: Kevin12345Mc (7792 in chips, $5 bounty) 
VVS777: posts the ante 36
neoGR: posts the ante 36
incjr: posts the ante 36
loseonteturn: posts the ante 36
Yaugun: posts the ante 36
Razzmus: posts the ante 36
marck1son: posts the ante 36
Kevin12345Mc: posts the ante 36
VVS777: posts small blind 125
neoGR: posts big blind 250
*** HOLE CARDS ***
Dealt to Kevin12345Mc [Td 6h]
incjr: folds 
loseonteturn: folds 
Yaugun: folds 
Razzmus: folds 
marck1son: raises 250 to 500
Kevin12345Mc: folds 
VVS777: folds 
neoGR: folds 
Uncalled bet (250) returned to marck1son
marck1son collected 913 from pot
marck1son: doesn't show hand 
*** SUMMARY ***
Total pot 913 | Rake 0 
Seat 1: VVS777 (small blind) folded before Flop
Seat 2: neoGR (big blind) folded before Flop
Seat 3: incjr folded before Flop (didn't bet)
Seat 4: loseonteturn folded before Flop (didn't bet)
Seat 5: Yaugun folded before Flop (didn't bet)
Seat 6: Razzmus folded before Flop (didn't bet)
Seat 7: marck1son collected (913)
Seat 8: Kevin12345Mc (button) folded before Flop (didn't bet)



PokerStars Hand #255107468672: Tournament #3862890532, $4.80+$5.00+$1.20 USD Hold'em No Limit - Level XII (125/250) - 2025/03/02 18:20:10 WET [2025/03/02 13:20:10 ET]
Table '3862890532 246' 8-max Seat #1 is the button
Seat 1: VVS777 (28771 in chips, $7.50 bounty) 
Seat 2: neoGR (17165 in chips, $20 bounty) 
Seat 3: incjr (6381 in chips, $9.37 bounty) 
Seat 4: loseonteturn (17009 in chips, $5 bounty) 
Seat 5: Yaugun (29797 in chips, $8.75 bounty) 
Seat 6: Razzmus (8742 in chips, $5 bounty) 
Seat 7: marck1son (11081 in chips, $7.50 bounty) 
Seat 8: Kevin12345Mc (7756 in chips, $5 bounty) 
VVS777: posts the ante 36
neoGR: posts the ante 36
incjr: posts the ante 36
loseonteturn: posts the ante 36
Yaugun: posts the ante 36
Razzmus: posts the ante 36
marck1son: posts the ante 36
Kevin12345Mc: posts the ante 36
neoGR: posts small blind 125
incjr: posts big blind 250
*** HOLE CARDS ***
Dealt to Kevin12345Mc [6h Kh]
loseonteturn: folds 
Yaugun: folds 
Razzmus: folds 
marck1son: raises 250 to 500
Kevin12345Mc: folds 
VVS777: folds 
neoGR: calls 375
incjr: calls 250
*** FLOP *** [4s 9c Ks]
neoGR: checks 
incjr: checks 
marck1son: checks 
*** TURN *** [4s 9c Ks] [Qh]
neoGR: checks 
incjr: bets 894
marck1son: folds 
neoGR: folds 
Uncalled bet (894) returned to incjr
incjr collected 1788 from pot
*** SUMMARY ***
Total pot 1788 | Rake 0 
Board [4s 9c Ks Qh]
Seat 1: VVS777 (button) folded before Flop (didn't bet)
Seat 2: neoGR (small blind) folded on the Turn
Seat 3: incjr (big blind) collected (1788)
Seat 4: loseonteturn folded before Flop (didn't bet)
Seat 5: Yaugun folded before Flop (didn't bet)
Seat 6: Razzmus folded before Flop (didn't bet)
Seat 7: marck1son folded on the Turn
Seat 8: Kevin12345Mc folded before Flop (didn't bet)



PokerStars Hand #255107486705: Tournament #3862890532, $4.80+$5.00+$1.20 USD Hold'em No Limit - Level XII (125/250) - 2025/03/02 18:21:05 WET [2025/03/02 13:21:05 ET]
Table '3862890532 246' 8-max Seat #2 is the button
Seat 1: VVS777 (28735 in chips, $7.50 bounty) 
Seat 2: neoGR (16629 in chips, $20 bounty) 
Seat 3: incjr (7633 in chips, $9.37 bounty) 
Seat 4: loseonteturn (16973 in chips, $5 bounty) 
Seat 5: Yaugun (29761 in chips, $8.75 bounty) 
Seat 7: marck1son (10545 in chips, $7.50 bounty) 
Seat 8: Kevin12345Mc (7720 in chips, $5 bounty) 
VVS777: posts the ante 36
neoGR: posts the ante 36
incjr: posts the ante 36
loseonteturn: posts the ante 36
Yaugun: posts the ante 36
marck1son: posts the ante 36
Kevin12345Mc: posts the ante 36
incjr: posts small blind 125
loseonteturn: posts big blind 250
*** HOLE CARDS ***
Dealt to Kevin12345Mc [8c As]
Never Locked is disconnected 
Yaugun: folds 
marck1son: folds 
Kevin12345Mc: folds 
VVS777: folds 
neoGR: raises 250 to 500
incjr: calls 375
loseonteturn: calls 250
*** FLOP *** [6d Jh 7d]
incjr: bets 876
loseonteturn: folds 
neoGR: calls 876
*** TURN *** [6d Jh 7d] [Kh]
incjr: bets 1752
neoGR: raises 5123 to 6875
incjr: calls 4469 and is all-in
Uncalled bet (654) returned to neoGR
*** RIVER *** [6d Jh 7d Kh] [9h]
*** SHOW DOWN ***
incjr: shows [9d Qd] (a pair of Nines)
neoGR: shows [Ks 7h] (two pair, Kings and Sevens)
neoGR collected 15946 from pot
neoGR wins $4.69 for eliminating incjr and their own bounty increases by $4.68 to $24.68
incjr finished the tournament in 1801st place
*** SUMMARY ***
Total pot 15946 | Rake 0 
Board [6d Jh 7d Kh 9h]
Seat 1: VVS777 folded before Flop (didn't bet)
Seat 2: neoGR (button) showed [Ks 7h] and won (15946) with two pair, Kings and Sevens
Seat 3: incjr (small blind) showed [9d Qd] and lost with a pair of Nines
Seat 4: loseonteturn (big blind) folded on the Flop
Seat 5: Yaugun folded before Flop (didn't bet)
Seat 7: marck1son folded before Flop (didn't bet)
Seat 8: Kevin12345Mc folded before Flop (didn't bet)



PokerStars Hand #255107518897: Tournament #3862890532, $4.80+$5.00+$1.20 USD Hold'em No Limit - Level XIII (150/300) - 2025/03/02 18:22:43 WET [2025/03/02 13:22:43 ET]
Table '3862890532 21' 8-max Seat #5 is the button
Seat 1: Jeffe-car (18314 in chips, $11.87 bounty) 
Seat 2: livelikenolimit (21078 in chips, $12.50 bounty) 
Seat 3: JBGMendes (14405 in chips, $10 bounty) 
Seat 4: Peu Ivo (37857 in chips, $20 bounty) 
Seat 5: panchi hmg (14566 in chips, $18.75 bounty) 
Seat 6: bungades13 (18089 in chips, $8.75 bounty) 
Seat 7: vishnya0409 (7058 in chips, $7.50 bounty) 
Seat 8: Kevin12345Mc (7684 in chips, $5 bounty) 
Jeffe-car: posts the ante 42
livelikenolimit: posts the ante 42
JBGMendes: posts the ante 42
Peu Ivo: posts the ante 42
panchi hmg: posts the ante 42
bungades13: posts the ante 42
vishnya0409: posts the ante 42
Kevin12345Mc: posts the ante 42
bungades13: posts small blind 150
vishnya0409: posts big blind 300
*** HOLE CARDS ***
Dealt to Kevin12345Mc [9s Td]
Kevin12345Mc: folds 
Jeffe-car: folds 
livelikenolimit: folds 
JBGMendes: folds 
Peu Ivo: folds 
panchi hmg: folds 
bungades13: calls 150
vishnya0409: raises 750 to 1050
bungades13: folds 
Uncalled bet (750) returned to vishnya0409
vishnya0409 collected 936 from pot
*** SUMMARY ***
Total pot 936 | Rake 0 
Seat 1: Jeffe-car folded before Flop (didn't bet)
Seat 2: livelikenolimit folded before Flop (didn't bet)
Seat 3: JBGMendes folded before Flop (didn't bet)
Seat 4: Peu Ivo folded before Flop (didn't bet)
Seat 5: panchi hmg (button) folded before Flop (didn't bet)
Seat 6: bungades13 (small blind) folded before Flop
Seat 7: vishnya0409 (big blind) collected (936)
Seat 8: Kevin12345Mc folded before Flop (didn't bet)



PokerStars Hand #255107531912: Tournament #3862890532, $4.80+$5.00+$1.20 USD Hold'em No Limit - Level XIII (150/300) - 2025/03/02 18:23:23 WET [2025/03/02 13:23:23 ET]
Table '3862890532 21' 8-max Seat #6 is the button
Seat 1: Jeffe-car (18272 in chips, $11.87 bounty) 
Seat 2: livelikenolimit (21036 in chips, $12.50 bounty) 
Seat 3: JBGMendes (14363 in chips, $10 bounty) 
Seat 4: Peu Ivo (37815 in chips, $20 bounty) 
Seat 5: panchi hmg (14524 in chips, $18.75 bounty) 
Seat 6: bungades13 (17747 in chips, $8.75 bounty) 
Seat 7: vishnya0409 (7652 in chips, $7.50 bounty) 
Seat 8: Kevin12345Mc (7642 in chips, $5 bounty) 
Jeffe-car: posts the ante 42
livelikenolimit: posts the ante 42
JBGMendes: posts the ante 42
Peu Ivo: posts the ante 42
panchi hmg: posts the ante 42
bungades13: posts the ante 42
vishnya0409: posts the ante 42
Kevin12345Mc: posts the ante 42
vishnya0409: posts small blind 150
Kevin12345Mc: posts big blind 300
*** HOLE CARDS ***
Dealt to Kevin12345Mc [Ad 8d]
Jeffe-car: folds 
livelikenolimit: folds 
JBGMendes: folds 
Peu Ivo: folds 
panchi hmg: raises 420 to 720
bungades13: calls 720
vishnya0409: folds 
vishnya0409 is sitting out
Kevin12345Mc: raises 6880 to 7600 and is all-in
panchi hmg: folds 
bungades13: folds 
Uncalled bet (6880) returned to Kevin12345Mc
Kevin12345Mc collected 2646 from pot
Kevin12345Mc: doesn't show hand 
*** SUMMARY ***
Total pot 2646 | Rake 0 
Seat 1: Jeffe-car folded before Flop (didn't bet)
Seat 2: livelikenolimit folded before Flop (didn't bet)
Seat 3: JBGMendes folded before Flop (didn't bet)
Seat 4: Peu Ivo folded before Flop (didn't bet)
Seat 5: panchi hmg folded before Flop
Seat 6: bungades13 (button) folded before Flop
Seat 7: vishnya0409 (small blind) folded before Flop
Seat 8: Kevin12345Mc (big blind) collected (2646)



PokerStars Hand #255107544923: Tournament #3862890532, $4.80+$5.00+$1.20 USD Hold'em No Limit - Level XIII (150/300) - 2025/03/02 18:24:03 WET [2025/03/02 13:24:03 ET]
Table '3862890532 21' 8-max Seat #7 is the button
Seat 1: Jeffe-car (18230 in chips, $11.87 bounty) 
Seat 2: livelikenolimit (20994 in chips, $12.50 bounty) 
Seat 3: JBGMendes (14321 in chips, $10 bounty) 
Seat 4: Peu Ivo (37773 in chips, $20 bounty) 
Seat 5: panchi hmg (13762 in chips, $18.75 bounty) 
Seat 6: bungades13 (16985 in chips, $8.75 bounty) 
Seat 7: vishnya0409 (7460 in chips, $7.50 bounty) is sitting out
Seat 8: Kevin12345Mc (9526 in chips, $5 bounty) 
Jeffe-car: posts the ante 42
livelikenolimit: posts the ante 42
JBGMendes: posts the ante 42
Peu Ivo: posts the ante 42
panchi hmg: posts the ante 42
bungades13: posts the ante 42
vishnya0409: posts the ante 42
Kevin12345Mc: posts the ante 42
Kevin12345Mc: posts small blind 150
Jeffe-car: posts big blind 300
*** HOLE CARDS ***
Dealt to Kevin12345Mc [7d 9h]
livelikenolimit: folds 
JBGMendes: folds 
Peu Ivo: folds 
panchi hmg: raises 420 to 720
bungades13: folds 
vishnya0409: folds 
Kevin12345Mc: folds 
Jeffe-car: calls 420
*** FLOP *** [Td 4h Jc]
Jeffe-car: checks 
panchi hmg: bets 636
Jeffe-car: folds 
Uncalled bet (636) returned to panchi hmg
panchi hmg collected 1926 from pot
*** SUMMARY ***
Total pot 1926 | Rake 0 
Board [Td 4h Jc]
Seat 1: Jeffe-car (big blind) folded on the Flop
Seat 2: livelikenolimit folded before Flop (didn't bet)
Seat 3: JBGMendes folded before Flop (didn't bet)
Seat 4: Peu Ivo folded before Flop (didn't bet)
Seat 5: panchi hmg collected (1926)
Seat 6: bungades13 folded before Flop (didn't bet)
Seat 7: vishnya0409 (button) folded before Flop (didn't bet)
Seat 8: Kevin12345Mc (small blind) folded before Flop



PokerStars Hand #255107565959: Tournament #3862890532, $4.80+$5.00+$1.20 USD Hold'em No Limit - Level XIII (150/300) - 2025/03/02 18:25:07 WET [2025/03/02 13:25:07 ET]
Table '3862890532 21' 8-max Seat #8 is the button
Seat 1: Jeffe-car (17468 in chips, $11.87 bounty) 
Seat 2: livelikenolimit (20952 in chips, $12.50 bounty) 
Seat 3: JBGMendes (14279 in chips, $10 bounty) 
Seat 4: Peu Ivo (37731 in chips, $20 bounty) 
Seat 5: panchi hmg (14926 in chips, $18.75 bounty) 
Seat 6: bungades13 (16943 in chips, $8.75 bounty) 
Seat 7: vishnya0409 (7418 in chips, $7.50 bounty) is sitting out
Seat 8: Kevin12345Mc (9334 in chips, $5 bounty) 
Jeffe-car: posts the ante 42
livelikenolimit: posts the ante 42
JBGMendes: posts the ante 42
Peu Ivo: posts the ante 42
panchi hmg: posts the ante 42
bungades13: posts the ante 42
vishnya0409: posts the ante 42
Kevin12345Mc: posts the ante 42
Jeffe-car: posts small blind 150
livelikenolimit: posts big blind 300
*** HOLE CARDS ***
Dealt to Kevin12345Mc [Th 9d]
JBGMendes: folds 
Peu Ivo: folds 
panchi hmg: folds 
bungades13: calls 300
vishnya0409: folds 
Kevin12345Mc: folds 
Jeffe-car: calls 150
livelikenolimit: checks 
*** FLOP *** [Js 9s 8s]
Jeffe-car: checks 
livelikenolimit: checks 
bungades13: bets 618
Jeffe-car: folds 
livelikenolimit: folds 
Uncalled bet (618) returned to bungades13
bungades13 collected 1236 from pot
*** SUMMARY ***
Total pot 1236 | Rake 0 
Board [Js 9s 8s]
Seat 1: Jeffe-car (small blind) folded on the Flop
Seat 2: livelikenolimit (big blind) folded on the Flop
Seat 3: JBGMendes folded before Flop (didn't bet)
Seat 4: Peu Ivo folded before Flop (didn't bet)
Seat 5: panchi hmg folded before Flop (didn't bet)
Seat 6: bungades13 collected (1236)
Seat 7: vishnya0409 folded before Flop (didn't bet)
Seat 8: Kevin12345Mc (button) folded before Flop (didn't bet)



PokerStars Hand #255107581034: Tournament #3862890532, $4.80+$5.00+$1.20 USD Hold'em No Limit - Level XIII (150/300) - 2025/03/02 18:25:53 WET [2025/03/02 13:25:53 ET]
Table '3862890532 21' 8-max Seat #1 is the button
Seat 1: Jeffe-car (17126 in chips, $11.87 bounty) 
Seat 2: livelikenolimit (20610 in chips, $12.50 bounty) 
Seat 3: JBGMendes (14237 in chips, $10 bounty) 
Seat 4: Peu Ivo (37689 in chips, $20 bounty) 
Seat 5: panchi hmg (14884 in chips, $18.75 bounty) 
Seat 6: bungades13 (17837 in chips, $8.75 bounty) 
Seat 7: vishnya0409 (7376 in chips, $7.50 bounty) is sitting out
Seat 8: Kevin12345Mc (9292 in chips, $5 bounty) 
Jeffe-car: posts the ante 42
livelikenolimit: posts the ante 42
JBGMendes: posts the ante 42
Peu Ivo: posts the ante 42
panchi hmg: posts the ante 42
bungades13: posts the ante 42
vishnya0409: posts the ante 42
Kevin12345Mc: posts the ante 42
livelikenolimit: posts small blind 150
JBGMendes: posts big blind 300
*** HOLE CARDS ***
Dealt to Kevin12345Mc [Jh Tc]
Peu Ivo: folds 
panchi hmg: raises 360 to 660
bungades13: folds 
vishnya0409: folds 
Kevin12345Mc: folds 
Jeffe-car: folds 
livelikenolimit: calls 510
JBGMendes: folds 
*** FLOP *** [Qs Jd 3d]
livelikenolimit: checks 
panchi hmg: bets 645
livelikenolimit: calls 645
*** TURN *** [Qs Jd 3d] [6h]
livelikenolimit: checks 
panchi hmg: bets 2499
livelikenolimit: calls 2499
*** RIVER *** [Qs Jd 3d 6h] [5h]
livelikenolimit: checks 
panchi hmg: checks 
*** SHOW DOWN ***
livelikenolimit: shows [Jc Ad] (a pair of Jacks)
panchi hmg: mucks hand 
livelikenolimit collected 8244 from pot
*** SUMMARY ***
Total pot 8244 | Rake 0 
Board [Qs Jd 3d 6h 5h]
Seat 1: Jeffe-car (button) folded before Flop (didn't bet)
Seat 2: livelikenolimit (small blind) showed [Jc Ad] and won (8244) with a pair of Jacks
Seat 3: JBGMendes (big blind) folded before Flop
Seat 4: Peu Ivo folded before Flop (didn't bet)
Seat 5: panchi hmg mucked [Th Js]
Seat 6: bungades13 folded before Flop (didn't bet)
Seat 7: vishnya0409 folded before Flop (didn't bet)
Seat 8: Kevin12345Mc folded before Flop (didn't bet)



PokerStars Hand #255107597093: Tournament #3862890532, $4.80+$5.00+$1.20 USD Hold'em No Limit - Level XIII (150/300) - 2025/03/02 18:26:42 WET [2025/03/02 13:26:42 ET]
Table '3862890532 21' 8-max Seat #2 is the button
Seat 1: Jeffe-car (17084 in chips, $11.87 bounty) 
Seat 2: livelikenolimit (25008 in chips, $12.50 bounty) 
Seat 3: JBGMendes (13895 in chips, $10 bounty) 
Seat 4: Peu Ivo (37647 in chips, $20 bounty) 
Seat 5: panchi hmg (11038 in chips, $18.75 bounty) 
Seat 6: bungades13 (17795 in chips, $8.75 bounty) 
Seat 7: vishnya0409 (7334 in chips, $7.50 bounty) is sitting out
Seat 8: Kevin12345Mc (9250 in chips, $5 bounty) 
Jeffe-car: posts the ante 42
livelikenolimit: posts the ante 42
JBGMendes: posts the ante 42
Peu Ivo: posts the ante 42
panchi hmg: posts the ante 42
bungades13: posts the ante 42
vishnya0409: posts the ante 42
Kevin12345Mc: posts the ante 42
JBGMendes: posts small blind 150
Peu Ivo: posts big blind 300
*** HOLE CARDS ***
Dealt to Kevin12345Mc [8h Kc]
panchi hmg: folds 
bungades13: folds 
vishnya0409: folds 
Kevin12345Mc: folds 
Jeffe-car: folds 
livelikenolimit: folds 
JBGMendes: raises 450 to 750
Peu Ivo: calls 450
*** FLOP *** [5c 3c 2s]
JBGMendes: checks 
Peu Ivo: bets 606
JBGMendes: folds 
Uncalled bet (606) returned to Peu Ivo
Peu Ivo collected 1836 from pot
Peu Ivo: doesn't show hand 
*** SUMMARY ***
Total pot 1836 | Rake 0 
Board [5c 3c 2s]
Seat 1: Jeffe-car folded before Flop (didn't bet)
Seat 2: livelikenolimit (button) folded before Flop (didn't bet)
Seat 3: JBGMendes (small blind) folded on the Flop
Seat 4: Peu Ivo (big blind) collected (1836)
Seat 5: panchi hmg folded before Flop (didn't bet)
Seat 6: bungades13 folded before Flop (didn't bet)
Seat 7: vishnya0409 folded before Flop (didn't bet)
Seat 8: Kevin12345Mc folded before Flop (didn't bet)



PokerStars Hand #255107618674: Tournament #3862890532, $4.80+$5.00+$1.20 USD Hold'em No Limit - Level XIII (150/300) - 2025/03/02 18:27:48 WET [2025/03/02 13:27:48 ET]
Table '3862890532 21' 8-max Seat #3 is the button
Seat 1: Jeffe-car (17042 in chips, $11.87 bounty) 
Seat 2: livelikenolimit (24966 in chips, $12.50 bounty) 
Seat 3: JBGMendes (13103 in chips, $10 bounty) 
Seat 4: Peu Ivo (38691 in chips, $20 bounty) 
Seat 5: panchi hmg (10996 in chips, $18.75 bounty) 
Seat 6: bungades13 (17753 in chips, $8.75 bounty) 
Seat 7: vishnya0409 (7292 in chips, $7.50 bounty) is sitting out
Seat 8: Kevin12345Mc (9208 in chips, $5 bounty) 
Jeffe-car: posts the ante 42
livelikenolimit: posts the ante 42
JBGMendes: posts the ante 42
Peu Ivo: posts the ante 42
panchi hmg: posts the ante 42
bungades13: posts the ante 42
vishnya0409: posts the ante 42
Kevin12345Mc: posts the ante 42
Peu Ivo: posts small blind 150
panchi hmg: posts big blind 300
*** HOLE CARDS ***
Dealt to Kevin12345Mc [Qh 6c]
bungades13: calls 300
vishnya0409: folds 
Kevin12345Mc: folds 
Jeffe-car: folds 
livelikenolimit: calls 300
JBGMendes: folds 
Peu Ivo: calls 150
panchi hmg: raises 3510 to 3810
bungades13: folds 
livelikenolimit: folds 
Peu Ivo: folds 
Uncalled bet (3510) returned to panchi hmg
panchi hmg collected 1536 from pot
*** SUMMARY ***
Total pot 1536 | Rake 0 
Seat 1: Jeffe-car folded before Flop (didn't bet)
Seat 2: livelikenolimit folded before Flop
Seat 3: JBGMendes (button) folded before Flop (didn't bet)
Seat 4: Peu Ivo (small blind) folded before Flop
Seat 5: panchi hmg (big blind) collected (1536)
Seat 6: bungades13 folded before Flop
Seat 7: vishnya0409 folded before Flop (didn't bet)
Seat 8: Kevin12345Mc folded before Flop (didn't bet)



PokerStars Hand #255107627641: Tournament #3862890532, $4.80+$5.00+$1.20 USD Hold'em No Limit - Level XIII (150/300) - 2025/03/02 18:28:15 WET [2025/03/02 13:28:15 ET]
Table '3862890532 21' 8-max Seat #4 is the button
Seat 1: Jeffe-car (17000 in chips, $11.87 bounty) 
Seat 2: livelikenolimit (24624 in chips, $12.50 bounty) 
Seat 3: JBGMendes (13061 in chips, $10 bounty) 
Seat 4: Peu Ivo (38349 in chips, $20 bounty) 
Seat 5: panchi hmg (12190 in chips, $18.75 bounty) 
Seat 6: bungades13 (17411 in chips, $8.75 bounty) 
Seat 7: vishnya0409 (7250 in chips, $7.50 bounty) is sitting out
Seat 8: Kevin12345Mc (9166 in chips, $5 bounty) 
Jeffe-car: posts the ante 42
livelikenolimit: posts the ante 42
JBGMendes: posts the ante 42
Peu Ivo: posts the ante 42
panchi hmg: posts the ante 42
bungades13: posts the ante 42
vishnya0409: posts the ante 42
Kevin12345Mc: posts the ante 42
panchi hmg: posts small blind 150
bungades13: posts big blind 300
*** HOLE CARDS ***
Dealt to Kevin12345Mc [Kc Jc]
vishnya0409: folds 
Kevin12345Mc: raises 330 to 630
Jeffe-car: folds 
livelikenolimit: folds 
JBGMendes: folds 
Peu Ivo: folds 
panchi hmg: calls 480
bungades13: folds 
*** FLOP *** [Td 7h 5d]
panchi hmg: checks 
Kevin12345Mc: checks 
*** TURN *** [Td 7h 5d] [7d]
panchi hmg: bets 626
Kevin12345Mc: folds 
Uncalled bet (626) returned to panchi hmg
panchi hmg collected 1896 from pot
*** SUMMARY ***
Total pot 1896 | Rake 0 
Board [Td 7h 5d 7d]
Seat 1: Jeffe-car folded before Flop (didn't bet)
Seat 2: livelikenolimit folded before Flop (didn't bet)
Seat 3: JBGMendes folded before Flop (didn't bet)
Seat 4: Peu Ivo (button) folded before Flop (didn't bet)
Seat 5: panchi hmg (small blind) collected (1896)
Seat 6: bungades13 (big blind) folded before Flop
Seat 7: vishnya0409 folded before Flop (didn't bet)
Seat 8: Kevin12345Mc folded on the Turn



PokerStars Hand #255107640662: Tournament #3862890532, $4.80+$5.00+$1.20 USD Hold'em No Limit - Level XIII (150/300) - 2025/03/02 18:28:55 WET [2025/03/02 13:28:55 ET]
Table '3862890532 21' 8-max Seat #5 is the button
Seat 1: Jeffe-car (16958 in chips, $11.87 bounty) 
Seat 2: livelikenolimit (24582 in chips, $12.50 bounty) 
Seat 3: JBGMendes (13019 in chips, $10 bounty) 
Seat 4: Peu Ivo (38307 in chips, $20 bounty) 
Seat 5: panchi hmg (13414 in chips, $18.75 bounty) 
Seat 6: bungades13 (17069 in chips, $8.75 bounty) 
Seat 7: vishnya0409 (7208 in chips, $7.50 bounty) is sitting out
Seat 8: Kevin12345Mc (8494 in chips, $5 bounty) 
Jeffe-car: posts the ante 42
livelikenolimit: posts the ante 42
JBGMendes: posts the ante 42
Peu Ivo: posts the ante 42
panchi hmg: posts the ante 42
bungades13: posts the ante 42
vishnya0409: posts the ante 42
Kevin12345Mc: posts the ante 42
bungades13: posts small blind 150
vishnya0409: posts big blind 300
*** HOLE CARDS ***
Dealt to Kevin12345Mc [6d 3h]
Kevin12345Mc: folds 
Jeffe-car: folds 
livelikenolimit: folds 
JBGMendes: folds 
Peu Ivo: folds 
panchi hmg: raises 13072 to 13372 and is all-in
bungades13: folds 
vishnya0409: folds 
Uncalled bet (13072) returned to panchi hmg
panchi hmg collected 1086 from pot
*** SUMMARY ***
Total pot 1086 | Rake 0 
Seat 1: Jeffe-car folded before Flop (didn't bet)
Seat 2: livelikenolimit folded before Flop (didn't bet)
Seat 3: JBGMendes folded before Flop (didn't bet)
Seat 4: Peu Ivo folded before Flop (didn't bet)
Seat 5: panchi hmg (button) collected (1086)
Seat 6: bungades13 (small blind) folded before Flop
Seat 7: vishnya0409 (big blind) folded before Flop
Seat 8: Kevin12345Mc folded before Flop (didn't bet)



PokerStars Hand #255107649512: Tournament #3862890532, $4.80+$5.00+$1.20 USD Hold'em No Limit - Level XIV (175/350) - 2025/03/02 18:29:23 WET [2025/03/02 13:29:23 ET]
Table '3862890532 21' 8-max Seat #6 is the button
Seat 1: Jeffe-car (16916 in chips, $11.87 bounty) 
Seat 2: livelikenolimit (24540 in chips, $12.50 bounty) 
Seat 3: JBGMendes (12977 in chips, $10 bounty) 
Seat 4: Peu Ivo (38265 in chips, $20 bounty) 
Seat 5: panchi hmg (14158 in chips, $18.75 bounty) 
Seat 6: bungades13 (16877 in chips, $8.75 bounty) 
Seat 7: vishnya0409 (6866 in chips, $7.50 bounty) is sitting out
Seat 8: Kevin12345Mc (8452 in chips, $5 bounty) 
Jeffe-car: posts the ante 50
livelikenolimit: posts the ante 50
JBGMendes: posts the ante 50
Peu Ivo: posts the ante 50
panchi hmg: posts the ante 50
bungades13: posts the ante 50
vishnya0409: posts the ante 50
Kevin12345Mc: posts the ante 50
vishnya0409: posts small blind 175
Kevin12345Mc: posts big blind 350
*** HOLE CARDS ***
Dealt to Kevin12345Mc [7d 3c]
Jeffe-car: folds 
livelikenolimit: folds 
JBGMendes: folds 
Peu Ivo: raises 350 to 700
panchi hmg: calls 700
bungades13: folds 
vishnya0409: folds 
Kevin12345Mc: folds 
*** FLOP *** [Qd Kc 2c]
Peu Ivo: checks 
panchi hmg: checks 
*** TURN *** [Qd Kc 2c] [2h]
Peu Ivo: bets 1581
panchi hmg: calls 1581
*** RIVER *** [Qd Kc 2c 2h] [Qs]
Peu Ivo: checks 
panchi hmg: bets 1811
Peu Ivo: calls 1811
*** SHOW DOWN ***
panchi hmg: shows [Ts Jc] (two pair, Queens and Deuces)
Peu Ivo: shows [Jd Ks] (two pair, Kings and Queens)
Peu Ivo collected 9109 from pot
*** SUMMARY ***
Total pot 9109 | Rake 0 
Board [Qd Kc 2c 2h Qs]
Seat 1: Jeffe-car folded before Flop (didn't bet)
Seat 2: livelikenolimit folded before Flop (didn't bet)
Seat 3: JBGMendes folded before Flop (didn't bet)
Seat 4: Peu Ivo showed [Jd Ks] and won (9109) with two pair, Kings and Queens
Seat 5: panchi hmg showed [Ts Jc] and lost with two pair, Queens and Deuces
Seat 6: bungades13 (button) folded before Flop (didn't bet)
Seat 7: vishnya0409 (small blind) folded before Flop
Seat 8: Kevin12345Mc (big blind) folded before Flop



PokerStars Hand #255107679555: Tournament #3862890532, $4.80+$5.00+$1.20 USD Hold'em No Limit - Level XIV (175/350) - 2025/03/02 18:30:54 WET [2025/03/02 13:30:54 ET]
Table '3862890532 21' 8-max Seat #7 is the button
Seat 1: Jeffe-car (16866 in chips, $11.87 bounty) 
Seat 2: livelikenolimit (24490 in chips, $12.50 bounty) 
Seat 3: JBGMendes (12927 in chips, $10 bounty) 
Seat 4: Peu Ivo (43232 in chips, $20 bounty) 
Seat 5: panchi hmg (10016 in chips, $18.75 bounty) 
Seat 6: bungades13 (16827 in chips, $8.75 bounty) 
Seat 7: vishnya0409 (6641 in chips, $7.50 bounty) is sitting out
Seat 8: Kevin12345Mc (8052 in chips, $5 bounty) 
Jeffe-car: posts the ante 50
livelikenolimit: posts the ante 50
JBGMendes: posts the ante 50
Peu Ivo: posts the ante 50
panchi hmg: posts the ante 50
bungades13: posts the ante 50
vishnya0409: posts the ante 50
Kevin12345Mc: posts the ante 50
Kevin12345Mc: posts small blind 175
Jeffe-car: posts big blind 350
*** HOLE CARDS ***
Dealt to Kevin12345Mc [Kh 3h]
livelikenolimit: folds 
JBGMendes: folds 
Peu Ivo: raises 350 to 700
panchi hmg: folds 
bungades13: calls 700
vishnya0409: folds 
Kevin12345Mc: folds 
Jeffe-car: calls 350
*** FLOP *** [7h 2s Qh]
Jeffe-car: checks 
Peu Ivo: bets 883
bungades13: folds 
Jeffe-car: folds 
Uncalled bet (883) returned to Peu Ivo
vishnya0409 has returned
Peu Ivo collected 2675 from pot
Peu Ivo: doesn't show hand 
*** SUMMARY ***
Total pot 2675 | Rake 0 
Board [7h 2s Qh]
Seat 1: Jeffe-car (big blind) folded on the Flop
Seat 2: livelikenolimit folded before Flop (didn't bet)
Seat 3: JBGMendes folded before Flop (didn't bet)
Seat 4: Peu Ivo collected (2675)
Seat 5: panchi hmg folded before Flop (didn't bet)
Seat 6: bungades13 folded on the Flop
Seat 7: vishnya0409 (button) folded before Flop (didn't bet)
Seat 8: Kevin12345Mc (small blind) folded before Flop



PokerStars Hand #255107695617: Tournament #3862890532, $4.80+$5.00+$1.20 USD Hold'em No Limit - Level XIV (175/350) - 2025/03/02 18:31:41 WET [2025/03/02 13:31:41 ET]
Table '3862890532 21' 8-max Seat #8 is the button
Seat 1: Jeffe-car (16116 in chips, $11.87 bounty) 
Seat 2: livelikenolimit (24440 in chips, $12.50 bounty) 
Seat 3: JBGMendes (12877 in chips, $10 bounty) 
Seat 4: Peu Ivo (45157 in chips, $20 bounty) 
Seat 5: panchi hmg (9966 in chips, $18.75 bounty) 
Seat 6: bungades13 (16077 in chips, $8.75 bounty) 
Seat 7: vishnya0409 (6591 in chips, $7.50 bounty) 
Seat 8: Kevin12345Mc (7827 in chips, $5 bounty) 
Jeffe-car: posts the ante 50
livelikenolimit: posts the ante 50
JBGMendes: posts the ante 50
Peu Ivo: posts the ante 50
panchi hmg: posts the ante 50
bungades13: posts the ante 50
vishnya0409: posts the ante 50
Kevin12345Mc: posts the ante 50
Jeffe-car: posts small blind 175
livelikenolimit: posts big blind 350
*** HOLE CARDS ***
Dealt to Kevin12345Mc [Qc 9s]
JBGMendes: folds 
Peu Ivo: folds 
panchi hmg: folds 
bungades13: folds 
vishnya0409: raises 350 to 700
Kevin12345Mc: folds 
Jeffe-car: raises 15366 to 16066 and is all-in
livelikenolimit: folds 
vishnya0409: folds 
Uncalled bet (15366) returned to Jeffe-car
Jeffe-car collected 2150 from pot
Jeffe-car: doesn't show hand 
*** SUMMARY ***
Total pot 2150 | Rake 0 
Seat 1: Jeffe-car (small blind) collected (2150)
Seat 2: livelikenolimit (big blind) folded before Flop
Seat 3: JBGMendes folded before Flop (didn't bet)
Seat 4: Peu Ivo folded before Flop (didn't bet)
Seat 5: panchi hmg folded before Flop (didn't bet)
Seat 6: bungades13 folded before Flop (didn't bet)
Seat 7: vishnya0409 folded before Flop
Seat 8: Kevin12345Mc (button) folded before Flop (didn't bet)



PokerStars Hand #255107706274: Tournament #3862890532, $4.80+$5.00+$1.20 USD Hold'em No Limit - Level XIV (175/350) - 2025/03/02 18:32:13 WET [2025/03/02 13:32:13 ET]
Table '3862890532 21' 8-max Seat #1 is the button
Seat 1: Jeffe-car (17516 in chips, $11.87 bounty) 
Seat 2: livelikenolimit (24040 in chips, $12.50 bounty) 
Seat 3: JBGMendes (12827 in chips, $10 bounty) 
Seat 4: Peu Ivo (45107 in chips, $20 bounty) 
Seat 5: panchi hmg (9916 in chips, $18.75 bounty) 
Seat 6: bungades13 (16027 in chips, $8.75 bounty) 
Seat 7: vishnya0409 (5841 in chips, $7.50 bounty) 
Seat 8: Kevin12345Mc (7777 in chips, $5 bounty) 
Jeffe-car: posts the ante 50
livelikenolimit: posts the ante 50
JBGMendes: posts the ante 50
Peu Ivo: posts the ante 50
panchi hmg: posts the ante 50
bungades13: posts the ante 50
vishnya0409: posts the ante 50
Kevin12345Mc: posts the ante 50
livelikenolimit: posts small blind 175
JBGMendes: posts big blind 350
*** HOLE CARDS ***
Dealt to Kevin12345Mc [4c 3s]
Peu Ivo: folds 
panchi hmg: folds 
bungades13: folds 
vishnya0409: folds 
Kevin12345Mc: folds 
Jeffe-car: calls 350
livelikenolimit: folds 
JBGMendes: raises 1275 to 1625
Jeffe-car: folds 
Uncalled bet (1275) returned to JBGMendes
JBGMendes collected 1275 from pot
JBGMendes: doesn't show hand 
*** SUMMARY ***
Total pot 1275 | Rake 0 
Seat 1: Jeffe-car (button) folded before Flop
Seat 2: livelikenolimit (small blind) folded before Flop
Seat 3: JBGMendes (big blind) collected (1275)
Seat 4: Peu Ivo folded before Flop (didn't bet)
Seat 5: panchi hmg folded before Flop (didn't bet)
Seat 6: bungades13 folded before Flop (didn't bet)
Seat 7: vishnya0409 folded before Flop (didn't bet)
Seat 8: Kevin12345Mc folded before Flop (didn't bet)



PokerStars Hand #255107716788: Tournament #3862890532, $4.80+$5.00+$1.20 USD Hold'em No Limit - Level XIV (175/350) - 2025/03/02 18:32:44 WET [2025/03/02 13:32:44 ET]
Table '3862890532 21' 8-max Seat #2 is the button
Seat 1: Jeffe-car (17116 in chips, $11.87 bounty) 
Seat 2: livelikenolimit (23815 in chips, $12.50 bounty) 
Seat 3: JBGMendes (13702 in chips, $10 bounty) 
Seat 4: Peu Ivo (45057 in chips, $20 bounty) 
Seat 5: panchi hmg (9866 in chips, $18.75 bounty) 
Seat 6: bungades13 (15977 in chips, $8.75 bounty) 
Seat 7: vishnya0409 (5791 in chips, $7.50 bounty) 
Seat 8: Kevin12345Mc (7727 in chips, $5 bounty) 
Jeffe-car: posts the ante 50
livelikenolimit: posts the ante 50
JBGMendes: posts the ante 50
Peu Ivo: posts the ante 50
panchi hmg: posts the ante 50
bungades13: posts the ante 50
vishnya0409: posts the ante 50
Kevin12345Mc: posts the ante 50
JBGMendes: posts small blind 175
Peu Ivo: posts big blind 350
*** HOLE CARDS ***
Dealt to Kevin12345Mc [5s 4c]
panchi hmg: raises 490 to 840
bungades13: calls 840
vishnya0409: folds 
Kevin12345Mc: folds 
Jeffe-car: folds 
livelikenolimit: folds 
JBGMendes: calls 665
Peu Ivo: folds 
*** FLOP *** [Ts 3c Td]
JBGMendes: checks 
panchi hmg: bets 719
bungades13: folds 
JBGMendes: folds 
Uncalled bet (719) returned to panchi hmg
panchi hmg collected 3270 from pot
*** SUMMARY ***
Total pot 3270 | Rake 0 
Board [Ts 3c Td]
Seat 1: Jeffe-car folded before Flop (didn't bet)
Seat 2: livelikenolimit (button) folded before Flop (didn't bet)
Seat 3: JBGMendes (small blind) folded on the Flop
Seat 4: Peu Ivo (big blind) folded before Flop
Seat 5: panchi hmg collected (3270)
Seat 6: bungades13 folded on the Flop
Seat 7: vishnya0409 folded before Flop (didn't bet)
Seat 8: Kevin12345Mc folded before Flop (didn't bet)



PokerStars Hand #255107731060: Tournament #3862890532, $4.80+$5.00+$1.20 USD Hold'em No Limit - Level XIV (175/350) - 2025/03/02 18:33:27 WET [2025/03/02 13:33:27 ET]
Table '3862890532 21' 8-max Seat #3 is the button
Seat 1: Jeffe-car (17066 in chips, $11.87 bounty) 
Seat 2: livelikenolimit (23765 in chips, $12.50 bounty) 
Seat 3: JBGMendes (12812 in chips, $10 bounty) 
Seat 4: Peu Ivo (44657 in chips, $20 bounty) 
Seat 5: panchi hmg (12246 in chips, $18.75 bounty) 
Seat 6: bungades13 (15087 in chips, $8.75 bounty) 
Seat 7: vishnya0409 (5741 in chips, $7.50 bounty) 
Seat 8: Kevin12345Mc (7677 in chips, $5 bounty) 
Jeffe-car: posts the ante 50
livelikenolimit: posts the ante 50
JBGMendes: posts the ante 50
Peu Ivo: posts the ante 50
panchi hmg: posts the ante 50
bungades13: posts the ante 50
vishnya0409: posts the ante 50
Kevin12345Mc: posts the ante 50
Peu Ivo: posts small blind 175
panchi hmg: posts big blind 350
*** HOLE CARDS ***
Dealt to Kevin12345Mc [Ac Jd]
bungades13: calls 350
vishnya0409: folds 
Kevin12345Mc: raises 350 to 700
Jeffe-car: folds 
livelikenolimit: folds 
JBGMendes: folds 
Peu Ivo: folds 
panchi hmg: raises 3745 to 4445
bungades13: folds 
Kevin12345Mc: raises 3182 to 7627 and is all-in
panchi hmg: calls 3182
*** FLOP *** [6h Jh Js]
*** TURN *** [6h Jh Js] [7h]
*** RIVER *** [6h Jh Js 7h] [5d]
*** SHOW DOWN ***
panchi hmg: shows [6d 6c] (a full house, Sixes full of Jacks)
Kevin12345Mc: shows [Ac Jd] (three of a kind, Jacks)
panchi hmg collected 16179 from pot
panchi hmg wins $2.50 for eliminating Kevin12345Mc and their own bounty increases by $2.50 to $21.25
Kevin12345Mc finished the tournament in 1443rd place
*** SUMMARY ***
Total pot 16179 | Rake 0 
Board [6h Jh Js 7h 5d]
Seat 1: Jeffe-car folded before Flop (didn't bet)
Seat 2: livelikenolimit folded before Flop (didn't bet)
Seat 3: JBGMendes (button) folded before Flop (didn't bet)
Seat 4: Peu Ivo (small blind) folded before Flop
Seat 5: panchi hmg (big blind) showed [6d 6c] and won (16179) with a full house, Sixes full of Jacks
Seat 6: bungades13 folded before Flop
Seat 7: vishnya0409 folded before Flop (didn't bet)
Seat 8: Kevin12345Mc showed [Ac Jd] and lost with three of a kind, Jacks



