PokerStars Hand #255212419331: Tournament #3863783058, $9.80+$1.20 USD Hold'em No Limit - Level I (25/50) - 2025/03/09 17:59:51 WET [2025/03/09 13:59:51 ET]
Table '3863783058 70' 8-max Seat #1 is the button
Seat 1: Kevin12345Mc (10000 in chips) 
Seat 2: DerekWinston (10000 in chips) 
Seat 3: LencsA (10000 in chips) 
Seat 4: 1-Loveleven-1 (10000 in chips) 
Seat 5: Jamekya 228 (10000 in chips) 
Seat 6: clyjoe (10000 in chips) 
Seat 7: sötsomsocker (10000 in chips) 
Seat 8: Sig4rillo (10000 in chips) 
Kevin12345Mc: posts the ante 6
DerekWinston: posts the ante 6
LencsA: posts the ante 6
1-Loveleven-1: posts the ante 6
Jamekya 228: posts the ante 6
clyjoe: posts the ante 6
sötsomsocker: posts the ante 6
Sig4rillo: posts the ante 6
DerekWinston: posts small blind 25
LencsA: posts big blind 50
*** HOLE CARDS ***
Dealt to Kevin12345Mc [7c 3h]
1-Loveleven-1: folds 
Jamekya 228: folds 
clyjoe: folds 
sötsomsocker: folds 
Sig4rillo: folds 
Kevin12345Mc: folds 
DerekWinston: raises 125 to 175
LencsA: raises 9819 to 9994 and is all-in
DerekWinston: calls 9819 and is all-in
*** FLOP *** [Td 5h 6d]
*** TURN *** [Td 5h 6d] [Qd]
*** RIVER *** [Td 5h 6d Qd] [3s]
*** SHOW DOWN ***
DerekWinston: shows [As Ah] (a pair of Aces)
LencsA: shows [Jc Js] (a pair of Jacks)
DerekWinston collected 20036 from pot
LencsA finished the tournament
*** SUMMARY ***
Total pot 20036 | Rake 0 
Board [Td 5h 6d Qd 3s]
Seat 1: Kevin12345Mc (button) folded before Flop (didn't bet)
Seat 2: DerekWinston (small blind) showed [As Ah] and won (20036) with a pair of Aces
Seat 3: LencsA (big blind) showed [Jc Js] and lost with a pair of Jacks
Seat 4: 1-Loveleven-1 folded before Flop (didn't bet)
Seat 5: Jamekya 228 folded before Flop (didn't bet)
Seat 6: clyjoe folded before Flop (didn't bet)
Seat 7: sötsomsocker folded before Flop (didn't bet)
Seat 8: Sig4rillo folded before Flop (didn't bet)



PokerStars Hand #255212424675: Tournament #3863783058, $9.80+$1.20 USD Hold'em No Limit - Level I (25/50) - 2025/03/09 18:00:17 WET [2025/03/09 14:00:17 ET]
Table '3863783058 70' 8-max Seat #2 is the button
Seat 1: Kevin12345Mc (9994 in chips) 
Seat 2: DerekWinston (20036 in chips) 
Seat 4: 1-Loveleven-1 (9994 in chips) 
Seat 5: Jamekya 228 (9994 in chips) 
Seat 6: clyjoe (9994 in chips) 
Seat 7: sötsomsocker (9994 in chips) 
Seat 8: Sig4rillo (9994 in chips) 
Kevin12345Mc: posts the ante 6
DerekWinston: posts the ante 6
1-Loveleven-1: posts the ante 6
Jamekya 228: posts the ante 6
clyjoe: posts the ante 6
sötsomsocker: posts the ante 6
Sig4rillo: posts the ante 6
1-Loveleven-1: posts small blind 25
Jamekya 228: posts big blind 50
*** HOLE CARDS ***
Dealt to Kevin12345Mc [6c Ah]
clyjoe: folds 
sötsomsocker: folds 
Sig4rillo: folds 
Kevin12345Mc: raises 75 to 125
DerekWinston: folds 
1-Loveleven-1: folds 
Jamekya 228: folds 
Uncalled bet (75) returned to Kevin12345Mc
Kevin12345Mc collected 167 from pot
Kevin12345Mc: doesn't show hand 
*** SUMMARY ***
Total pot 167 | Rake 0 
Seat 1: Kevin12345Mc collected (167)
Seat 2: DerekWinston (button) folded before Flop (didn't bet)
Seat 4: 1-Loveleven-1 (small blind) folded before Flop
Seat 5: Jamekya 228 (big blind) folded before Flop
Seat 6: clyjoe folded before Flop (didn't bet)
Seat 7: sötsomsocker folded before Flop (didn't bet)
Seat 8: Sig4rillo folded before Flop (didn't bet)



PokerStars Hand #255212429139: Tournament #3863783058, $9.80+$1.20 USD Hold'em No Limit - Level I (25/50) - 2025/03/09 18:00:37 WET [2025/03/09 14:00:37 ET]
Table '3863783058 70' 8-max Seat #4 is the button
Seat 1: Kevin12345Mc (10105 in chips) 
Seat 2: DerekWinston (20030 in chips) 
Seat 3: tremvito (10000 in chips) 
Seat 4: 1-Loveleven-1 (9963 in chips) 
Seat 5: Jamekya 228 (9938 in chips) 
Seat 6: clyjoe (9988 in chips) 
Seat 8: Sig4rillo (9988 in chips) 
Kevin12345Mc: posts the ante 6
DerekWinston: posts the ante 6
tremvito: posts the ante 6
1-Loveleven-1: posts the ante 6
Jamekya 228: posts the ante 6
clyjoe: posts the ante 6
Sig4rillo: posts the ante 6
Jamekya 228: posts small blind 25
clyjoe: posts big blind 50
*** HOLE CARDS ***
Dealt to Kevin12345Mc [6d Ts]
Sig4rillo: folds 
Kevin12345Mc: folds 
DerekWinston: folds 
tremvito: raises 100 to 150
1-Loveleven-1: folds 
Jamekya 228: folds 
clyjoe: calls 100
*** FLOP *** [9c Ks 4s]
clyjoe: checks 
hendrik 41 is disconnected 
tremvito: bets 367
clyjoe: folds 
Uncalled bet (367) returned to tremvito
tremvito collected 367 from pot
*** SUMMARY ***
Total pot 367 | Rake 0 
Board [9c Ks 4s]
Seat 1: Kevin12345Mc folded before Flop (didn't bet)
Seat 2: DerekWinston folded before Flop (didn't bet)
Seat 3: tremvito collected (367)
Seat 4: 1-Loveleven-1 (button) folded before Flop (didn't bet)
Seat 5: Jamekya 228 (small blind) folded before Flop
Seat 6: clyjoe (big blind) folded on the Flop
Seat 8: Sig4rillo folded before Flop (didn't bet)



PokerStars Hand #255212438628: Tournament #3863783058, $9.80+$1.20 USD Hold'em No Limit - Level I (25/50) - 2025/03/09 18:01:17 WET [2025/03/09 14:01:17 ET]
Table '3863783058 70' 8-max Seat #5 is the button
Seat 1: Kevin12345Mc (10099 in chips) 
Seat 2: DerekWinston (20024 in chips) 
Seat 3: tremvito (10211 in chips) 
Seat 4: 1-Loveleven-1 (9957 in chips) 
Seat 5: Jamekya 228 (9907 in chips) 
Seat 6: clyjoe (9832 in chips) 
Seat 7: hendrik 41 (10000 in chips) 
Kevin12345Mc: posts the ante 6
DerekWinston: posts the ante 6
tremvito: posts the ante 6
1-Loveleven-1: posts the ante 6
Jamekya 228: posts the ante 6
clyjoe: posts the ante 6
hendrik 41: posts the ante 6
clyjoe: posts small blind 25
hendrik 41: posts big blind 50
*** HOLE CARDS ***
Dealt to Kevin12345Mc [4h 2h]
Kevin12345Mc: folds 
DerekWinston: folds 
tremvito: folds 
1-Loveleven-1: folds 
Jamekya 228: raises 60 to 110
krauli1000 is disconnected 
clyjoe: calls 85
hendrik 41: folds 
*** FLOP *** [Td 3s 2c]
clyjoe: checks 
Jamekya 228: checks 
*** TURN *** [Td 3s 2c] [3d]
clyjoe: checks 
Jamekya 228: checks 
*** RIVER *** [Td 3s 2c 3d] [6c]
clyjoe: checks 
Jamekya 228: checks 
*** SHOW DOWN ***
clyjoe: shows [9h 8h] (a pair of Threes)
Jamekya 228: shows [9d Kh] (a pair of Threes - King kicker)
Jamekya 228 collected 312 from pot
*** SUMMARY ***
Total pot 312 | Rake 0 
Board [Td 3s 2c 3d 6c]
Seat 1: Kevin12345Mc folded before Flop (didn't bet)
Seat 2: DerekWinston folded before Flop (didn't bet)
Seat 3: tremvito folded before Flop (didn't bet)
Seat 4: 1-Loveleven-1 folded before Flop (didn't bet)
Seat 5: Jamekya 228 (button) showed [9d Kh] and won (312) with a pair of Threes
Seat 6: clyjoe (small blind) showed [9h 8h] and lost with a pair of Threes
Seat 7: hendrik 41 (big blind) folded before Flop



PokerStars Hand #255212447974: Tournament #3863783058, $9.80+$1.20 USD Hold'em No Limit - Level I (25/50) - 2025/03/09 18:01:50 WET [2025/03/09 14:01:50 ET]
Table '3863783058 285' 8-max Seat #1 is the button
Seat 1: thaiisfl (10000 in chips) 
Seat 2: NelKru (9994 in chips) 
Seat 3: JQWXID (10105 in chips) 
Seat 4: Kevin12345Mc (10093 in chips) 
Seat 7: pavlenko den (10000 in chips) 
thaiisfl: posts the ante 6
NelKru: posts the ante 6
JQWXID: posts the ante 6
Kevin12345Mc: posts the ante 6
pavlenko den: posts the ante 6
NelKru: posts small blind 25
JQWXID: posts big blind 50
*** HOLE CARDS ***
Dealt to Kevin12345Mc [Qc 3c]
Kevin12345Mc is disconnected 
Kevin12345Mc is connected 
NelKru is disconnected 
pavlenko den is disconnected 
Cordeiro288 is disconnected 
thaiisfl is disconnected 
Kevin12345Mc: folds 
JR.smoker is disconnected 
pavlenko den: raises 50 to 100
thaiisfl: calls 100
NelKru: calls 75
JQWXID: folds 
*** FLOP *** [9s 2d Th]
NelKru: checks 
pavlenko den: checks 
thaiisfl: bets 175
NelKru: calls 175
pavlenko den: folds 
*** TURN *** [9s 2d Th] [Jc]
NelKru: checks 
thaiisfl: checks 
*** RIVER *** [9s 2d Th Jc] [Jd]
NelKru: checks 
thaiisfl: bets 548
NelKru: folds 
Uncalled bet (548) returned to thaiisfl
thaiisfl collected 730 from pot
*** SUMMARY ***
Total pot 730 | Rake 0 
Board [9s 2d Th Jc Jd]
Seat 1: thaiisfl (button) collected (730)
Seat 2: NelKru (small blind) folded on the River
Seat 3: JQWXID (big blind) folded before Flop
Seat 4: Kevin12345Mc folded before Flop (didn't bet)
Seat 7: pavlenko den folded on the Flop



PokerStars Hand #255212480154: Tournament #3863783058, $9.80+$1.20 USD Hold'em No Limit - Level I (25/50) - 2025/03/09 18:03:36 WET [2025/03/09 14:03:36 ET]
Table '3863783058 446' 8-max Seat #1 is the button
Seat 1: quebrada157 (10111 in chips) 
Seat 2: Whysoserios0 (9009 in chips) 
Seat 3: Kevin12345Mc (10087 in chips) 
Seat 4: gavonater (10000 in chips) 
Seat 7: lele19941607 (10000 in chips) 
Seat 8: r1social (10000 in chips) 
quebrada157: posts the ante 6
Whysoserios0: posts the ante 6
Kevin12345Mc: posts the ante 6
gavonater: posts the ante 6
lele19941607: posts the ante 6
r1social: posts the ante 6
Whysoserios0: posts small blind 25
Kevin12345Mc: posts big blind 50
*** HOLE CARDS ***
Dealt to Kevin12345Mc [2s 5s]
quebrada157 is disconnected 
Kevin12345Mc is disconnected 
1-Loveleven-1 is disconnected 
gavonater is connected 
gavonater is connected 
r1social is disconnected 
lele19941607 is disconnected 
gavonater: folds 
lele19941607 is connected 
mocano32 is disconnected 
lele19941607: folds 
r1social: folds 
quebrada157: raises 100 to 150
Whysoserios0: folds 
Kevin12345Mc: folds 
Uncalled bet (100) returned to quebrada157
quebrada157 collected 161 from pot
quebrada157: doesn't show hand 
*** SUMMARY ***
Total pot 161 | Rake 0 
Seat 1: quebrada157 (button) collected (161)
Seat 2: Whysoserios0 (small blind) folded before Flop
Seat 3: Kevin12345Mc (big blind) folded before Flop
Seat 4: gavonater folded before Flop (didn't bet)
Seat 7: lele19941607 folded before Flop (didn't bet)
Seat 8: r1social folded before Flop (didn't bet)



PokerStars Hand #255212487369: Tournament #3863783058, $9.80+$1.20 USD Hold'em No Limit - Level I (25/50) - 2025/03/09 18:03:59 WET [2025/03/09 14:03:59 ET]
Table '3863783058 446' 8-max Seat #2 is the button
Seat 1: quebrada157 (10216 in chips) 
Seat 2: Whysoserios0 (8978 in chips) 
Seat 3: Kevin12345Mc (10031 in chips) 
Seat 4: gavonater (9994 in chips) 
Seat 5: 1-Loveleven-1 (9939 in chips) 
Seat 6: mocano32 (10000 in chips) 
Seat 7: lele19941607 (9994 in chips) 
Seat 8: r1social (9994 in chips) 
quebrada157: posts the ante 6
Whysoserios0: posts the ante 6
Kevin12345Mc: posts the ante 6
gavonater: posts the ante 6
1-Loveleven-1: posts the ante 6
mocano32: posts the ante 6
lele19941607: posts the ante 6
r1social: posts the ante 6
Kevin12345Mc: posts small blind 25
gavonater: posts big blind 50
*** HOLE CARDS ***
Dealt to Kevin12345Mc [4h Qc]
1-Loveleven-1: folds 
mocano32: folds 
lele19941607: folds 
r1social: raises 50 to 100
quebrada157: folds 
Whysoserios0: calls 100
Kevin12345Mc: folds 
gavonater: folds 
*** FLOP *** [As 7h Qs]
r1social: bets 97
Whysoserios0: calls 97
*** TURN *** [As 7h Qs] [4s]
r1social: bets 388
Whysoserios0: calls 388
*** RIVER *** [As 7h Qs 4s] [6d]
r1social: checks 
Whysoserios0: checks 
*** SHOW DOWN ***
r1social: shows [Kh Tc] (high card Ace)
Whysoserios0: shows [9h Ah] (a pair of Aces)
Whysoserios0 collected 1293 from pot
*** SUMMARY ***
Total pot 1293 | Rake 0 
Board [As 7h Qs 4s 6d]
Seat 1: quebrada157 folded before Flop (didn't bet)
Seat 2: Whysoserios0 (button) showed [9h Ah] and won (1293) with a pair of Aces
Seat 3: Kevin12345Mc (small blind) folded before Flop
Seat 4: gavonater (big blind) folded before Flop
Seat 5: 1-Loveleven-1 folded before Flop (didn't bet)
Seat 6: mocano32 folded before Flop (didn't bet)
Seat 7: lele19941607 folded before Flop (didn't bet)
Seat 8: r1social showed [Kh Tc] and lost with high card Ace



PokerStars Hand #255212512716: Tournament #3863783058, $9.80+$1.20 USD Hold'em No Limit - Level I (25/50) - 2025/03/09 18:05:19 WET [2025/03/09 14:05:19 ET]
Table '3863783058 446' 8-max Seat #3 is the button
Seat 1: quebrada157 (10210 in chips) 
Seat 2: Whysoserios0 (9680 in chips) 
Seat 3: Kevin12345Mc (10000 in chips) 
Seat 4: gavonater (9938 in chips) 
Seat 5: 1-Loveleven-1 (9933 in chips) 
Seat 6: mocano32 (9994 in chips) 
Seat 7: lele19941607 (9988 in chips) 
Seat 8: r1social (9403 in chips) 
quebrada157: posts the ante 6
Whysoserios0: posts the ante 6
Kevin12345Mc: posts the ante 6
gavonater: posts the ante 6
1-Loveleven-1: posts the ante 6
mocano32: posts the ante 6
lele19941607: posts the ante 6
r1social: posts the ante 6
gavonater: posts small blind 25
1-Loveleven-1: posts big blind 50
*** HOLE CARDS ***
Dealt to Kevin12345Mc [6s 7d]
mocano32: calls 50
lele19941607: folds 
r1social: folds 
quebrada157: folds 
Whysoserios0: folds 
Kevin12345Mc: folds 
gavonater: folds 
1-Loveleven-1: checks 
*** FLOP *** [9d Jh Ks]
1-Loveleven-1: checks 
mocano32: checks 
*** TURN *** [9d Jh Ks] [Qs]
1-Loveleven-1: bets 150
mocano32: folds 
Uncalled bet (150) returned to 1-Loveleven-1
1-Loveleven-1 collected 173 from pot
1-Loveleven-1: doesn't show hand 
*** SUMMARY ***
Total pot 173 | Rake 0 
Board [9d Jh Ks Qs]
Seat 1: quebrada157 folded before Flop (didn't bet)
Seat 2: Whysoserios0 folded before Flop (didn't bet)
Seat 3: Kevin12345Mc (button) folded before Flop (didn't bet)
Seat 4: gavonater (small blind) folded before Flop
Seat 5: 1-Loveleven-1 (big blind) collected (173)
Seat 6: mocano32 folded on the Turn
Seat 7: lele19941607 folded before Flop (didn't bet)
Seat 8: r1social folded before Flop (didn't bet)



PokerStars Hand #255212529782: Tournament #3863783058, $9.80+$1.20 USD Hold'em No Limit - Level I (25/50) - 2025/03/09 18:06:12 WET [2025/03/09 14:06:12 ET]
Table '3863783058 446' 8-max Seat #4 is the button
Seat 1: quebrada157 (10204 in chips) 
Seat 2: Whysoserios0 (9674 in chips) 
Seat 3: Kevin12345Mc (9994 in chips) 
Seat 4: gavonater (9907 in chips) 
Seat 5: 1-Loveleven-1 (10050 in chips) 
Seat 6: mocano32 (9938 in chips) 
Seat 7: lele19941607 (9982 in chips) 
Seat 8: r1social (9397 in chips) 
quebrada157: posts the ante 6
Whysoserios0: posts the ante 6
Kevin12345Mc: posts the ante 6
gavonater: posts the ante 6
1-Loveleven-1: posts the ante 6
mocano32: posts the ante 6
lele19941607: posts the ante 6
r1social: posts the ante 6
1-Loveleven-1: posts small blind 25
mocano32: posts big blind 50
*** HOLE CARDS ***
Dealt to Kevin12345Mc [6c Ks]
lele19941607: folds 
r1social: folds 
quebrada157: folds 
Whysoserios0: folds 
Kevin12345Mc: folds 
gavonater: folds 
1-Loveleven-1: calls 25
mocano32: checks 
*** FLOP *** [Td 9d As]
1-Loveleven-1: checks 
mocano32: checks 
*** TURN *** [Td 9d As] [7d]
1-Loveleven-1: bets 50
mocano32: calls 50
*** RIVER *** [Td 9d As 7d] [6h]
1-Loveleven-1: bets 150
mocano32: calls 150
*** SHOW DOWN ***
1-Loveleven-1: shows [8d 9h] (a straight, Six to Ten)
mocano32: mucks hand 
1-Loveleven-1 collected 548 from pot
*** SUMMARY ***
Total pot 548 | Rake 0 
Board [Td 9d As 7d 6h]
Seat 1: quebrada157 folded before Flop (didn't bet)
Seat 2: Whysoserios0 folded before Flop (didn't bet)
Seat 3: Kevin12345Mc folded before Flop (didn't bet)
Seat 4: gavonater (button) folded before Flop (didn't bet)
Seat 5: 1-Loveleven-1 (small blind) showed [8d 9h] and won (548) with a straight, Six to Ten
Seat 6: mocano32 (big blind) mucked [6d Ah]
Seat 7: lele19941607 folded before Flop (didn't bet)
Seat 8: r1social folded before Flop (didn't bet)



PokerStars Hand #255212545405: Tournament #3863783058, $9.80+$1.20 USD Hold'em No Limit - Level I (25/50) - 2025/03/09 18:07:01 WET [2025/03/09 14:07:01 ET]
Table '3863783058 446' 8-max Seat #5 is the button
Seat 1: quebrada157 (10198 in chips) 
Seat 2: Whysoserios0 (9668 in chips) 
Seat 3: Kevin12345Mc (9988 in chips) 
Seat 4: gavonater (9901 in chips) 
Seat 5: 1-Loveleven-1 (10342 in chips) 
Seat 6: mocano32 (9682 in chips) 
Seat 7: lele19941607 (9976 in chips) 
Seat 8: r1social (9391 in chips) 
quebrada157: posts the ante 6
Whysoserios0: posts the ante 6
Kevin12345Mc: posts the ante 6
gavonater: posts the ante 6
1-Loveleven-1: posts the ante 6
mocano32: posts the ante 6
lele19941607: posts the ante 6
r1social: posts the ante 6
mocano32: posts small blind 25
lele19941607: posts big blind 50
*** HOLE CARDS ***
Dealt to Kevin12345Mc [Ks 4h]
r1social: folds 
quebrada157: folds 
Whysoserios0: raises 50 to 100
Kevin12345Mc: folds 
gavonater: folds 
1-Loveleven-1: folds 
mocano32: raises 300 to 400
lele19941607: folds 
Whysoserios0: folds 
Uncalled bet (300) returned to mocano32
mocano32 collected 298 from pot
mocano32: doesn't show hand 
*** SUMMARY ***
Total pot 298 | Rake 0 
Seat 1: quebrada157 folded before Flop (didn't bet)
Seat 2: Whysoserios0 folded before Flop
Seat 3: Kevin12345Mc folded before Flop (didn't bet)
Seat 4: gavonater folded before Flop (didn't bet)
Seat 5: 1-Loveleven-1 (button) folded before Flop (didn't bet)
Seat 6: mocano32 (small blind) collected (298)
Seat 7: lele19941607 (big blind) folded before Flop
Seat 8: r1social folded before Flop (didn't bet)



PokerStars Hand #255212559369: Tournament #3863783058, $9.80+$1.20 USD Hold'em No Limit - Level I (25/50) - 2025/03/09 18:07:45 WET [2025/03/09 14:07:45 ET]
Table '3863783058 446' 8-max Seat #6 is the button
Seat 1: quebrada157 (10192 in chips) 
Seat 2: Whysoserios0 (9562 in chips) 
Seat 3: Kevin12345Mc (9982 in chips) 
Seat 4: gavonater (9895 in chips) 
Seat 5: 1-Loveleven-1 (10336 in chips) 
Seat 6: mocano32 (9874 in chips) 
Seat 7: lele19941607 (9920 in chips) 
Seat 8: r1social (9385 in chips) 
quebrada157: posts the ante 6
Whysoserios0: posts the ante 6
Kevin12345Mc: posts the ante 6
gavonater: posts the ante 6
1-Loveleven-1: posts the ante 6
mocano32: posts the ante 6
lele19941607: posts the ante 6
r1social: posts the ante 6
lele19941607: posts small blind 25
r1social: posts big blind 50
*** HOLE CARDS ***
Dealt to Kevin12345Mc [7d Ad]
quebrada157: folds 
Whysoserios0: folds 
Kevin12345Mc: raises 75 to 125
gavonater: folds 
1-Loveleven-1: folds 
mocano32: calls 125
lele19941607: folds 
r1social: calls 75
*** FLOP *** [6h 2s Ah]
r1social: checks 
Kevin12345Mc: bets 224
mocano32: calls 224
r1social: folds 
*** TURN *** [6h 2s Ah] [4d]
Kevin12345Mc: bets 591
mocano32: calls 591
*** RIVER *** [6h 2s Ah 4d] [Qd]
Kevin12345Mc: checks 
mocano32: bets 1039
Kevin12345Mc: calls 1039
*** SHOW DOWN ***
mocano32: shows [9d As] (a pair of Aces)
Kevin12345Mc: mucks hand 
mocano32 collected 4156 from pot
*** SUMMARY ***
Total pot 4156 | Rake 0 
Board [6h 2s Ah 4d Qd]
Seat 1: quebrada157 folded before Flop (didn't bet)
Seat 2: Whysoserios0 folded before Flop (didn't bet)
Seat 3: Kevin12345Mc mucked [7d Ad]
Seat 4: gavonater folded before Flop (didn't bet)
Seat 5: 1-Loveleven-1 folded before Flop (didn't bet)
Seat 6: mocano32 (button) showed [9d As] and won (4156) with a pair of Aces
Seat 7: lele19941607 (small blind) folded before Flop
Seat 8: r1social (big blind) folded on the Flop



PokerStars Hand #255212580016: Tournament #3863783058, $9.80+$1.20 USD Hold'em No Limit - Level I (25/50) - 2025/03/09 18:08:50 WET [2025/03/09 14:08:50 ET]
Table '3863783058 446' 8-max Seat #7 is the button
Seat 1: quebrada157 (10186 in chips) 
Seat 2: Whysoserios0 (9556 in chips) 
Seat 3: Kevin12345Mc (7997 in chips) 
Seat 4: gavonater (9889 in chips) 
Seat 5: 1-Loveleven-1 (10330 in chips) 
Seat 6: mocano32 (12045 in chips) 
Seat 7: lele19941607 (9889 in chips) 
Seat 8: r1social (9254 in chips) 
quebrada157: posts the ante 6
Whysoserios0: posts the ante 6
Kevin12345Mc: posts the ante 6
gavonater: posts the ante 6
1-Loveleven-1: posts the ante 6
mocano32: posts the ante 6
lele19941607: posts the ante 6
r1social: posts the ante 6
r1social: posts small blind 25
quebrada157: posts big blind 50
*** HOLE CARDS ***
Dealt to Kevin12345Mc [Ah Td]
Whysoserios0: folds 
Kevin12345Mc: raises 75 to 125
gavonater: folds 
1-Loveleven-1: folds 
mocano32: folds 
lele19941607: folds 
r1social: folds 
quebrada157: calls 75
*** FLOP *** [9d 6c Kc]
quebrada157: checks 
Kevin12345Mc: bets 107
quebrada157: calls 107
*** TURN *** [9d 6c Kc] [8c]
quebrada157: checks 
Kevin12345Mc: checks 
*** RIVER *** [9d 6c Kc 8c] [9c]
quebrada157: bets 300
Kevin12345Mc: folds 
Uncalled bet (300) returned to quebrada157
quebrada157 collected 537 from pot
quebrada157: doesn't show hand 
*** SUMMARY ***
Total pot 537 | Rake 0 
Board [9d 6c Kc 8c 9c]
Seat 1: quebrada157 (big blind) collected (537)
Seat 2: Whysoserios0 folded before Flop (didn't bet)
Seat 3: Kevin12345Mc folded on the River
Seat 4: gavonater folded before Flop (didn't bet)
Seat 5: 1-Loveleven-1 folded before Flop (didn't bet)
Seat 6: mocano32 folded before Flop (didn't bet)
Seat 7: lele19941607 (button) folded before Flop (didn't bet)
Seat 8: r1social (small blind) folded before Flop



PokerStars Hand #255212600916: Tournament #3863783058, $9.80+$1.20 USD Hold'em No Limit - Level II (30/60) - 2025/03/09 18:09:55 WET [2025/03/09 14:09:55 ET]
Table '3863783058 446' 8-max Seat #8 is the button
Seat 1: quebrada157 (10485 in chips) 
Seat 2: Whysoserios0 (9550 in chips) 
Seat 3: Kevin12345Mc (7759 in chips) 
Seat 4: gavonater (9883 in chips) 
Seat 5: 1-Loveleven-1 (10324 in chips) 
Seat 6: mocano32 (12039 in chips) 
Seat 7: lele19941607 (9883 in chips) 
Seat 8: r1social (9223 in chips) 
quebrada157: posts the ante 8
Whysoserios0: posts the ante 8
Kevin12345Mc: posts the ante 8
gavonater: posts the ante 8
1-Loveleven-1: posts the ante 8
mocano32: posts the ante 8
lele19941607: posts the ante 8
r1social: posts the ante 8
quebrada157: posts small blind 30
Whysoserios0: posts big blind 60
*** HOLE CARDS ***
Dealt to Kevin12345Mc [Qd 5h]
Kevin12345Mc: folds 
gavonater: folds 
1-Loveleven-1: folds 
mocano32: calls 60
lele19941607: folds 
r1social: raises 180 to 240
quebrada157: folds 
Whysoserios0: folds 
mocano32: calls 180
*** FLOP *** [9s Ts 9h]
mocano32: checks 
r1social: bets 190
mocano32: calls 190
*** TURN *** [9s Ts 9h] [3d]
mocano32: checks 
r1social: checks 
*** RIVER *** [9s Ts 9h 3d] [6s]
mocano32: bets 507
r1social: calls 507
*** SHOW DOWN ***
mocano32: shows [5d 9d] (three of a kind, Nines)
r1social: mucks hand 
mocano32 collected 2028 from pot
*** SUMMARY ***
Total pot 2028 | Rake 0 
Board [9s Ts 9h 3d 6s]
Seat 1: quebrada157 (small blind) folded before Flop
Seat 2: Whysoserios0 (big blind) folded before Flop
Seat 3: Kevin12345Mc folded before Flop (didn't bet)
Seat 4: gavonater folded before Flop (didn't bet)
Seat 5: 1-Loveleven-1 folded before Flop (didn't bet)
Seat 6: mocano32 showed [5d 9d] and won (2028) with three of a kind, Nines
Seat 7: lele19941607 folded before Flop (didn't bet)
Seat 8: r1social (button) mucked [As Kc]



PokerStars Hand #255212625479: Tournament #3863783058, $9.80+$1.20 USD Hold'em No Limit - Level II (30/60) - 2025/03/09 18:11:13 WET [2025/03/09 14:11:13 ET]
Table '3863783058 952' 8-max Seat #1 is the button
Seat 1: som1990 (10933 in chips) 
Seat 2: Kevin12345Mc (7751 in chips) 
Seat 3: bagzarelli (9968 in chips) 
Seat 4: Crespo230 (9720 in chips) 
Seat 5: Stephan1164 (8637 in chips) 
Seat 6: @L1N93 (10000 in chips) 
Seat 8: CJ_Trip (10000 in chips) 
som1990: posts the ante 8
Kevin12345Mc: posts the ante 8
bagzarelli: posts the ante 8
Crespo230: posts the ante 8
Stephan1164: posts the ante 8
@L1N93: posts the ante 8
CJ_Trip: posts the ante 8
Kevin12345Mc: posts small blind 30
bagzarelli: posts big blind 60
*** HOLE CARDS ***
Dealt to Kevin12345Mc [9s 9d]
Stephan1164 is disconnected 
bagzarelli is disconnected 
@L1N93 is disconnected 
Crespo230 is disconnected 
CJ_Trip is disconnected 
Crespo230 is connected 
Ra4ok123 is disconnected 
Crespo230: folds 
Stephan1164: raises 60 to 120
@L1N93: folds 
CJ_Trip: calls 120
som1990: folds 
Kevin12345Mc: raises 420 to 540
bagzarelli: folds 
Stephan1164: calls 420
CJ_Trip: folds 
*** FLOP *** [3c Kh 4h]
Kevin12345Mc: bets 434
Stephan1164: calls 434
*** TURN *** [3c Kh 4h] [6c]
Kevin12345Mc: checks 
Stephan1164: bets 540
Kevin12345Mc: calls 540
*** RIVER *** [3c Kh 4h 6c] [5c]
Kevin12345Mc: checks 
Stephan1164: checks 
*** SHOW DOWN ***
Kevin12345Mc: shows [9s 9d] (a pair of Nines)
Stephan1164: mucks hand 
Kevin12345Mc collected 3264 from pot
*** SUMMARY ***
Total pot 3264 | Rake 0 
Board [3c Kh 4h 6c 5c]
Seat 1: som1990 (button) folded before Flop (didn't bet)
Seat 2: Kevin12345Mc (small blind) showed [9s 9d] and won (3264) with a pair of Nines
Seat 3: bagzarelli (big blind) folded before Flop
Seat 4: Crespo230 folded before Flop (didn't bet)
Seat 5: Stephan1164 mucked [Th 3h]
Seat 6: @L1N93 folded before Flop (didn't bet)
Seat 8: CJ_Trip folded before Flop



PokerStars Hand #255212653182: Tournament #3863783058, $9.80+$1.20 USD Hold'em No Limit - Level II (30/60) - 2025/03/09 18:12:39 WET [2025/03/09 14:12:39 ET]
Table '3863783058 952' 8-max Seat #2 is the button
Seat 1: som1990 (10925 in chips) 
Seat 2: Kevin12345Mc (9493 in chips) 
Seat 3: bagzarelli (9900 in chips) 
Seat 4: Crespo230 (9712 in chips) 
Seat 5: Stephan1164 (7115 in chips) 
Seat 6: @L1N93 (9992 in chips) 
Seat 7: Ra4ok123 (10000 in chips) 
Seat 8: CJ_Trip (9872 in chips) 
som1990: posts the ante 8
Kevin12345Mc: posts the ante 8
bagzarelli: posts the ante 8
Crespo230: posts the ante 8
Stephan1164: posts the ante 8
@L1N93: posts the ante 8
Ra4ok123: posts the ante 8
CJ_Trip: posts the ante 8
bagzarelli: posts small blind 30
Crespo230: posts big blind 60
*** HOLE CARDS ***
Dealt to Kevin12345Mc [4d Qh]
Stephan1164: folds 
@L1N93: folds 
Ra4ok123: folds 
CJ_Trip: raises 90 to 150
som1990: folds 
Kevin12345Mc: folds 
bagzarelli: folds 
Crespo230: calls 90
*** FLOP *** [3d 8s Ac]
Crespo230: checks 
CJ_Trip: checks 
*** TURN *** [3d 8s Ac] [Kd]
Crespo230: checks 
CJ_Trip: bets 260
Crespo230: raises 667 to 927
CJ_Trip: folds 
Uncalled bet (667) returned to Crespo230
Crespo230 collected 914 from pot
Crespo230: doesn't show hand 
*** SUMMARY ***
Total pot 914 | Rake 0 
Board [3d 8s Ac Kd]
Seat 1: som1990 folded before Flop (didn't bet)
Seat 2: Kevin12345Mc (button) folded before Flop (didn't bet)
Seat 3: bagzarelli (small blind) folded before Flop
Seat 4: Crespo230 (big blind) collected (914)
Seat 5: Stephan1164 folded before Flop (didn't bet)
Seat 6: @L1N93 folded before Flop (didn't bet)
Seat 7: Ra4ok123 folded before Flop (didn't bet)
Seat 8: CJ_Trip folded on the Turn



PokerStars Hand #255212679136: Tournament #3863783058, $9.80+$1.20 USD Hold'em No Limit - Level II (30/60) - 2025/03/09 18:14:01 WET [2025/03/09 14:14:01 ET]
Table '3863783058 952' 8-max Seat #3 is the button
Seat 1: som1990 (10917 in chips) 
Seat 2: Kevin12345Mc (9485 in chips) 
Seat 3: bagzarelli (9862 in chips) 
Seat 4: Crespo230 (10208 in chips) 
Seat 5: Stephan1164 (7107 in chips) 
Seat 6: @L1N93 (9984 in chips) 
Seat 7: Ra4ok123 (9992 in chips) 
Seat 8: CJ_Trip (9454 in chips) 
som1990: posts the ante 8
Kevin12345Mc: posts the ante 8
bagzarelli: posts the ante 8
Crespo230: posts the ante 8
Stephan1164: posts the ante 8
@L1N93: posts the ante 8
Ra4ok123: posts the ante 8
CJ_Trip: posts the ante 8
Crespo230: posts small blind 30
Stephan1164: posts big blind 60
*** HOLE CARDS ***
Dealt to Kevin12345Mc [Kh 2c]
@L1N93: folds 
Ra4ok123: folds 
CJ_Trip: folds 
som1990: raises 120 to 180
Kevin12345Mc: folds 
bagzarelli: folds 
Crespo230: folds 
Stephan1164: folds 
Uncalled bet (120) returned to som1990
som1990 collected 214 from pot
som1990: doesn't show hand 
*** SUMMARY ***
Total pot 214 | Rake 0 
Seat 1: som1990 collected (214)
Seat 2: Kevin12345Mc folded before Flop (didn't bet)
Seat 3: bagzarelli (button) folded before Flop (didn't bet)
Seat 4: Crespo230 (small blind) folded before Flop
Seat 5: Stephan1164 (big blind) folded before Flop
Seat 6: @L1N93 folded before Flop (didn't bet)
Seat 7: Ra4ok123 folded before Flop (didn't bet)
Seat 8: CJ_Trip folded before Flop (didn't bet)



PokerStars Hand #255212689730: Tournament #3863783058, $9.80+$1.20 USD Hold'em No Limit - Level II (30/60) - 2025/03/09 18:14:34 WET [2025/03/09 14:14:34 ET]
Table '3863783058 952' 8-max Seat #4 is the button
Seat 1: som1990 (11063 in chips) 
Seat 2: Kevin12345Mc (9477 in chips) 
Seat 3: bagzarelli (9854 in chips) 
Seat 4: Crespo230 (10170 in chips) 
Seat 5: Stephan1164 (7039 in chips) 
Seat 6: @L1N93 (9976 in chips) 
Seat 7: Ra4ok123 (9984 in chips) 
Seat 8: CJ_Trip (9446 in chips) 
som1990: posts the ante 8
Kevin12345Mc: posts the ante 8
bagzarelli: posts the ante 8
Crespo230: posts the ante 8
Stephan1164: posts the ante 8
@L1N93: posts the ante 8
Ra4ok123: posts the ante 8
CJ_Trip: posts the ante 8
Stephan1164: posts small blind 30
@L1N93: posts big blind 60
*** HOLE CARDS ***
Dealt to Kevin12345Mc [2d 9s]
Ra4ok123: folds 
CJ_Trip: folds 
som1990: folds 
Kevin12345Mc: folds 
bagzarelli: folds 
Crespo230: raises 60 to 120
Stephan1164: calls 90
@L1N93: raises 630 to 750
Crespo230: calls 630
Stephan1164: calls 630
*** FLOP *** [3d 9h Kd]
Stephan1164: checks 
@L1N93: checks 
Crespo230: bets 764
Stephan1164: folds 
@L1N93: folds 
Uncalled bet (764) returned to Crespo230
Crespo230 collected 2314 from pot
Crespo230: doesn't show hand 
*** SUMMARY ***
Total pot 2314 | Rake 0 
Board [3d 9h Kd]
Seat 1: som1990 folded before Flop (didn't bet)
Seat 2: Kevin12345Mc folded before Flop (didn't bet)
Seat 3: bagzarelli folded before Flop (didn't bet)
Seat 4: Crespo230 (button) collected (2314)
Seat 5: Stephan1164 (small blind) folded on the Flop
Seat 6: @L1N93 (big blind) folded on the Flop
Seat 7: Ra4ok123 folded before Flop (didn't bet)
Seat 8: CJ_Trip folded before Flop (didn't bet)



PokerStars Hand #255212705622: Tournament #3863783058, $9.80+$1.20 USD Hold'em No Limit - Level II (30/60) - 2025/03/09 18:15:24 WET [2025/03/09 14:15:24 ET]
Table '3863783058 952' 8-max Seat #5 is the button
Seat 1: som1990 (11055 in chips) 
Seat 2: Kevin12345Mc (9469 in chips) 
Seat 3: bagzarelli (9846 in chips) 
Seat 4: Crespo230 (11726 in chips) 
Seat 5: Stephan1164 (6281 in chips) 
Seat 6: @L1N93 (9218 in chips) 
Seat 7: Ra4ok123 (9976 in chips) 
Seat 8: CJ_Trip (9438 in chips) 
som1990: posts the ante 8
Kevin12345Mc: posts the ante 8
bagzarelli: posts the ante 8
Crespo230: posts the ante 8
Stephan1164: posts the ante 8
@L1N93: posts the ante 8
Ra4ok123: posts the ante 8
CJ_Trip: posts the ante 8
@L1N93: posts small blind 30
Ra4ok123: posts big blind 60
*** HOLE CARDS ***
Dealt to Kevin12345Mc [7d Qc]
CJ_Trip: folds 
som1990: folds 
Kevin12345Mc: folds 
bagzarelli: folds 
Crespo230: folds 
Stephan1164: raises 60 to 120
@L1N93: folds 
Ra4ok123: calls 60
*** FLOP *** [8s 4h 9s]
Ra4ok123: checks 
Stephan1164: bets 600
Ra4ok123: calls 600
*** TURN *** [8s 4h 9s] [3d]
Ra4ok123: checks 
Stephan1164: bets 5553 and is all-in
Ra4ok123: folds 
Uncalled bet (5553) returned to Stephan1164
Stephan1164 collected 1534 from pot
Stephan1164: doesn't show hand 
*** SUMMARY ***
Total pot 1534 | Rake 0 
Board [8s 4h 9s 3d]
Seat 1: som1990 folded before Flop (didn't bet)
Seat 2: Kevin12345Mc folded before Flop (didn't bet)
Seat 3: bagzarelli folded before Flop (didn't bet)
Seat 4: Crespo230 folded before Flop (didn't bet)
Seat 5: Stephan1164 (button) collected (1534)
Seat 6: @L1N93 (small blind) folded before Flop
Seat 7: Ra4ok123 (big blind) folded on the Turn
Seat 8: CJ_Trip folded before Flop (didn't bet)



PokerStars Hand #255212722455: Tournament #3863783058, $9.80+$1.20 USD Hold'em No Limit - Level II (30/60) - 2025/03/09 18:16:17 WET [2025/03/09 14:16:17 ET]
Table '3863783058 952' 8-max Seat #6 is the button
Seat 1: som1990 (11047 in chips) 
Seat 2: Kevin12345Mc (9461 in chips) 
Seat 3: bagzarelli (9838 in chips) 
Seat 4: Crespo230 (11718 in chips) 
Seat 5: Stephan1164 (7087 in chips) 
Seat 6: @L1N93 (9180 in chips) 
Seat 7: Ra4ok123 (9248 in chips) 
Seat 8: CJ_Trip (9430 in chips) 
som1990: posts the ante 8
Kevin12345Mc: posts the ante 8
bagzarelli: posts the ante 8
Crespo230: posts the ante 8
Stephan1164: posts the ante 8
@L1N93: posts the ante 8
Ra4ok123: posts the ante 8
CJ_Trip: posts the ante 8
Ra4ok123: posts small blind 30
CJ_Trip: posts big blind 60
*** HOLE CARDS ***
Dealt to Kevin12345Mc [2c Td]
som1990: folds 
Kevin12345Mc: folds 
bagzarelli: folds 
Crespo230: folds 
Stephan1164: folds 
@L1N93: folds 
Ra4ok123: raises 150 to 210
CJ_Trip: folds 
Uncalled bet (150) returned to Ra4ok123
Ra4ok123 collected 184 from pot
Ra4ok123: doesn't show hand 
*** SUMMARY ***
Total pot 184 | Rake 0 
Seat 1: som1990 folded before Flop (didn't bet)
Seat 2: Kevin12345Mc folded before Flop (didn't bet)
Seat 3: bagzarelli folded before Flop (didn't bet)
Seat 4: Crespo230 folded before Flop (didn't bet)
Seat 5: Stephan1164 folded before Flop (didn't bet)
Seat 6: @L1N93 (button) folded before Flop (didn't bet)
Seat 7: Ra4ok123 (small blind) collected (184)
Seat 8: CJ_Trip (big blind) folded before Flop



PokerStars Hand #255212732321: Tournament #3863783058, $9.80+$1.20 USD Hold'em No Limit - Level II (30/60) - 2025/03/09 18:16:48 WET [2025/03/09 14:16:48 ET]
Table '3863783058 952' 8-max Seat #7 is the button
Seat 1: som1990 (11039 in chips) 
Seat 2: Kevin12345Mc (9453 in chips) 
Seat 3: bagzarelli (9830 in chips) 
Seat 4: Crespo230 (11710 in chips) 
Seat 5: Stephan1164 (7079 in chips) 
Seat 6: @L1N93 (9172 in chips) 
Seat 7: Ra4ok123 (9364 in chips) 
Seat 8: CJ_Trip (9362 in chips) 
som1990: posts the ante 8
Kevin12345Mc: posts the ante 8
bagzarelli: posts the ante 8
Crespo230: posts the ante 8
Stephan1164: posts the ante 8
@L1N93: posts the ante 8
Ra4ok123: posts the ante 8
CJ_Trip: posts the ante 8
CJ_Trip: posts small blind 30
som1990: posts big blind 60
*** HOLE CARDS ***
Dealt to Kevin12345Mc [4d 6c]
Kevin12345Mc: folds 
bagzarelli: folds 
Crespo230: folds 
Stephan1164: raises 60 to 120
@L1N93: calls 120
Ra4ok123: calls 120
CJ_Trip: folds 
som1990: folds 
*** FLOP *** [Ac 9s 4h]
Stephan1164: checks 
@L1N93: checks 
Ra4ok123: bets 170
Stephan1164: calls 170
@L1N93: folds 
*** TURN *** [Ac 9s 4h] [Jh]
Stephan1164: checks 
Ra4ok123: bets 510
Stephan1164: folds 
Uncalled bet (510) returned to Ra4ok123
Ra4ok123 collected 854 from pot
Ra4ok123: doesn't show hand 
*** SUMMARY ***
Total pot 854 | Rake 0 
Board [Ac 9s 4h Jh]
Seat 1: som1990 (big blind) folded before Flop
Seat 2: Kevin12345Mc folded before Flop (didn't bet)
Seat 3: bagzarelli folded before Flop (didn't bet)
Seat 4: Crespo230 folded before Flop (didn't bet)
Seat 5: Stephan1164 folded on the Turn
Seat 6: @L1N93 folded on the Flop
Seat 7: Ra4ok123 (button) collected (854)
Seat 8: CJ_Trip (small blind) folded before Flop



PokerStars Hand #255212763054: Tournament #3863783058, $9.80+$1.20 USD Hold'em No Limit - Level II (30/60) - 2025/03/09 18:18:23 WET [2025/03/09 14:18:23 ET]
Table '3863783058 952' 8-max Seat #8 is the button
Seat 1: som1990 (10971 in chips) 
Seat 2: Kevin12345Mc (9445 in chips) 
Seat 3: bagzarelli (9822 in chips) 
Seat 4: Crespo230 (11702 in chips) 
Seat 5: Stephan1164 (6781 in chips) 
Seat 6: @L1N93 (9044 in chips) 
Seat 7: Ra4ok123 (9920 in chips) 
Seat 8: CJ_Trip (9324 in chips) 
som1990: posts the ante 8
Kevin12345Mc: posts the ante 8
bagzarelli: posts the ante 8
Crespo230: posts the ante 8
Stephan1164: posts the ante 8
@L1N93: posts the ante 8
Ra4ok123: posts the ante 8
CJ_Trip: posts the ante 8
som1990: posts small blind 30
Kevin12345Mc: posts big blind 60
*** HOLE CARDS ***
Dealt to Kevin12345Mc [2h Ad]
bagzarelli: raises 60 to 120
Crespo230: folds 
Stephan1164: raises 6653 to 6773 and is all-in
@L1N93: folds 
Ra4ok123: folds 
CJ_Trip: folds 
som1990: folds 
Kevin12345Mc: folds 
bagzarelli: folds 
Uncalled bet (6653) returned to Stephan1164
Stephan1164 collected 394 from pot
Stephan1164: doesn't show hand 
*** SUMMARY ***
Total pot 394 | Rake 0 
Seat 1: som1990 (small blind) folded before Flop
Seat 2: Kevin12345Mc (big blind) folded before Flop
Seat 3: bagzarelli folded before Flop
Seat 4: Crespo230 folded before Flop (didn't bet)
Seat 5: Stephan1164 collected (394)
Seat 6: @L1N93 folded before Flop (didn't bet)
Seat 7: Ra4ok123 folded before Flop (didn't bet)
Seat 8: CJ_Trip (button) folded before Flop (didn't bet)



PokerStars Hand #255212771355: Tournament #3863783058, $9.80+$1.20 USD Hold'em No Limit - Level II (30/60) - 2025/03/09 18:18:49 WET [2025/03/09 14:18:49 ET]
Table '3863783058 952' 8-max Seat #1 is the button
Seat 1: som1990 (10933 in chips) 
Seat 2: Kevin12345Mc (9377 in chips) 
Seat 3: bagzarelli (9694 in chips) 
Seat 4: Crespo230 (11694 in chips) 
Seat 5: Stephan1164 (7047 in chips) 
Seat 6: @L1N93 (9036 in chips) 
Seat 7: Ra4ok123 (9912 in chips) 
Seat 8: CJ_Trip (9316 in chips) 
som1990: posts the ante 8
Kevin12345Mc: posts the ante 8
bagzarelli: posts the ante 8
Crespo230: posts the ante 8
Stephan1164: posts the ante 8
@L1N93: posts the ante 8
Ra4ok123: posts the ante 8
CJ_Trip: posts the ante 8
Kevin12345Mc: posts small blind 30
bagzarelli: posts big blind 60
*** HOLE CARDS ***
Dealt to Kevin12345Mc [Kh Ad]
Crespo230: raises 60 to 120
Stephan1164: calls 120
@L1N93: folds 
Ra4ok123: folds 
CJ_Trip: folds 
som1990: calls 120
Kevin12345Mc: raises 540 to 660
bagzarelli: folds 
Crespo230: calls 540
Stephan1164: calls 540
som1990: calls 540
*** FLOP *** [8c Js Td]
Kevin12345Mc: checks 
Crespo230: checks 
Stephan1164: checks 
som1990: checks 
*** TURN *** [8c Js Td] [Ac]
Kevin12345Mc: bets 1824
Crespo230: calls 1824
Stephan1164: calls 1824
som1990: folds 
*** RIVER *** [8c Js Td Ac] [Kd]
Kevin12345Mc: checks 
Crespo230: checks 
Stephan1164: bets 4555 and is all-in
Kevin12345Mc: calls 4555
Crespo230: folds [Ts As]
*** SHOW DOWN ***
Stephan1164: shows [6h Ks] (a pair of Kings)
Kevin12345Mc: shows [Kh Ad] (two pair, Aces and Kings)
Kevin12345Mc collected 17346 from pot
Stephan1164 finished the tournament
*** SUMMARY ***
Total pot 17346 | Rake 0 
Board [8c Js Td Ac Kd]
Seat 1: som1990 (button) folded on the Turn
Seat 2: Kevin12345Mc (small blind) showed [Kh Ad] and won (17346) with two pair, Aces and Kings
Seat 3: bagzarelli (big blind) folded before Flop
Seat 4: Crespo230 folded on the River
Seat 5: Stephan1164 showed [6h Ks] and lost with a pair of Kings
Seat 6: @L1N93 folded before Flop (didn't bet)
Seat 7: Ra4ok123 folded before Flop (didn't bet)
Seat 8: CJ_Trip folded before Flop (didn't bet)



PokerStars Hand #255212804951: Tournament #3863783058, $9.80+$1.20 USD Hold'em No Limit - Level III (40/80) - 2025/03/09 18:20:33 WET [2025/03/09 14:20:33 ET]
Table '3863783058 952' 8-max Seat #2 is the button
Seat 1: som1990 (10265 in chips) 
Seat 2: Kevin12345Mc (19676 in chips) 
Seat 3: bagzarelli (9626 in chips) 
Seat 4: Crespo230 (9202 in chips) 
Seat 5: Jaycop7 (10000 in chips) 
Seat 6: @L1N93 (9028 in chips) 
Seat 7: Ra4ok123 (9904 in chips) 
Seat 8: CJ_Trip (9308 in chips) 
som1990: posts the ante 10
Kevin12345Mc: posts the ante 10
bagzarelli: posts the ante 10
Crespo230: posts the ante 10
Jaycop7: posts the ante 10
@L1N93: posts the ante 10
Ra4ok123: posts the ante 10
CJ_Trip: posts the ante 10
bagzarelli: posts small blind 40
Crespo230: posts big blind 80
*** HOLE CARDS ***
Dealt to Kevin12345Mc [3s Jh]
Jaycop7: folds 
@L1N93: folds 
Ra4ok123: folds 
CJ_Trip: raises 120 to 200
som1990: calls 200
Kevin12345Mc: folds 
bagzarelli: folds 
Crespo230: folds 
*** FLOP *** [4c Tc 7s]
CJ_Trip: checks 
som1990: checks 
*** TURN *** [4c Tc 7s] [Td]
CJ_Trip: bets 396
som1990: folds 
Uncalled bet (396) returned to CJ_Trip
CJ_Trip collected 600 from pot
CJ_Trip: doesn't show hand 
*** SUMMARY ***
Total pot 600 | Rake 0 
Board [4c Tc 7s Td]
Seat 1: som1990 folded on the Turn
Seat 2: Kevin12345Mc (button) folded before Flop (didn't bet)
Seat 3: bagzarelli (small blind) folded before Flop
Seat 4: Crespo230 (big blind) folded before Flop
Seat 5: Jaycop7 folded before Flop (didn't bet)
Seat 6: @L1N93 folded before Flop (didn't bet)
Seat 7: Ra4ok123 folded before Flop (didn't bet)
Seat 8: CJ_Trip collected (600)



PokerStars Hand #255212821366: Tournament #3863783058, $9.80+$1.20 USD Hold'em No Limit - Level III (40/80) - 2025/03/09 18:21:24 WET [2025/03/09 14:21:24 ET]
Table '3863783058 952' 8-max Seat #3 is the button
Seat 1: som1990 (10055 in chips) 
Seat 2: Kevin12345Mc (19666 in chips) 
Seat 3: bagzarelli (9576 in chips) 
Seat 4: Crespo230 (9112 in chips) 
Seat 5: Jaycop7 (9990 in chips) 
Seat 6: @L1N93 (9018 in chips) 
Seat 7: Ra4ok123 (9894 in chips) 
Seat 8: CJ_Trip (9698 in chips) 
som1990: posts the ante 10
Kevin12345Mc: posts the ante 10
bagzarelli: posts the ante 10
Crespo230: posts the ante 10
Jaycop7: posts the ante 10
@L1N93: posts the ante 10
Ra4ok123: posts the ante 10
CJ_Trip: posts the ante 10
Crespo230: posts small blind 40
Jaycop7: posts big blind 80
*** HOLE CARDS ***
Dealt to Kevin12345Mc [Qc Ks]
@L1N93: folds 
Ra4ok123: folds 
CJ_Trip: folds 
som1990: raises 80 to 160
Kevin12345Mc: raises 480 to 640
bagzarelli: folds 
Crespo230: folds 
Jaycop7: folds 
som1990: calls 480
*** FLOP *** [8c 3s Ts]
som1990: checks 
Kevin12345Mc: bets 488
som1990: calls 488
*** TURN *** [8c 3s Ts] [5c]
som1990: checks 
Kevin12345Mc: checks 
*** RIVER *** [8c 3s Ts 5c] [4c]
som1990: checks 
Kevin12345Mc: checks 
*** SHOW DOWN ***
som1990: shows [Qh Th] (a pair of Tens)
Kevin12345Mc: mucks hand 
som1990 collected 2456 from pot
*** SUMMARY ***
Total pot 2456 | Rake 0 
Board [8c 3s Ts 5c 4c]
Seat 1: som1990 showed [Qh Th] and won (2456) with a pair of Tens
Seat 2: Kevin12345Mc mucked [Qc Ks]
Seat 3: bagzarelli (button) folded before Flop (didn't bet)
Seat 4: Crespo230 (small blind) folded before Flop
Seat 5: Jaycop7 (big blind) folded before Flop
Seat 6: @L1N93 folded before Flop (didn't bet)
Seat 7: Ra4ok123 folded before Flop (didn't bet)
Seat 8: CJ_Trip folded before Flop (didn't bet)



PokerStars Hand #255212839721: Tournament #3863783058, $9.80+$1.20 USD Hold'em No Limit - Level III (40/80) - 2025/03/09 18:22:21 WET [2025/03/09 14:22:21 ET]
Table '3863783058 952' 8-max Seat #4 is the button
Seat 1: som1990 (11373 in chips) 
Seat 2: Kevin12345Mc (18528 in chips) 
Seat 3: bagzarelli (9566 in chips) 
Seat 4: Crespo230 (9062 in chips) 
Seat 5: Jaycop7 (9900 in chips) 
Seat 6: @L1N93 (9008 in chips) 
Seat 7: Ra4ok123 (9884 in chips) 
Seat 8: CJ_Trip (9688 in chips) 
som1990: posts the ante 10
Kevin12345Mc: posts the ante 10
bagzarelli: posts the ante 10
Crespo230: posts the ante 10
Jaycop7: posts the ante 10
@L1N93: posts the ante 10
Ra4ok123: posts the ante 10
CJ_Trip: posts the ante 10
Jaycop7: posts small blind 40
@L1N93: posts big blind 80
*** HOLE CARDS ***
Dealt to Kevin12345Mc [8d Th]
Ra4ok123: folds 
CJ_Trip: folds 
som1990: folds 
Kevin12345Mc: folds 
bagzarelli: folds 
Crespo230: raises 80 to 160
Jaycop7: calls 120
@L1N93: raises 840 to 1000
Crespo230: folds 
Jaycop7: folds 
Uncalled bet (840) returned to @L1N93
@L1N93 collected 560 from pot
@L1N93: doesn't show hand 
*** SUMMARY ***
Total pot 560 | Rake 0 
Seat 1: som1990 folded before Flop (didn't bet)
Seat 2: Kevin12345Mc folded before Flop (didn't bet)
Seat 3: bagzarelli folded before Flop (didn't bet)
Seat 4: Crespo230 (button) folded before Flop
Seat 5: Jaycop7 (small blind) folded before Flop
Seat 6: @L1N93 (big blind) collected (560)
Seat 7: Ra4ok123 folded before Flop (didn't bet)
Seat 8: CJ_Trip folded before Flop (didn't bet)



PokerStars Hand #255212851266: Tournament #3863783058, $9.80+$1.20 USD Hold'em No Limit - Level III (40/80) - 2025/03/09 18:22:57 WET [2025/03/09 14:22:57 ET]
Table '3863783058 952' 8-max Seat #5 is the button
Seat 1: som1990 (11363 in chips) 
Seat 2: Kevin12345Mc (18518 in chips) 
Seat 3: bagzarelli (9556 in chips) 
Seat 4: Crespo230 (8892 in chips) 
Seat 5: Jaycop7 (9730 in chips) 
Seat 6: @L1N93 (9398 in chips) 
Seat 7: Ra4ok123 (9874 in chips) 
Seat 8: CJ_Trip (9678 in chips) 
som1990: posts the ante 10
Kevin12345Mc: posts the ante 10
bagzarelli: posts the ante 10
Crespo230: posts the ante 10
Jaycop7: posts the ante 10
@L1N93: posts the ante 10
Ra4ok123: posts the ante 10
CJ_Trip: posts the ante 10
@L1N93: posts small blind 40
Ra4ok123: posts big blind 80
*** HOLE CARDS ***
Dealt to Kevin12345Mc [9h 9d]
CJ_Trip: raises 120 to 200
som1990: folds 
Kevin12345Mc: calls 200
bagzarelli: folds 
Crespo230: calls 200
Jaycop7: folds 
@L1N93: calls 160
Ra4ok123: folds 
*** FLOP *** [4d 7s 2d]
@L1N93: checks 
CJ_Trip: bets 640
Kevin12345Mc: calls 640
Crespo230: calls 640
@L1N93: folds 
*** TURN *** [4d 7s 2d] [6c]
CJ_Trip: bets 2160
Kevin12345Mc: calls 2160
Crespo230: raises 5882 to 8042 and is all-in
CJ_Trip: raises 786 to 8828 and is all-in
Kevin12345Mc: folds 
Uncalled bet (786) returned to CJ_Trip
*** RIVER *** [4d 7s 2d 6c] [6d]
*** SHOW DOWN ***
CJ_Trip: shows [8h 8c] (two pair, Eights and Sixes)
Crespo230: shows [4s 4c] (a full house, Fours full of Sixes)
Crespo230 collected 21124 from pot
*** SUMMARY ***
Total pot 21124 | Rake 0 
Board [4d 7s 2d 6c 6d]
Seat 1: som1990 folded before Flop (didn't bet)
Seat 2: Kevin12345Mc folded on the Turn
Seat 3: bagzarelli folded before Flop (didn't bet)
Seat 4: Crespo230 showed [4s 4c] and won (21124) with a full house, Fours full of Sixes
Seat 5: Jaycop7 (button) folded before Flop (didn't bet)
Seat 6: @L1N93 (small blind) folded on the Flop
Seat 7: Ra4ok123 (big blind) folded before Flop
Seat 8: CJ_Trip showed [8h 8c] and lost with two pair, Eights and Sixes



PokerStars Hand #255212885987: Tournament #3863783058, $9.80+$1.20 USD Hold'em No Limit - Level III (40/80) - 2025/03/09 18:24:47 WET [2025/03/09 14:24:47 ET]
Table '3863783058 952' 8-max Seat #6 is the button
Seat 1: som1990 (11353 in chips) 
Seat 2: Kevin12345Mc (15508 in chips) 
Seat 3: bagzarelli (9546 in chips) 
Seat 4: Crespo230 (21124 in chips) 
Seat 5: Jaycop7 (9720 in chips) 
Seat 6: @L1N93 (9188 in chips) 
Seat 7: Ra4ok123 (9784 in chips) 
Seat 8: CJ_Trip (786 in chips) 
som1990: posts the ante 10
Kevin12345Mc: posts the ante 10
bagzarelli: posts the ante 10
Crespo230: posts the ante 10
Jaycop7: posts the ante 10
@L1N93: posts the ante 10
Ra4ok123: posts the ante 10
CJ_Trip: posts the ante 10
Ra4ok123: posts small blind 40
CJ_Trip: posts big blind 80
*** HOLE CARDS ***
Dealt to Kevin12345Mc [2h 5h]
som1990: folds 
Kevin12345Mc: folds 
bagzarelli: folds 
Crespo230: raises 80 to 160
Jaycop7: folds 
@L1N93: folds 
Ra4ok123: folds 
CJ_Trip: raises 440 to 600
Crespo230: raises 440 to 1040
CJ_Trip: calls 176 and is all-in
Uncalled bet (264) returned to Crespo230
*** FLOP *** [9d Jd 5d]
*** TURN *** [9d Jd 5d] [3c]
*** RIVER *** [9d Jd 5d 3c] [7d]
*** SHOW DOWN ***
CJ_Trip: shows [3h Kd] (a flush, King high)
Crespo230: shows [Th Tc] (a pair of Tens)
CJ_Trip collected 1672 from pot
*** SUMMARY ***
Total pot 1672 | Rake 0 
Board [9d Jd 5d 3c 7d]
Seat 1: som1990 folded before Flop (didn't bet)
Seat 2: Kevin12345Mc folded before Flop (didn't bet)
Seat 3: bagzarelli folded before Flop (didn't bet)
Seat 4: Crespo230 showed [Th Tc] and lost with a pair of Tens
Seat 5: Jaycop7 folded before Flop (didn't bet)
Seat 6: @L1N93 (button) folded before Flop (didn't bet)
Seat 7: Ra4ok123 (small blind) folded before Flop
Seat 8: CJ_Trip (big blind) showed [3h Kd] and won (1672) with a flush, King high



PokerStars Hand #255212895808: Tournament #3863783058, $9.80+$1.20 USD Hold'em No Limit - Level III (40/80) - 2025/03/09 18:25:17 WET [2025/03/09 14:25:17 ET]
Table '3863783058 952' 8-max Seat #7 is the button
Seat 1: som1990 (11343 in chips) 
Seat 2: Kevin12345Mc (15498 in chips) 
Seat 3: bagzarelli (9536 in chips) 
Seat 4: Crespo230 (20338 in chips) 
Seat 5: Jaycop7 (9710 in chips) 
Seat 6: @L1N93 (9178 in chips) 
Seat 7: Ra4ok123 (9734 in chips) 
Seat 8: CJ_Trip (1672 in chips) 
som1990: posts the ante 10
Kevin12345Mc: posts the ante 10
bagzarelli: posts the ante 10
Crespo230: posts the ante 10
Jaycop7: posts the ante 10
@L1N93: posts the ante 10
Ra4ok123: posts the ante 10
CJ_Trip: posts the ante 10
CJ_Trip: posts small blind 40
som1990: posts big blind 80
*** HOLE CARDS ***
Dealt to Kevin12345Mc [Jc Jd]
Kevin12345Mc: raises 120 to 200
bagzarelli: folds 
Crespo230: folds 
Jaycop7: calls 200
@L1N93: folds 
Ra4ok123: folds 
CJ_Trip: folds 
som1990: calls 120
*** FLOP *** [2s Tc Th]
som1990: checks 
Kevin12345Mc: bets 475
Jaycop7: calls 475
som1990: folds 
*** TURN *** [2s Tc Th] [Js]
Kevin12345Mc: bets 1262
Jaycop7: raises 1262 to 2524
Kevin12345Mc: raises 12289 to 14813 and is all-in
Jaycop7: calls 6501 and is all-in
Uncalled bet (5788) returned to Kevin12345Mc
*** RIVER *** [2s Tc Th Js] [6c]
*** SHOW DOWN ***
Kevin12345Mc: shows [Jc Jd] (a full house, Jacks full of Tens)
Jaycop7: shows [2c 2h] (a full house, Deuces full of Tens)
Kevin12345Mc collected 19720 from pot
Jaycop7 finished the tournament
*** SUMMARY ***
Total pot 19720 | Rake 0 
Board [2s Tc Th Js 6c]
Seat 1: som1990 (big blind) folded on the Flop
Seat 2: Kevin12345Mc showed [Jc Jd] and won (19720) with a full house, Jacks full of Tens
Seat 3: bagzarelli folded before Flop (didn't bet)
Seat 4: Crespo230 folded before Flop (didn't bet)
Seat 5: Jaycop7 showed [2c 2h] and lost with a full house, Deuces full of Tens
Seat 6: @L1N93 folded before Flop (didn't bet)
Seat 7: Ra4ok123 (button) folded before Flop (didn't bet)
Seat 8: CJ_Trip (small blind) folded before Flop



PokerStars Hand #255212916157: Tournament #3863783058, $9.80+$1.20 USD Hold'em No Limit - Level III (40/80) - 2025/03/09 18:26:21 WET [2025/03/09 14:26:21 ET]
Table '3863783058 952' 8-max Seat #8 is the button
Seat 1: som1990 (11133 in chips) 
Seat 2: Kevin12345Mc (25508 in chips) 
Seat 3: bagzarelli (9526 in chips) 
Seat 4: Crespo230 (20328 in chips) 
Seat 5: harrispkr (10000 in chips) 
Seat 6: @L1N93 (9168 in chips) 
Seat 7: Ra4ok123 (9724 in chips) 
Seat 8: CJ_Trip (1622 in chips) 
som1990: posts the ante 10
Kevin12345Mc: posts the ante 10
bagzarelli: posts the ante 10
Crespo230: posts the ante 10
harrispkr: posts the ante 10
@L1N93: posts the ante 10
Ra4ok123: posts the ante 10
CJ_Trip: posts the ante 10
som1990: posts small blind 40
Kevin12345Mc: posts big blind 80
*** HOLE CARDS ***
Dealt to Kevin12345Mc [7h Th]
bagzarelli: folds 
Crespo230: raises 80 to 160
harrispkr is disconnected 
harrispkr is connected 
harrispkr: folds 
@L1N93: folds 
Ra4ok123: folds 
CJ_Trip: calls 160
som1990: folds 
Kevin12345Mc: calls 80
*** FLOP *** [Jd 6s 4d]
Kevin12345Mc: checks 
Crespo230: checks 
CJ_Trip: checks 
*** TURN *** [Jd 6s 4d] [8d]
Kevin12345Mc: checks 
Crespo230: checks 
CJ_Trip: checks 
*** RIVER *** [Jd 6s 4d 8d] [5s]
Kevin12345Mc: checks 
Crespo230: bets 198
CJ_Trip: folds 
Kevin12345Mc: folds 
Uncalled bet (198) returned to Crespo230
Crespo230 collected 600 from pot
Crespo230: doesn't show hand 
*** SUMMARY ***
Total pot 600 | Rake 0 
Board [Jd 6s 4d 8d 5s]
Seat 1: som1990 (small blind) folded before Flop
Seat 2: Kevin12345Mc (big blind) folded on the River
Seat 3: bagzarelli folded before Flop (didn't bet)
Seat 4: Crespo230 collected (600)
Seat 5: harrispkr folded before Flop (didn't bet)
Seat 6: @L1N93 folded before Flop (didn't bet)
Seat 7: Ra4ok123 folded before Flop (didn't bet)
Seat 8: CJ_Trip (button) folded on the River



PokerStars Hand #255212931639: Tournament #3863783058, $9.80+$1.20 USD Hold'em No Limit - Level III (40/80) - 2025/03/09 18:27:09 WET [2025/03/09 14:27:09 ET]
Table '3863783058 952' 8-max Seat #1 is the button
Seat 1: som1990 (11083 in chips) 
Seat 2: Kevin12345Mc (25338 in chips) 
Seat 3: bagzarelli (9516 in chips) 
Seat 4: Crespo230 (20758 in chips) 
Seat 5: harrispkr (9990 in chips) 
Seat 6: @L1N93 (9158 in chips) 
Seat 7: Ra4ok123 (9714 in chips) 
Seat 8: CJ_Trip (1452 in chips) 
som1990: posts the ante 10
Kevin12345Mc: posts the ante 10
bagzarelli: posts the ante 10
Crespo230: posts the ante 10
harrispkr: posts the ante 10
@L1N93: posts the ante 10
Ra4ok123: posts the ante 10
CJ_Trip: posts the ante 10
Kevin12345Mc: posts small blind 40
bagzarelli: posts big blind 80
*** HOLE CARDS ***
Dealt to Kevin12345Mc [8d 5c]
Crespo230: folds 
harrispkr: folds 
@L1N93: folds 
Ra4ok123: raises 80 to 160
CJ_Trip: folds 
som1990: calls 160
Kevin12345Mc: folds 
bagzarelli: calls 80
*** FLOP *** [Qc 2d 9c]
bagzarelli: checks 
Ra4ok123: bets 198
som1990: folds 
bagzarelli: calls 198
*** TURN *** [Qc 2d 9c] [6h]
bagzarelli: checks 
Ra4ok123: bets 720
bagzarelli: calls 720
*** RIVER *** [Qc 2d 9c 6h] [8c]
bagzarelli: checks 
Ra4ok123: bets 1960
bagzarelli: calls 1960
*** SHOW DOWN ***
Ra4ok123: shows [Tc 7c] (a flush, Queen high)
bagzarelli: mucks hand 
Ra4ok123 collected 6356 from pot
*** SUMMARY ***
Total pot 6356 | Rake 0 
Board [Qc 2d 9c 6h 8c]
Seat 1: som1990 (button) folded on the Flop
Seat 2: Kevin12345Mc (small blind) folded before Flop
Seat 3: bagzarelli (big blind) mucked [Qh Ks]
Seat 4: Crespo230 folded before Flop (didn't bet)
Seat 5: harrispkr folded before Flop (didn't bet)
Seat 6: @L1N93 folded before Flop (didn't bet)
Seat 7: Ra4ok123 showed [Tc 7c] and won (6356) with a flush, Queen high
Seat 8: CJ_Trip folded before Flop (didn't bet)



PokerStars Hand #255212962396: Tournament #3863783058, $9.80+$1.20 USD Hold'em No Limit - Level III (40/80) - 2025/03/09 18:28:45 WET [2025/03/09 14:28:45 ET]
Table '3863783058 952' 8-max Seat #2 is the button
Seat 1: som1990 (10913 in chips) 
Seat 2: Kevin12345Mc (25288 in chips) 
Seat 3: bagzarelli (6468 in chips) 
Seat 4: Crespo230 (20748 in chips) 
Seat 5: harrispkr (9980 in chips) 
Seat 6: @L1N93 (9148 in chips) 
Seat 7: Ra4ok123 (13022 in chips) 
Seat 8: CJ_Trip (1442 in chips) 
som1990: posts the ante 10
Kevin12345Mc: posts the ante 10
bagzarelli: posts the ante 10
Crespo230: posts the ante 10
harrispkr: posts the ante 10
@L1N93: posts the ante 10
Ra4ok123: posts the ante 10
CJ_Trip: posts the ante 10
bagzarelli: posts small blind 40
Crespo230: posts big blind 80
*** HOLE CARDS ***
Dealt to Kevin12345Mc [Qh 5d]
harrispkr: folds 
@L1N93: folds 
Ra4ok123: folds 
CJ_Trip: raises 1352 to 1432 and is all-in
som1990: folds 
Kevin12345Mc: folds 
bagzarelli: raises 5026 to 6458 and is all-in
Crespo230: folds 
Uncalled bet (5026) returned to bagzarelli
*** FLOP *** [7d 2s Td]
*** TURN *** [7d 2s Td] [Tc]
*** RIVER *** [7d 2s Td Tc] [4d]
*** SHOW DOWN ***
bagzarelli: shows [7c 7s] (a full house, Sevens full of Tens)
CJ_Trip: shows [8h Jh] (a pair of Tens)
bagzarelli collected 3024 from pot
CJ_Trip finished the tournament
*** SUMMARY ***
Total pot 3024 | Rake 0 
Board [7d 2s Td Tc 4d]
Seat 1: som1990 folded before Flop (didn't bet)
Seat 2: Kevin12345Mc (button) folded before Flop (didn't bet)
Seat 3: bagzarelli (small blind) showed [7c 7s] and won (3024) with a full house, Sevens full of Tens
Seat 4: Crespo230 (big blind) folded before Flop
Seat 5: harrispkr folded before Flop (didn't bet)
Seat 6: @L1N93 folded before Flop (didn't bet)
Seat 7: Ra4ok123 folded before Flop (didn't bet)
Seat 8: CJ_Trip showed [8h Jh] and lost with a pair of Tens



PokerStars Hand #255212976924: Tournament #3863783058, $9.80+$1.20 USD Hold'em No Limit - Level III (40/80) - 2025/03/09 18:29:32 WET [2025/03/09 14:29:32 ET]
Table '3863783058 952' 8-max Seat #3 is the button
Seat 1: som1990 (10903 in chips) 
Seat 2: Kevin12345Mc (25278 in chips) 
Seat 3: bagzarelli (8050 in chips) 
Seat 4: Crespo230 (20658 in chips) 
Seat 5: harrispkr (9970 in chips) 
Seat 6: @L1N93 (9138 in chips) 
Seat 7: Ra4ok123 (13012 in chips) 
som1990: posts the ante 10
Kevin12345Mc: posts the ante 10
bagzarelli: posts the ante 10
Crespo230: posts the ante 10
harrispkr: posts the ante 10
@L1N93: posts the ante 10
Ra4ok123: posts the ante 10
Crespo230: posts small blind 40
harrispkr: posts big blind 80
*** HOLE CARDS ***
Dealt to Kevin12345Mc [2c Td]
journitemer is disconnected 
@L1N93: folds 
Ra4ok123: folds 
som1990: folds 
Kevin12345Mc: folds 
bagzarelli: raises 200 to 280
Crespo230: folds 
harrispkr: calls 200
*** FLOP *** [5c 3c Tc]
harrispkr: checks 
bagzarelli: bets 400
harrispkr: calls 400
*** TURN *** [5c 3c Tc] [Kd]
harrispkr: checks 
bagzarelli: bets 800
harrispkr: calls 800
*** RIVER *** [5c 3c Tc Kd] [9c]
harrispkr: checks 
bagzarelli: checks 
*** SHOW DOWN ***
harrispkr: shows [Qc Js] (a flush, Queen high)
bagzarelli: mucks hand 
harrispkr collected 3070 from pot
*** SUMMARY ***
Total pot 3070 | Rake 0 
Board [5c 3c Tc Kd 9c]
Seat 1: som1990 folded before Flop (didn't bet)
Seat 2: Kevin12345Mc folded before Flop (didn't bet)
Seat 3: bagzarelli (button) mucked [8d 8s]
Seat 4: Crespo230 (small blind) folded before Flop
Seat 5: harrispkr (big blind) showed [Qc Js] and won (3070) with a flush, Queen high
Seat 6: @L1N93 folded before Flop (didn't bet)
Seat 7: Ra4ok123 folded before Flop (didn't bet)



PokerStars Hand #255213016623: Tournament #3863783058, $9.80+$1.20 USD Hold'em No Limit - Level IV (50/100) - 2025/03/09 18:31:33 WET [2025/03/09 14:31:33 ET]
Table '3863783058 952' 8-max Seat #4 is the button
Seat 1: som1990 (10893 in chips) 
Seat 2: Kevin12345Mc (25268 in chips) 
Seat 3: bagzarelli (6560 in chips) 
Seat 4: Crespo230 (20608 in chips) 
Seat 5: harrispkr (11550 in chips) 
Seat 6: @L1N93 (9128 in chips) 
Seat 7: Ra4ok123 (13002 in chips) 
Seat 8: journitemer (10000 in chips) 
som1990: posts the ante 12
Kevin12345Mc: posts the ante 12
bagzarelli: posts the ante 12
Crespo230: posts the ante 12
harrispkr: posts the ante 12
@L1N93: posts the ante 12
Ra4ok123: posts the ante 12
journitemer: posts the ante 12
harrispkr: posts small blind 50
@L1N93: posts big blind 100
*** HOLE CARDS ***
Dealt to Kevin12345Mc [5c 9d]
Ra4ok123: folds 
journitemer: raises 150 to 250
som1990: folds 
Kevin12345Mc: folds 
bagzarelli: calls 250
Crespo230: raises 650 to 900
harrispkr: folds 
@L1N93: folds 
journitemer: folds 
bagzarelli: calls 650
*** FLOP *** [8s Ah 8c]
bagzarelli: checks 
Crespo230: bets 505
bagzarelli: folds 
Uncalled bet (505) returned to Crespo230
Crespo230 collected 2296 from pot
Crespo230: doesn't show hand 
*** SUMMARY ***
Total pot 2296 | Rake 0 
Board [8s Ah 8c]
Seat 1: som1990 folded before Flop (didn't bet)
Seat 2: Kevin12345Mc folded before Flop (didn't bet)
Seat 3: bagzarelli folded on the Flop
Seat 4: Crespo230 (button) collected (2296)
Seat 5: harrispkr (small blind) folded before Flop
Seat 6: @L1N93 (big blind) folded before Flop
Seat 7: Ra4ok123 folded before Flop (didn't bet)
Seat 8: journitemer folded before Flop



PokerStars Hand #255213032703: Tournament #3863783058, $9.80+$1.20 USD Hold'em No Limit - Level IV (50/100) - 2025/03/09 18:32:22 WET [2025/03/09 14:32:22 ET]
Table '3863783058 952' 8-max Seat #5 is the button
Seat 1: som1990 (10881 in chips) 
Seat 2: Kevin12345Mc (25256 in chips) 
Seat 3: bagzarelli (5648 in chips) 
Seat 4: Crespo230 (21992 in chips) 
Seat 5: harrispkr (11488 in chips) 
Seat 6: @L1N93 (9016 in chips) 
Seat 7: Ra4ok123 (12990 in chips) 
Seat 8: journitemer (9738 in chips) 
som1990: posts the ante 12
Kevin12345Mc: posts the ante 12
bagzarelli: posts the ante 12
Crespo230: posts the ante 12
harrispkr: posts the ante 12
@L1N93: posts the ante 12
Ra4ok123: posts the ante 12
journitemer: posts the ante 12
@L1N93: posts small blind 50
Ra4ok123: posts big blind 100
*** HOLE CARDS ***
Dealt to Kevin12345Mc [4d 3c]
journitemer: folds 
som1990: folds 
Kevin12345Mc: folds 
bagzarelli: raises 200 to 300
Crespo230: folds 
harrispkr: raises 600 to 900
@L1N93: folds 
Ra4ok123: folds 
bagzarelli: raises 4736 to 5636 and is all-in
harrispkr: calls 4736
*** FLOP *** [Qc Ts Kh]
*** TURN *** [Qc Ts Kh] [4s]
*** RIVER *** [Qc Ts Kh 4s] [9d]
*** SHOW DOWN ***
bagzarelli: shows [Qh Ac] (a pair of Queens)
harrispkr: shows [Ad Ah] (a pair of Aces)
harrispkr collected 11518 from pot
bagzarelli finished the tournament
*** SUMMARY ***
Total pot 11518 | Rake 0 
Board [Qc Ts Kh 4s 9d]
Seat 1: som1990 folded before Flop (didn't bet)
Seat 2: Kevin12345Mc folded before Flop (didn't bet)
Seat 3: bagzarelli showed [Qh Ac] and lost with a pair of Queens
Seat 4: Crespo230 folded before Flop (didn't bet)
Seat 5: harrispkr (button) showed [Ad Ah] and won (11518) with a pair of Aces
Seat 6: @L1N93 (small blind) folded before Flop
Seat 7: Ra4ok123 (big blind) folded before Flop
Seat 8: journitemer folded before Flop (didn't bet)



PokerStars Hand #255213055233: Tournament #3863783058, $9.80+$1.20 USD Hold'em No Limit - Level IV (50/100) - 2025/03/09 18:33:31 WET [2025/03/09 14:33:31 ET]
Table '3863783058 952' 8-max Seat #6 is the button
Seat 1: som1990 (10869 in chips) 
Seat 2: Kevin12345Mc (25244 in chips) 
Seat 4: Crespo230 (21980 in chips) 
Seat 5: harrispkr (17358 in chips) 
Seat 6: @L1N93 (8954 in chips) 
Seat 7: Ra4ok123 (12878 in chips) 
Seat 8: journitemer (9726 in chips) 
som1990: posts the ante 12
Kevin12345Mc: posts the ante 12
Crespo230: posts the ante 12
harrispkr: posts the ante 12
@L1N93: posts the ante 12
Ra4ok123: posts the ante 12
journitemer: posts the ante 12
Ra4ok123: posts small blind 50
journitemer: posts big blind 100
*** HOLE CARDS ***
Dealt to Kevin12345Mc [3c 6c]
som1990: folds 
Kevin12345Mc: folds 
Crespo230: raises 100 to 200
harrispkr: folds 
janariellistars is disconnected 
@L1N93: folds 
Ra4ok123: folds 
journitemer: folds 
Uncalled bet (100) returned to Crespo230
Crespo230 collected 334 from pot
*** SUMMARY ***
Total pot 334 | Rake 0 
Seat 1: som1990 folded before Flop (didn't bet)
Seat 2: Kevin12345Mc folded before Flop (didn't bet)
Seat 4: Crespo230 collected (334)
Seat 5: harrispkr folded before Flop (didn't bet)
Seat 6: @L1N93 (button) folded before Flop (didn't bet)
Seat 7: Ra4ok123 (small blind) folded before Flop
Seat 8: journitemer (big blind) folded before Flop



PokerStars Hand #255213081100: Tournament #3863783058, $9.80+$1.20 USD Hold'em No Limit - Level IV (50/100) - 2025/03/09 18:34:49 WET [2025/03/09 14:34:49 ET]
Table '3863783058 225' 8-max Seat #2 is the button
Seat 1: MrPufies (19425 in chips) 
Seat 2: Marcelothefirst (9284 in chips) 
Seat 3: Fakerfg (3521 in chips) 
Seat 4: LordAzils002 (12038 in chips) 
Seat 5: Kevin12345Mc (25232 in chips) 
Seat 6: kloun7 (9332 in chips) 
Seat 7: D0MAGE (10000 in chips) 
Seat 8: KungPowNuts (9988 in chips) 
MrPufies: posts the ante 12
Marcelothefirst: posts the ante 12
Fakerfg: posts the ante 12
LordAzils002: posts the ante 12
Kevin12345Mc: posts the ante 12
kloun7: posts the ante 12
D0MAGE: posts the ante 12
KungPowNuts: posts the ante 12
Fakerfg: posts small blind 50
LordAzils002: posts big blind 100
*** HOLE CARDS ***
Dealt to Kevin12345Mc [2d Kd]
Kevin12345Mc: folds 
kloun7: folds 
D0MAGE: folds 
KungPowNuts: raises 100 to 200
MrPufies: calls 200
Marcelothefirst: folds 
Fakerfg: folds 
LordAzils002: calls 100
*** FLOP *** [4d 3h 6h]
LordAzils002: bets 492
KungPowNuts: folds 
MrPufies: calls 492
*** TURN *** [4d 3h 6h] [3d]
LordAzils002: bets 1242
MrPufies: calls 1242
*** RIVER *** [4d 3h 6h 3d] [Th]
LordAzils002: checks 
MrPufies: bets 3118
LordAzils002: folds 
Uncalled bet (3118) returned to MrPufies
MrPufies collected 4214 from pot
MrPufies: doesn't show hand 
*** SUMMARY ***
Total pot 4214 | Rake 0 
Board [4d 3h 6h 3d Th]
Seat 1: MrPufies collected (4214)
Seat 2: Marcelothefirst (button) folded before Flop (didn't bet)
Seat 3: Fakerfg (small blind) folded before Flop
Seat 4: LordAzils002 (big blind) folded on the River
Seat 5: Kevin12345Mc folded before Flop (didn't bet)
Seat 6: kloun7 folded before Flop (didn't bet)
Seat 7: D0MAGE folded before Flop (didn't bet)
Seat 8: KungPowNuts folded on the Flop



PokerStars Hand #255213112891: Tournament #3863783058, $9.80+$1.20 USD Hold'em No Limit - Level IV (50/100) - 2025/03/09 18:36:25 WET [2025/03/09 14:36:25 ET]
Table '3863783058 225' 8-max Seat #3 is the button
Seat 1: MrPufies (21693 in chips) 
Seat 2: Marcelothefirst (9272 in chips) 
Seat 3: Fakerfg (3459 in chips) 
Seat 4: LordAzils002 (10092 in chips) 
Seat 5: Kevin12345Mc (25220 in chips) 
Seat 6: kloun7 (9320 in chips) 
Seat 7: D0MAGE (9988 in chips) 
Seat 8: KungPowNuts (9776 in chips) 
MrPufies: posts the ante 12
Marcelothefirst: posts the ante 12
Fakerfg: posts the ante 12
LordAzils002: posts the ante 12
Kevin12345Mc: posts the ante 12
kloun7: posts the ante 12
D0MAGE: posts the ante 12
KungPowNuts: posts the ante 12
LordAzils002: posts small blind 50
Kevin12345Mc: posts big blind 100
*** HOLE CARDS ***
Dealt to Kevin12345Mc [Ts 9h]
kloun7: raises 200 to 300
Marcelothefirst is disconnected 
D0MAGE: folds 
KungPowNuts: folds 
Marcelothefirst is disconnected 
MrPufies: folds 
Marcelothefirst: folds 
Fakerfg: calls 300
LordAzils002: folds 
Kevin12345Mc: calls 200
*** FLOP *** [Jc 4h Jh]
Kevin12345Mc: checks 
kloun7: checks 
Fakerfg: checks 
*** TURN *** [Jc 4h Jh] [8h]
Kevin12345Mc: checks 
kloun7: checks 
Fakerfg: checks 
*** RIVER *** [Jc 4h Jh 8h] [7c]
Kevin12345Mc: bets 345
kloun7: calls 345
Fakerfg: folds 
*** SHOW DOWN ***
Kevin12345Mc: shows [Ts 9h] (a straight, Seven to Jack)
kloun7: mucks hand 
Kevin12345Mc collected 1736 from pot
*** SUMMARY ***
Total pot 1736 | Rake 0 
Board [Jc 4h Jh 8h 7c]
Seat 1: MrPufies folded before Flop (didn't bet)
Seat 2: Marcelothefirst folded before Flop (didn't bet)
Seat 3: Fakerfg (button) folded on the River
Seat 4: LordAzils002 (small blind) folded before Flop
Seat 5: Kevin12345Mc (big blind) showed [Ts 9h] and won (1736) with a straight, Seven to Jack
Seat 6: kloun7 mucked [Js Ac]
Seat 7: D0MAGE folded before Flop (didn't bet)
Seat 8: KungPowNuts folded before Flop (didn't bet)



PokerStars Hand #255213138618: Tournament #3863783058, $9.80+$1.20 USD Hold'em No Limit - Level IV (50/100) - 2025/03/09 18:37:43 WET [2025/03/09 14:37:43 ET]
Table '3863783058 225' 8-max Seat #4 is the button
Seat 1: MrPufies (21681 in chips) 
Seat 2: Marcelothefirst (9260 in chips) 
Seat 3: Fakerfg (3147 in chips) 
Seat 4: LordAzils002 (10030 in chips) 
Seat 5: Kevin12345Mc (26299 in chips) 
Seat 6: kloun7 (8663 in chips) 
Seat 7: D0MAGE (9976 in chips) 
Seat 8: KungPowNuts (9764 in chips) 
MrPufies: posts the ante 12
Marcelothefirst: posts the ante 12
Fakerfg: posts the ante 12
LordAzils002: posts the ante 12
Kevin12345Mc: posts the ante 12
kloun7: posts the ante 12
D0MAGE: posts the ante 12
KungPowNuts: posts the ante 12
Kevin12345Mc: posts small blind 50
kloun7: posts big blind 100
*** HOLE CARDS ***
Dealt to Kevin12345Mc [5d Js]
D0MAGE: folds 
KungPowNuts: folds 
MrPufies: raises 100 to 200
Marcelothefirst: folds 
Fakerfg: folds 
LordAzils002: folds 
Kevin12345Mc: folds 
kloun7: folds 
Uncalled bet (100) returned to MrPufies
MrPufies collected 346 from pot
MrPufies: doesn't show hand 
*** SUMMARY ***
Total pot 346 | Rake 0 
Seat 1: MrPufies collected (346)
Seat 2: Marcelothefirst folded before Flop (didn't bet)
Seat 3: Fakerfg folded before Flop (didn't bet)
Seat 4: LordAzils002 (button) folded before Flop (didn't bet)
Seat 5: Kevin12345Mc (small blind) folded before Flop
Seat 6: kloun7 (big blind) folded before Flop
Seat 7: D0MAGE folded before Flop (didn't bet)
Seat 8: KungPowNuts folded before Flop (didn't bet)



PokerStars Hand #255213149942: Tournament #3863783058, $9.80+$1.20 USD Hold'em No Limit - Level IV (50/100) - 2025/03/09 18:38:17 WET [2025/03/09 14:38:17 ET]
Table '3863783058 225' 8-max Seat #5 is the button
Seat 1: MrPufies (21915 in chips) 
Seat 2: Marcelothefirst (9248 in chips) 
Seat 3: Fakerfg (3135 in chips) 
Seat 4: LordAzils002 (10018 in chips) 
Seat 5: Kevin12345Mc (26237 in chips) 
Seat 6: kloun7 (8551 in chips) 
Seat 7: D0MAGE (9964 in chips) 
Seat 8: KungPowNuts (9752 in chips) 
MrPufies: posts the ante 12
Marcelothefirst: posts the ante 12
Fakerfg: posts the ante 12
LordAzils002: posts the ante 12
Kevin12345Mc: posts the ante 12
kloun7: posts the ante 12
D0MAGE: posts the ante 12
KungPowNuts: posts the ante 12
kloun7: posts small blind 50
D0MAGE: posts big blind 100
*** HOLE CARDS ***
Dealt to Kevin12345Mc [8c 5d]
KungPowNuts: folds 
MrPufies: raises 100 to 200
Marcelothefirst: calls 200
Fakerfg: calls 200
LordAzils002: raises 950 to 1150
Kevin12345Mc: folds 
kloun7: folds 
D0MAGE: folds 
MrPufies: folds 
Marcelothefirst: folds 
Fakerfg: calls 950
*** FLOP *** [4h Qd 2c]
Fakerfg: checks 
LordAzils002: bets 2044
Fakerfg: calls 1973 and is all-in
Uncalled bet (71) returned to LordAzils002
*** TURN *** [4h Qd 2c] [6s]
*** RIVER *** [4h Qd 2c 6s] [7c]
*** SHOW DOWN ***
Fakerfg: shows [2h 2d] (three of a kind, Deuces)
LordAzils002: shows [As 4s] (a pair of Fours)
Fakerfg collected 6892 from pot
*** SUMMARY ***
Total pot 6892 | Rake 0 
Board [4h Qd 2c 6s 7c]
Seat 1: MrPufies folded before Flop
Seat 2: Marcelothefirst folded before Flop
Seat 3: Fakerfg showed [2h 2d] and won (6892) with three of a kind, Deuces
Seat 4: LordAzils002 showed [As 4s] and lost with a pair of Fours
Seat 5: Kevin12345Mc (button) folded before Flop (didn't bet)
Seat 6: kloun7 (small blind) folded before Flop
Seat 7: D0MAGE (big blind) folded before Flop
Seat 8: KungPowNuts folded before Flop (didn't bet)



PokerStars Hand #255213167421: Tournament #3863783058, $9.80+$1.20 USD Hold'em No Limit - Level IV (50/100) - 2025/03/09 18:39:09 WET [2025/03/09 14:39:09 ET]
Table '3863783058 225' 8-max Seat #6 is the button
Seat 1: MrPufies (21703 in chips) 
Seat 2: Marcelothefirst (9036 in chips) 
Seat 3: Fakerfg (6892 in chips) 
Seat 4: LordAzils002 (6883 in chips) 
Seat 5: Kevin12345Mc (26225 in chips) 
Seat 6: kloun7 (8489 in chips) 
Seat 7: D0MAGE (9852 in chips) 
Seat 8: KungPowNuts (9740 in chips) 
MrPufies: posts the ante 12
Marcelothefirst: posts the ante 12
Fakerfg: posts the ante 12
LordAzils002: posts the ante 12
Kevin12345Mc: posts the ante 12
kloun7: posts the ante 12
D0MAGE: posts the ante 12
KungPowNuts: posts the ante 12
D0MAGE: posts small blind 50
KungPowNuts: posts big blind 100
*** HOLE CARDS ***
Dealt to Kevin12345Mc [Kd 6h]
MrPufies: folds 
Marcelothefirst: folds 
Fakerfg: folds 
LordAzils002: raises 110 to 210
Kevin12345Mc: folds 
kloun7: folds 
D0MAGE: folds 
KungPowNuts: folds 
Uncalled bet (110) returned to LordAzils002
LordAzils002 collected 346 from pot
LordAzils002: doesn't show hand 
*** SUMMARY ***
Total pot 346 | Rake 0 
Seat 1: MrPufies folded before Flop (didn't bet)
Seat 2: Marcelothefirst folded before Flop (didn't bet)
Seat 3: Fakerfg folded before Flop (didn't bet)
Seat 4: LordAzils002 collected (346)
Seat 5: Kevin12345Mc folded before Flop (didn't bet)
Seat 6: kloun7 (button) folded before Flop (didn't bet)
Seat 7: D0MAGE (small blind) folded before Flop
Seat 8: KungPowNuts (big blind) folded before Flop



PokerStars Hand #255213179268: Tournament #3863783058, $9.80+$1.20 USD Hold'em No Limit - Level IV (50/100) - 2025/03/09 18:39:45 WET [2025/03/09 14:39:45 ET]
Table '3863783058 225' 8-max Seat #7 is the button
Seat 1: MrPufies (21691 in chips) 
Seat 2: Marcelothefirst (9024 in chips) 
Seat 3: Fakerfg (6880 in chips) 
Seat 4: LordAzils002 (7117 in chips) 
Seat 5: Kevin12345Mc (26213 in chips) 
Seat 6: kloun7 (8477 in chips) 
Seat 7: D0MAGE (9790 in chips) 
Seat 8: KungPowNuts (9628 in chips) 
MrPufies: posts the ante 12
Marcelothefirst: posts the ante 12
Fakerfg: posts the ante 12
LordAzils002: posts the ante 12
Kevin12345Mc: posts the ante 12
kloun7: posts the ante 12
D0MAGE: posts the ante 12
KungPowNuts: posts the ante 12
KungPowNuts: posts small blind 50
MrPufies: posts big blind 100
*** HOLE CARDS ***
Dealt to Kevin12345Mc [Td Jh]
Marcelothefirst: folds 
Fakerfg: folds 
LordAzils002: folds 
Kevin12345Mc: folds 
kloun7: folds 
D0MAGE: folds 
KungPowNuts: raises 100 to 200
MrPufies: folds 
Uncalled bet (100) returned to KungPowNuts
KungPowNuts collected 296 from pot
KungPowNuts: doesn't show hand 
*** SUMMARY ***
Total pot 296 | Rake 0 
Seat 1: MrPufies (big blind) folded before Flop
Seat 2: Marcelothefirst folded before Flop (didn't bet)
Seat 3: Fakerfg folded before Flop (didn't bet)
Seat 4: LordAzils002 folded before Flop (didn't bet)
Seat 5: Kevin12345Mc folded before Flop (didn't bet)
Seat 6: kloun7 folded before Flop (didn't bet)
Seat 7: D0MAGE (button) folded before Flop (didn't bet)
Seat 8: KungPowNuts (small blind) collected (296)



PokerStars Hand #255213193140: Tournament #3863783058, $9.80+$1.20 USD Hold'em No Limit - Level V (60/120) - 2025/03/09 18:40:26 WET [2025/03/09 14:40:26 ET]
Table '3863783058 225' 8-max Seat #8 is the button
Seat 1: MrPufies (21579 in chips) 
Seat 2: Marcelothefirst (9012 in chips) 
Seat 3: Fakerfg (6868 in chips) 
Seat 4: LordAzils002 (7105 in chips) 
Seat 5: Kevin12345Mc (26201 in chips) 
Seat 6: kloun7 (8465 in chips) 
Seat 7: D0MAGE (9778 in chips) 
Seat 8: KungPowNuts (9812 in chips) 
MrPufies: posts the ante 16
Marcelothefirst: posts the ante 16
Fakerfg: posts the ante 16
LordAzils002: posts the ante 16
Kevin12345Mc: posts the ante 16
kloun7: posts the ante 16
D0MAGE: posts the ante 16
KungPowNuts: posts the ante 16
MrPufies: posts small blind 60
Marcelothefirst: posts big blind 120
*** HOLE CARDS ***
Dealt to Kevin12345Mc [9s 8s]
Fakerfg: folds 
LordAzils002: raises 120 to 240
Kevin12345Mc: calls 240
kloun7: folds 
D0MAGE: folds 
KungPowNuts: folds 
MrPufies: folds 
Marcelothefirst: folds 
*** FLOP *** [Ac Js 7h]
LordAzils002: checks 
Kevin12345Mc: checks 
*** TURN *** [Ac Js 7h] [7d]
LordAzils002: checks 
Kevin12345Mc: checks 
*** RIVER *** [Ac Js 7h 7d] [Qc]
LordAzils002: checks 
Kevin12345Mc: checks 
*** SHOW DOWN ***
LordAzils002: shows [Qd 9d] (two pair, Queens and Sevens)
Kevin12345Mc: mucks hand 
LordAzils002 collected 788 from pot
*** SUMMARY ***
Total pot 788 | Rake 0 
Board [Ac Js 7h 7d Qc]
Seat 1: MrPufies (small blind) folded before Flop
Seat 2: Marcelothefirst (big blind) folded before Flop
Seat 3: Fakerfg folded before Flop (didn't bet)
Seat 4: LordAzils002 showed [Qd 9d] and won (788) with two pair, Queens and Sevens
Seat 5: Kevin12345Mc mucked [9s 8s]
Seat 6: kloun7 folded before Flop (didn't bet)
Seat 7: D0MAGE folded before Flop (didn't bet)
Seat 8: KungPowNuts (button) folded before Flop (didn't bet)



PokerStars Hand #255213215653: Tournament #3863783058, $9.80+$1.20 USD Hold'em No Limit - Level V (60/120) - 2025/03/09 18:41:35 WET [2025/03/09 14:41:35 ET]
Table '3863783058 225' 8-max Seat #1 is the button
Seat 1: MrPufies (21503 in chips) 
Seat 2: Marcelothefirst (8876 in chips) 
Seat 3: Fakerfg (6852 in chips) 
Seat 4: LordAzils002 (7637 in chips) 
Seat 5: Kevin12345Mc (25945 in chips) 
Seat 6: kloun7 (8449 in chips) 
Seat 7: D0MAGE (9762 in chips) 
Seat 8: KungPowNuts (9796 in chips) 
MrPufies: posts the ante 16
Marcelothefirst: posts the ante 16
Fakerfg: posts the ante 16
LordAzils002: posts the ante 16
Kevin12345Mc: posts the ante 16
kloun7: posts the ante 16
D0MAGE: posts the ante 16
KungPowNuts: posts the ante 16
Marcelothefirst: posts small blind 60
Fakerfg: posts big blind 120
*** HOLE CARDS ***
Dealt to Kevin12345Mc [9c Jh]
LordAzils002: raises 132 to 252
Kevin12345Mc: folds 
kloun7: folds 
D0MAGE: calls 252
KungPowNuts: raises 528 to 780
MrPufies: folds 
Marcelothefirst: folds 
Fakerfg: folds 
LordAzils002: folds 
D0MAGE: calls 528
*** FLOP *** [Kh 4s Qs]
D0MAGE: checks 
KungPowNuts: bets 1166
D0MAGE: folds 
Uncalled bet (1166) returned to KungPowNuts
KungPowNuts collected 2120 from pot
KungPowNuts: doesn't show hand 
*** SUMMARY ***
Total pot 2120 | Rake 0 
Board [Kh 4s Qs]
Seat 1: MrPufies (button) folded before Flop (didn't bet)
Seat 2: Marcelothefirst (small blind) folded before Flop
Seat 3: Fakerfg (big blind) folded before Flop
Seat 4: LordAzils002 folded before Flop
Seat 5: Kevin12345Mc folded before Flop (didn't bet)
Seat 6: kloun7 folded before Flop (didn't bet)
Seat 7: D0MAGE folded on the Flop
Seat 8: KungPowNuts collected (2120)



PokerStars Hand #255213231863: Tournament #3863783058, $9.80+$1.20 USD Hold'em No Limit - Level V (60/120) - 2025/03/09 18:42:24 WET [2025/03/09 14:42:24 ET]
Table '3863783058 225' 8-max Seat #2 is the button
Seat 1: MrPufies (21487 in chips) 
Seat 2: Marcelothefirst (8800 in chips) 
Seat 3: Fakerfg (6716 in chips) 
Seat 4: LordAzils002 (7369 in chips) 
Seat 5: Kevin12345Mc (25929 in chips) 
Seat 6: kloun7 (8433 in chips) 
Seat 7: D0MAGE (8966 in chips) 
Seat 8: KungPowNuts (11120 in chips) 
MrPufies: posts the ante 16
Marcelothefirst: posts the ante 16
Fakerfg: posts the ante 16
LordAzils002: posts the ante 16
Kevin12345Mc: posts the ante 16
kloun7: posts the ante 16
D0MAGE: posts the ante 16
KungPowNuts: posts the ante 16
Fakerfg: posts small blind 60
LordAzils002: posts big blind 120
*** HOLE CARDS ***
Dealt to Kevin12345Mc [Jd 4h]
Kevin12345Mc: folds 
kloun7: folds 
D0MAGE: raises 120 to 240
KungPowNuts: folds 
MrPufies: folds 
Marcelothefirst: folds 
Fakerfg: folds 
LordAzils002: calls 120
*** FLOP *** [9d 9h 6d]
LordAzils002: checks 
D0MAGE: bets 167
LordAzils002: folds 
Uncalled bet (167) returned to D0MAGE
D0MAGE collected 668 from pot
D0MAGE: doesn't show hand 
*** SUMMARY ***
Total pot 668 | Rake 0 
Board [9d 9h 6d]
Seat 1: MrPufies folded before Flop (didn't bet)
Seat 2: Marcelothefirst (button) folded before Flop (didn't bet)
Seat 3: Fakerfg (small blind) folded before Flop
Seat 4: LordAzils002 (big blind) folded on the Flop
Seat 5: Kevin12345Mc folded before Flop (didn't bet)
Seat 6: kloun7 folded before Flop (didn't bet)
Seat 7: D0MAGE collected (668)
Seat 8: KungPowNuts folded before Flop (didn't bet)



PokerStars Hand #255213244033: Tournament #3863783058, $9.80+$1.20 USD Hold'em No Limit - Level V (60/120) - 2025/03/09 18:43:01 WET [2025/03/09 14:43:01 ET]
Table '3863783058 225' 8-max Seat #3 is the button
Seat 1: MrPufies (21471 in chips) 
Seat 2: Marcelothefirst (8784 in chips) 
Seat 3: Fakerfg (6640 in chips) 
Seat 4: LordAzils002 (7113 in chips) 
Seat 5: Kevin12345Mc (25913 in chips) 
Seat 6: kloun7 (8417 in chips) 
Seat 7: D0MAGE (9378 in chips) 
Seat 8: KungPowNuts (11104 in chips) 
MrPufies: posts the ante 16
Marcelothefirst: posts the ante 16
Fakerfg: posts the ante 16
LordAzils002: posts the ante 16
Kevin12345Mc: posts the ante 16
kloun7: posts the ante 16
D0MAGE: posts the ante 16
KungPowNuts: posts the ante 16
LordAzils002: posts small blind 60
Kevin12345Mc: posts big blind 120
*** HOLE CARDS ***
Dealt to Kevin12345Mc [8d 2c]
kloun7: raises 240 to 360
D0MAGE: folds 
KungPowNuts: folds 
MrPufies: folds 
Marcelothefirst: calls 360
Fakerfg: calls 360
LordAzils002: folds 
Kevin12345Mc: folds 
*** FLOP *** [2s 8c Kd]
kloun7: bets 720
Marcelothefirst: folds 
Fakerfg: folds 
Uncalled bet (720) returned to kloun7
kloun7 collected 1388 from pot
kloun7: doesn't show hand 
*** SUMMARY ***
Total pot 1388 | Rake 0 
Board [2s 8c Kd]
Seat 1: MrPufies folded before Flop (didn't bet)
Seat 2: Marcelothefirst folded on the Flop
Seat 3: Fakerfg (button) folded on the Flop
Seat 4: LordAzils002 (small blind) folded before Flop
Seat 5: Kevin12345Mc (big blind) folded before Flop
Seat 6: kloun7 collected (1388)
Seat 7: D0MAGE folded before Flop (didn't bet)
Seat 8: KungPowNuts folded before Flop (didn't bet)



PokerStars Hand #255213259313: Tournament #3863783058, $9.80+$1.20 USD Hold'em No Limit - Level V (60/120) - 2025/03/09 18:43:47 WET [2025/03/09 14:43:47 ET]
Table '3863783058 225' 8-max Seat #4 is the button
Seat 1: MrPufies (21455 in chips) 
Seat 2: Marcelothefirst (8408 in chips) 
Seat 3: Fakerfg (6264 in chips) 
Seat 4: LordAzils002 (7037 in chips) 
Seat 5: Kevin12345Mc (25777 in chips) 
Seat 6: kloun7 (9429 in chips) 
Seat 7: D0MAGE (9362 in chips) 
Seat 8: KungPowNuts (11088 in chips) 
MrPufies: posts the ante 16
Marcelothefirst: posts the ante 16
Fakerfg: posts the ante 16
LordAzils002: posts the ante 16
Kevin12345Mc: posts the ante 16
kloun7: posts the ante 16
D0MAGE: posts the ante 16
KungPowNuts: posts the ante 16
Kevin12345Mc: posts small blind 60
kloun7: posts big blind 120
*** HOLE CARDS ***
Dealt to Kevin12345Mc [7c 6c]
D0MAGE: folds 
KungPowNuts: folds 
MrPufies: calls 120
Marcelothefirst: raises 240 to 360
Fakerfg: folds 
LordAzils002: calls 360
Kevin12345Mc: calls 300
kloun7: folds 
MrPufies: calls 240
*** FLOP *** [4c 4d Ts]
Kevin12345Mc: checks 
MrPufies: checks 
Marcelothefirst: bets 1084
LordAzils002: calls 1084
Kevin12345Mc: folds 
MrPufies: folds 
*** TURN *** [4c 4d Ts] [2s]
Marcelothefirst: bets 6948 and is all-in
LordAzils002: calls 5577 and is all-in
Uncalled bet (1371) returned to Marcelothefirst
*** RIVER *** [4c 4d Ts 2s] [Kh]
*** SHOW DOWN ***
Marcelothefirst: shows [Qc Qs] (two pair, Queens and Fours)
LordAzils002: shows [Td Ks] (two pair, Kings and Tens)
LordAzils002 collected 15010 from pot
*** SUMMARY ***
Total pot 15010 | Rake 0 
Board [4c 4d Ts 2s Kh]
Seat 1: MrPufies folded on the Flop
Seat 2: Marcelothefirst showed [Qc Qs] and lost with two pair, Queens and Fours
Seat 3: Fakerfg folded before Flop (didn't bet)
Seat 4: LordAzils002 (button) showed [Td Ks] and won (15010) with two pair, Kings and Tens
Seat 5: Kevin12345Mc (small blind) folded on the Flop
Seat 6: kloun7 (big blind) folded before Flop
Seat 7: D0MAGE folded before Flop (didn't bet)
Seat 8: KungPowNuts folded before Flop (didn't bet)



PokerStars Hand #255213291084: Tournament #3863783058, $9.80+$1.20 USD Hold'em No Limit - Level V (60/120) - 2025/03/09 18:45:23 WET [2025/03/09 14:45:23 ET]
Table '3863783058 225' 8-max Seat #5 is the button
Seat 1: MrPufies (21079 in chips) 
Seat 2: Marcelothefirst (1371 in chips) 
Seat 3: Fakerfg (6248 in chips) 
Seat 4: LordAzils002 (15010 in chips) 
Seat 5: Kevin12345Mc (25401 in chips) 
Seat 6: kloun7 (9293 in chips) 
Seat 7: D0MAGE (9346 in chips) 
Seat 8: KungPowNuts (11072 in chips) 
MrPufies: posts the ante 16
Marcelothefirst: posts the ante 16
Fakerfg: posts the ante 16
LordAzils002: posts the ante 16
Kevin12345Mc: posts the ante 16
kloun7: posts the ante 16
D0MAGE: posts the ante 16
KungPowNuts: posts the ante 16
kloun7: posts small blind 60
D0MAGE: posts big blind 120
*** HOLE CARDS ***
Dealt to Kevin12345Mc [Jc 6s]
KungPowNuts: folds 
MrPufies: folds 
Marcelothefirst: folds 
Fakerfg: folds 
LordAzils002: folds 
Kevin12345Mc: folds 
kloun7: calls 60
D0MAGE: checks 
*** FLOP *** [7c 8d 3c]
kloun7: checks 
D0MAGE: bets 120
kloun7: calls 120
*** TURN *** [7c 8d 3c] [8c]
kloun7: checks 
D0MAGE: bets 401
kloun7: folds 
Uncalled bet (401) returned to D0MAGE
D0MAGE collected 608 from pot
D0MAGE: doesn't show hand 
*** SUMMARY ***
Total pot 608 | Rake 0 
Board [7c 8d 3c 8c]
Seat 1: MrPufies folded before Flop (didn't bet)
Seat 2: Marcelothefirst folded before Flop (didn't bet)
Seat 3: Fakerfg folded before Flop (didn't bet)
Seat 4: LordAzils002 folded before Flop (didn't bet)
Seat 5: Kevin12345Mc (button) folded before Flop (didn't bet)
Seat 6: kloun7 (small blind) folded on the Turn
Seat 7: D0MAGE (big blind) collected (608)
Seat 8: KungPowNuts folded before Flop (didn't bet)



PokerStars Hand #255213312503: Tournament #3863783058, $9.80+$1.20 USD Hold'em No Limit - Level V (60/120) - 2025/03/09 18:46:28 WET [2025/03/09 14:46:28 ET]
Table '3863783058 225' 8-max Seat #6 is the button
Seat 1: MrPufies (21063 in chips) 
Seat 2: Marcelothefirst (1355 in chips) 
Seat 3: Fakerfg (6232 in chips) 
Seat 4: LordAzils002 (14994 in chips) 
Seat 5: Kevin12345Mc (25385 in chips) 
Seat 6: kloun7 (9037 in chips) 
Seat 7: D0MAGE (9698 in chips) 
Seat 8: KungPowNuts (11056 in chips) 
MrPufies: posts the ante 16
Marcelothefirst: posts the ante 16
Fakerfg: posts the ante 16
LordAzils002: posts the ante 16
Kevin12345Mc: posts the ante 16
kloun7: posts the ante 16
D0MAGE: posts the ante 16
KungPowNuts: posts the ante 16
D0MAGE: posts small blind 60
KungPowNuts: posts big blind 120
*** HOLE CARDS ***
Dealt to Kevin12345Mc [Jh 2h]
MrPufies: raises 120 to 240
Marcelothefirst: folds 
Fakerfg: folds 
LordAzils002: folds 
Kevin12345Mc: folds 
kloun7: folds 
D0MAGE: calls 180
KungPowNuts: folds 
*** FLOP *** [Ah Tc Qh]
D0MAGE: checks 
MrPufies: bets 539
D0MAGE: calls 539
*** TURN *** [Ah Tc Qh] [5s]
D0MAGE: checks 
MrPufies: bets 1336
D0MAGE: calls 1336
*** RIVER *** [Ah Tc Qh 5s] [Ts]
D0MAGE: bets 2955
MrPufies: calls 2955
*** SHOW DOWN ***
D0MAGE: shows [Th 9h] (three of a kind, Tens)
MrPufies: mucks hand 
D0MAGE collected 10388 from pot
*** SUMMARY ***
Total pot 10388 | Rake 0 
Board [Ah Tc Qh 5s Ts]
Seat 1: MrPufies mucked [Kh As]
Seat 2: Marcelothefirst folded before Flop (didn't bet)
Seat 3: Fakerfg folded before Flop (didn't bet)
Seat 4: LordAzils002 folded before Flop (didn't bet)
Seat 5: Kevin12345Mc folded before Flop (didn't bet)
Seat 6: kloun7 (button) folded before Flop (didn't bet)
Seat 7: D0MAGE (small blind) showed [Th 9h] and won (10388) with three of a kind, Tens
Seat 8: KungPowNuts (big blind) folded before Flop



PokerStars Hand #255213344705: Tournament #3863783058, $9.80+$1.20 USD Hold'em No Limit - Level V (60/120) - 2025/03/09 18:48:06 WET [2025/03/09 14:48:06 ET]
Table '3863783058 225' 8-max Seat #7 is the button
Seat 1: MrPufies (15977 in chips) 
Seat 2: Marcelothefirst (1339 in chips) 
Seat 3: Fakerfg (6216 in chips) 
Seat 4: LordAzils002 (14978 in chips) 
Seat 5: Kevin12345Mc (25369 in chips) 
Seat 6: kloun7 (9021 in chips) 
Seat 7: D0MAGE (15000 in chips) 
Seat 8: KungPowNuts (10920 in chips) 
MrPufies: posts the ante 16
Marcelothefirst: posts the ante 16
Fakerfg: posts the ante 16
LordAzils002: posts the ante 16
Kevin12345Mc: posts the ante 16
kloun7: posts the ante 16
D0MAGE: posts the ante 16
KungPowNuts: posts the ante 16
KungPowNuts: posts small blind 60
MrPufies: posts big blind 120
*** HOLE CARDS ***
Dealt to Kevin12345Mc [6d 3h]
Marcelothefirst: raises 1203 to 1323 and is all-in
Fakerfg: folds 
LordAzils002: folds 
Kevin12345Mc: folds 
kloun7: folds 
D0MAGE is disconnected 
D0MAGE has timed out while disconnected
D0MAGE: folds 
D0MAGE is sitting out
KungPowNuts: folds 
MrPufies: folds 
Uncalled bet (1203) returned to Marcelothefirst
Marcelothefirst is disconnected 
Marcelothefirst collected 428 from pot
*** SUMMARY ***
Total pot 428 | Rake 0 
Seat 1: MrPufies (big blind) folded before Flop
Seat 2: Marcelothefirst collected (428)
Seat 3: Fakerfg folded before Flop (didn't bet)
Seat 4: LordAzils002 folded before Flop (didn't bet)
Seat 5: Kevin12345Mc folded before Flop (didn't bet)
Seat 6: kloun7 folded before Flop (didn't bet)
Seat 7: D0MAGE (button) folded before Flop (didn't bet)
Seat 8: KungPowNuts (small blind) folded before Flop



PokerStars Hand #255213355665: Tournament #3863783058, $9.80+$1.20 USD Hold'em No Limit - Level V (60/120) - 2025/03/09 18:48:39 WET [2025/03/09 14:48:39 ET]
Table '3863783058 225' 8-max Seat #8 is the button
Seat 1: MrPufies (15841 in chips) 
Seat 2: Marcelothefirst (1631 in chips) 
Seat 3: Fakerfg (6200 in chips) 
Seat 4: LordAzils002 (14962 in chips) 
Seat 5: Kevin12345Mc (25353 in chips) 
Seat 6: kloun7 (9005 in chips) 
Seat 7: D0MAGE (14984 in chips) is sitting out
Seat 8: KungPowNuts (10844 in chips) 
MrPufies: posts the ante 16
Marcelothefirst: posts the ante 16
Fakerfg: posts the ante 16
LordAzils002: posts the ante 16
Kevin12345Mc: posts the ante 16
kloun7: posts the ante 16
D0MAGE: posts the ante 16
KungPowNuts: posts the ante 16
MrPufies: posts small blind 60
Marcelothefirst: posts big blind 120
*** HOLE CARDS ***
Dealt to Kevin12345Mc [Td Jh]
Fakerfg: folds 
LordAzils002: folds 
Kevin12345Mc: folds 
kloun7: raises 120 to 240
D0MAGE: folds 
KungPowNuts: folds 
MrPufies: folds 
Marcelothefirst: raises 1375 to 1615 and is all-in
kloun7: calls 1375
*** FLOP *** [Ks 7d 3d]
*** TURN *** [Ks 7d 3d] [9s]
*** RIVER *** [Ks 7d 3d 9s] [Js]
*** SHOW DOWN ***
Marcelothefirst: shows [8h 8d] (a pair of Eights)
kloun7: shows [Ah As] (a pair of Aces)
kloun7 collected 3418 from pot
Marcelothefirst finished the tournament
*** SUMMARY ***
Total pot 3418 | Rake 0 
Board [Ks 7d 3d 9s Js]
Seat 1: MrPufies (small blind) folded before Flop
Seat 2: Marcelothefirst (big blind) showed [8h 8d] and lost with a pair of Eights
Seat 3: Fakerfg folded before Flop (didn't bet)
Seat 4: LordAzils002 folded before Flop (didn't bet)
Seat 5: Kevin12345Mc folded before Flop (didn't bet)
Seat 6: kloun7 showed [Ah As] and won (3418) with a pair of Aces
Seat 7: D0MAGE folded before Flop (didn't bet)
Seat 8: KungPowNuts (button) folded before Flop (didn't bet)



PokerStars Hand #255213368891: Tournament #3863783058, $9.80+$1.20 USD Hold'em No Limit - Level V (60/120) - 2025/03/09 18:49:19 WET [2025/03/09 14:49:19 ET]
Table '3863783058 225' 8-max Seat #1 is the button
Seat 1: MrPufies (15765 in chips) 
Seat 3: Fakerfg (6184 in chips) 
Seat 4: LordAzils002 (14946 in chips) 
Seat 5: Kevin12345Mc (25337 in chips) 
Seat 6: kloun7 (10792 in chips) 
Seat 7: D0MAGE (14968 in chips) is sitting out
Seat 8: KungPowNuts (10828 in chips) 
MrPufies: posts the ante 16
Fakerfg: posts the ante 16
LordAzils002: posts the ante 16
Kevin12345Mc: posts the ante 16
kloun7: posts the ante 16
D0MAGE: posts the ante 16
KungPowNuts: posts the ante 16
Fakerfg: posts small blind 60
LordAzils002: posts big blind 120
*** HOLE CARDS ***
Dealt to Kevin12345Mc [Kh 7c]
Kevin12345Mc: folds 
kloun7: folds 
D0MAGE: folds 
D0MAGE is disconnected 
D0MAGE has returned
KungPowNuts: raises 120 to 240
MrPufies: calls 240
Fakerfg: folds 
LordAzils002: folds 
*** FLOP *** [5d 7h Ks]
KungPowNuts: checks 
MrPufies: checks 
*** TURN *** [5d 7h Ks] [5c]
KungPowNuts: checks 
MrPufies: bets 571
KungPowNuts: folds 
Uncalled bet (571) returned to MrPufies
MrPufies collected 772 from pot
MrPufies: doesn't show hand 
*** SUMMARY ***
Total pot 772 | Rake 0 
Board [5d 7h Ks 5c]
Seat 1: MrPufies (button) collected (772)
Seat 3: Fakerfg (small blind) folded before Flop
Seat 4: LordAzils002 (big blind) folded before Flop
Seat 5: Kevin12345Mc folded before Flop (didn't bet)
Seat 6: kloun7 folded before Flop (didn't bet)
Seat 7: D0MAGE folded before Flop (didn't bet)
Seat 8: KungPowNuts folded on the Turn



PokerStars Hand #255213383273: Tournament #3863783058, $9.80+$1.20 USD Hold'em No Limit - Level VI (80/160) - 2025/03/09 18:50:02 WET [2025/03/09 14:50:02 ET]
Table '3863783058 225' 8-max Seat #3 is the button
Seat 1: MrPufies (16281 in chips) 
Seat 2: zetorrao (10000 in chips) 
Seat 3: Fakerfg (6108 in chips) 
Seat 4: LordAzils002 (14810 in chips) 
Seat 5: Kevin12345Mc (25321 in chips) 
Seat 6: kloun7 (10776 in chips) 
Seat 7: D0MAGE (14952 in chips) 
Seat 8: KungPowNuts (10572 in chips) 
MrPufies: posts the ante 20
zetorrao: posts the ante 20
Fakerfg: posts the ante 20
LordAzils002: posts the ante 20
Kevin12345Mc: posts the ante 20
kloun7: posts the ante 20
D0MAGE: posts the ante 20
KungPowNuts: posts the ante 20
LordAzils002: posts small blind 80
Kevin12345Mc: posts big blind 160
*** HOLE CARDS ***
Dealt to Kevin12345Mc [5h 2d]
kloun7: raises 160 to 320
D0MAGE: folds 
KungPowNuts: folds 
MrPufies: folds 
zetorrao: folds 
Fakerfg: calls 320
LordAzils002: raises 1280 to 1600
Kevin12345Mc: folds 
kloun7: folds 
Fakerfg: calls 1280
*** FLOP *** [Kc 2h 9d]
LordAzils002: bets 1120
Fakerfg: folds 
Uncalled bet (1120) returned to LordAzils002
LordAzils002 collected 3840 from pot
LordAzils002: doesn't show hand 
*** SUMMARY ***
Total pot 3840 | Rake 0 
Board [Kc 2h 9d]
Seat 1: MrPufies folded before Flop (didn't bet)
Seat 2: zetorrao folded before Flop (didn't bet)
Seat 3: Fakerfg (button) folded on the Flop
Seat 4: LordAzils002 (small blind) collected (3840)
Seat 5: Kevin12345Mc (big blind) folded before Flop
Seat 6: kloun7 folded before Flop
Seat 7: D0MAGE folded before Flop (didn't bet)
Seat 8: KungPowNuts folded before Flop (didn't bet)



PokerStars Hand #255213401059: Tournament #3863783058, $9.80+$1.20 USD Hold'em No Limit - Level VI (80/160) - 2025/03/09 18:50:56 WET [2025/03/09 14:50:56 ET]
Table '3863783058 225' 8-max Seat #4 is the button
Seat 1: MrPufies (16261 in chips) 
Seat 2: zetorrao (9980 in chips) 
Seat 3: Fakerfg (4488 in chips) 
Seat 4: LordAzils002 (17030 in chips) 
Seat 5: Kevin12345Mc (25141 in chips) 
Seat 6: kloun7 (10436 in chips) 
Seat 7: D0MAGE (14932 in chips) 
Seat 8: KungPowNuts (10552 in chips) 
MrPufies: posts the ante 20
zetorrao: posts the ante 20
Fakerfg: posts the ante 20
LordAzils002: posts the ante 20
Kevin12345Mc: posts the ante 20
kloun7: posts the ante 20
D0MAGE: posts the ante 20
KungPowNuts: posts the ante 20
Kevin12345Mc: posts small blind 80
kloun7: posts big blind 160
*** HOLE CARDS ***
Dealt to Kevin12345Mc [As Kd]
D0MAGE: folds 
KungPowNuts: folds 
MrPufies: folds 
zetorrao: raises 560 to 720
Fakerfg: folds 
LordAzils002: folds 
Kevin12345Mc: raises 1520 to 2240
kloun7: folds 
zetorrao: calls 1520
*** FLOP *** [Ac Jh 6c]
Kevin12345Mc: bets 1584
zetorrao: calls 1584
*** TURN *** [Ac Jh 6c] [7d]
Kevin12345Mc: bets 7968
zetorrao: calls 6136 and is all-in
Uncalled bet (1832) returned to Kevin12345Mc
*** RIVER *** [Ac Jh 6c 7d] [Ks]
*** SHOW DOWN ***
Kevin12345Mc: shows [As Kd] (two pair, Aces and Kings)
zetorrao: shows [Kc Kh] (three of a kind, Kings)
zetorrao collected 20240 from pot
*** SUMMARY ***
Total pot 20240 | Rake 0 
Board [Ac Jh 6c 7d Ks]
Seat 1: MrPufies folded before Flop (didn't bet)
Seat 2: zetorrao showed [Kc Kh] and won (20240) with three of a kind, Kings
Seat 3: Fakerfg folded before Flop (didn't bet)
Seat 4: LordAzils002 (button) folded before Flop (didn't bet)
Seat 5: Kevin12345Mc (small blind) showed [As Kd] and lost with two pair, Aces and Kings
Seat 6: kloun7 (big blind) folded before Flop
Seat 7: D0MAGE folded before Flop (didn't bet)
Seat 8: KungPowNuts folded before Flop (didn't bet)



PokerStars Hand #255213423393: Tournament #3863783058, $9.80+$1.20 USD Hold'em No Limit - Level VI (80/160) - 2025/03/09 18:52:03 WET [2025/03/09 14:52:03 ET]
Table '3863783058 225' 8-max Seat #5 is the button
Seat 1: MrPufies (16241 in chips) 
Seat 2: zetorrao (20240 in chips) 
Seat 3: Fakerfg (4468 in chips) 
Seat 4: LordAzils002 (17010 in chips) 
Seat 5: Kevin12345Mc (15161 in chips) 
Seat 6: kloun7 (10256 in chips) 
Seat 7: D0MAGE (14912 in chips) 
Seat 8: KungPowNuts (10532 in chips) 
MrPufies: posts the ante 20
zetorrao: posts the ante 20
Fakerfg: posts the ante 20
LordAzils002: posts the ante 20
Kevin12345Mc: posts the ante 20
kloun7: posts the ante 20
D0MAGE: posts the ante 20
KungPowNuts: posts the ante 20
kloun7: posts small blind 80
D0MAGE: posts big blind 160
*** HOLE CARDS ***
Dealt to Kevin12345Mc [Kh Td]
KungPowNuts: folds 
MrPufies: calls 160
zetorrao: folds 
Fakerfg: folds 
LordAzils002: folds 
Kevin12345Mc: calls 160
kloun7: calls 80
D0MAGE: checks 
*** FLOP *** [Ts Kd Th]
kloun7: checks 
D0MAGE: checks 
MrPufies: checks 
Kevin12345Mc: bets 264
kloun7: folds 
D0MAGE: folds 
MrPufies: folds 
Uncalled bet (264) returned to Kevin12345Mc
Kevin12345Mc collected 800 from pot
Kevin12345Mc: doesn't show hand 
*** SUMMARY ***
Total pot 800 | Rake 0 
Board [Ts Kd Th]
Seat 1: MrPufies folded on the Flop
Seat 2: zetorrao folded before Flop (didn't bet)
Seat 3: Fakerfg folded before Flop (didn't bet)
Seat 4: LordAzils002 folded before Flop (didn't bet)
Seat 5: Kevin12345Mc (button) collected (800)
Seat 6: kloun7 (small blind) folded on the Flop
Seat 7: D0MAGE (big blind) folded on the Flop
Seat 8: KungPowNuts folded before Flop (didn't bet)



PokerStars Hand #255213438136: Tournament #3863783058, $9.80+$1.20 USD Hold'em No Limit - Level VI (80/160) - 2025/03/09 18:52:48 WET [2025/03/09 14:52:48 ET]
Table '3863783058 225' 8-max Seat #6 is the button
Seat 1: MrPufies (16061 in chips) 
Seat 2: zetorrao (20220 in chips) 
Seat 3: Fakerfg (4448 in chips) 
Seat 4: LordAzils002 (16990 in chips) 
Seat 5: Kevin12345Mc (15781 in chips) 
Seat 6: kloun7 (10076 in chips) 
Seat 7: D0MAGE (14732 in chips) 
Seat 8: KungPowNuts (10512 in chips) 
MrPufies: posts the ante 20
zetorrao: posts the ante 20
Fakerfg: posts the ante 20
LordAzils002: posts the ante 20
Kevin12345Mc: posts the ante 20
kloun7: posts the ante 20
D0MAGE: posts the ante 20
KungPowNuts: posts the ante 20
D0MAGE: posts small blind 80
KungPowNuts: posts big blind 160
*** HOLE CARDS ***
Dealt to Kevin12345Mc [Ts Qh]
MrPufies: folds 
zetorrao: raises 160 to 320
Fakerfg: calls 320
LordAzils002: folds 
Kevin12345Mc: folds 
kloun7: calls 320
D0MAGE: calls 240
KungPowNuts: folds 
*** FLOP *** [5c 6h 2d]
D0MAGE: checks 
zetorrao: checks 
Fakerfg: checks 
kloun7: bets 960
D0MAGE: folds 
zetorrao: calls 960
Fakerfg: folds 
*** TURN *** [5c 6h 2d] [Qc]
zetorrao: checks 
kloun7: checks 
*** RIVER *** [5c 6h 2d Qc] [Jc]
zetorrao: checks 
kloun7: checks 
*** SHOW DOWN ***
zetorrao: shows [8h 8s] (a pair of Eights)
kloun7: shows [8d 8c] (a pair of Eights)
zetorrao collected 1760 from pot
kloun7 collected 1760 from pot
*** SUMMARY ***
Total pot 3520 | Rake 0 
Board [5c 6h 2d Qc Jc]
Seat 1: MrPufies folded before Flop (didn't bet)
Seat 2: zetorrao showed [8h 8s] and won (1760) with a pair of Eights
Seat 3: Fakerfg folded on the Flop
Seat 4: LordAzils002 folded before Flop (didn't bet)
Seat 5: Kevin12345Mc folded before Flop (didn't bet)
Seat 6: kloun7 (button) showed [8d 8c] and won (1760) with a pair of Eights
Seat 7: D0MAGE (small blind) folded on the Flop
Seat 8: KungPowNuts (big blind) folded before Flop



PokerStars Hand #255213471344: Tournament #3863783058, $9.80+$1.20 USD Hold'em No Limit - Level VI (80/160) - 2025/03/09 18:54:28 WET [2025/03/09 14:54:28 ET]
Table '3863783058 225' 8-max Seat #7 is the button
Seat 1: MrPufies (16041 in chips) 
Seat 2: zetorrao (20680 in chips) 
Seat 3: Fakerfg (4108 in chips) 
Seat 4: LordAzils002 (16970 in chips) 
Seat 5: Kevin12345Mc (15761 in chips) 
Seat 6: kloun7 (10536 in chips) 
Seat 7: D0MAGE (14392 in chips) 
Seat 8: KungPowNuts (10332 in chips) 
MrPufies: posts the ante 20
zetorrao: posts the ante 20
Fakerfg: posts the ante 20
LordAzils002: posts the ante 20
Kevin12345Mc: posts the ante 20
kloun7: posts the ante 20
D0MAGE: posts the ante 20
KungPowNuts: posts the ante 20
KungPowNuts: posts small blind 80
MrPufies: posts big blind 160
*** HOLE CARDS ***
Dealt to Kevin12345Mc [Ts Td]
zetorrao: calls 160
Fakerfg: raises 3928 to 4088 and is all-in
LordAzils002: folds 
Kevin12345Mc: raises 11653 to 15741 and is all-in
kloun7: folds 
D0MAGE: folds 
KungPowNuts: folds 
MrPufies: folds 
MrPufies is sitting out
zetorrao: folds 
Uncalled bet (11653) returned to Kevin12345Mc
*** FLOP *** [8s Qs Th]
*** TURN *** [8s Qs Th] [7h]
*** RIVER *** [8s Qs Th 7h] [As]
*** SHOW DOWN ***
Fakerfg: shows [3s 7s] (a flush, Ace high)
Kevin12345Mc: shows [Ts Td] (three of a kind, Tens)
Fakerfg collected 8736 from pot
*** SUMMARY ***
Total pot 8736 | Rake 0 
Board [8s Qs Th 7h As]
Seat 1: MrPufies (big blind) folded before Flop
Seat 2: zetorrao folded before Flop
Seat 3: Fakerfg showed [3s 7s] and won (8736) with a flush, Ace high
Seat 4: LordAzils002 folded before Flop (didn't bet)
Seat 5: Kevin12345Mc showed [Ts Td] and lost with three of a kind, Tens
Seat 6: kloun7 folded before Flop (didn't bet)
Seat 7: D0MAGE (button) folded before Flop (didn't bet)
Seat 8: KungPowNuts (small blind) folded before Flop



PokerStars Hand #255213579560: Tournament #3863783058, $9.80+$1.20 USD Hold'em No Limit - Level VI (80/160) - 2025/03/09 19:02:24 WET [2025/03/09 15:02:24 ET]
Table '3863783058 225' 8-max Seat #8 is the button
Seat 1: MrPufies (15861 in chips) is sitting out
Seat 2: zetorrao (20500 in chips) 
Seat 3: nucho25 (10000 in chips) 
Seat 4: LordAzils002 (16950 in chips) 
Seat 5: Kevin12345Mc (11653 in chips) 
Seat 6: kloun7 (10516 in chips) 
Seat 7: D0MAGE (14372 in chips) 
Seat 8: KungPowNuts (10232 in chips) 
MrPufies: posts the ante 20
zetorrao: posts the ante 20
nucho25: posts the ante 20
LordAzils002: posts the ante 20
Kevin12345Mc: posts the ante 20
kloun7: posts the ante 20
D0MAGE: posts the ante 20
KungPowNuts: posts the ante 20
MrPufies: posts small blind 80
zetorrao: posts big blind 160
*** HOLE CARDS ***
Dealt to Kevin12345Mc [6c Qc]
MrPufies has returned
nucho25: folds 
LordAzils002: folds 
Kevin12345Mc: folds 
kloun7: folds 
D0MAGE: folds 
KungPowNuts: folds 
MrPufies: calls 80
zetorrao: checks 
*** FLOP *** [Th 9d Js]
MrPufies: checks 
zetorrao: checks 
*** TURN *** [Th 9d Js] [8c]
MrPufies: bets 355
zetorrao: folds 
Uncalled bet (355) returned to MrPufies
MrPufies collected 480 from pot
MrPufies: doesn't show hand 
*** SUMMARY ***
Total pot 480 | Rake 0 
Board [Th 9d Js 8c]
Seat 1: MrPufies (small blind) collected (480)
Seat 2: zetorrao (big blind) folded on the Turn
Seat 3: nucho25 folded before Flop (didn't bet)
Seat 4: LordAzils002 folded before Flop (didn't bet)
Seat 5: Kevin12345Mc folded before Flop (didn't bet)
Seat 6: kloun7 folded before Flop (didn't bet)
Seat 7: D0MAGE folded before Flop (didn't bet)
Seat 8: KungPowNuts (button) folded before Flop (didn't bet)



PokerStars Hand #255213601766: Tournament #3863783058, $9.80+$1.20 USD Hold'em No Limit - Level VI (80/160) - 2025/03/09 19:03:28 WET [2025/03/09 15:03:28 ET]
Table '3863783058 225' 8-max Seat #1 is the button
Seat 1: MrPufies (16161 in chips) 
Seat 2: zetorrao (20320 in chips) 
Seat 3: nucho25 (9980 in chips) 
Seat 4: LordAzils002 (16930 in chips) 
Seat 5: Kevin12345Mc (11633 in chips) 
Seat 6: kloun7 (10496 in chips) 
Seat 7: D0MAGE (14352 in chips) 
Seat 8: KungPowNuts (10212 in chips) 
MrPufies: posts the ante 20
zetorrao: posts the ante 20
nucho25: posts the ante 20
LordAzils002: posts the ante 20
Kevin12345Mc: posts the ante 20
kloun7: posts the ante 20
D0MAGE: posts the ante 20
KungPowNuts: posts the ante 20
zetorrao: posts small blind 80
nucho25: posts big blind 160
*** HOLE CARDS ***
Dealt to Kevin12345Mc [8s 7s]
LordAzils002: raises 176 to 336
Kevin12345Mc: folds 
kloun7: folds 
D0MAGE: folds 
KungPowNuts: folds 
MrPufies: calls 336
zetorrao: calls 256
nucho25: calls 176
*** FLOP *** [5c 5d Qd]
zetorrao: checks 
nucho25: checks 
LordAzils002: checks 
MrPufies: checks 
*** TURN *** [5c 5d Qd] [3d]
zetorrao: checks 
nucho25: checks 
LordAzils002: checks 
MrPufies: checks 
*** RIVER *** [5c 5d Qd 3d] [6c]
zetorrao: bets 1504
nucho25: folds 
LordAzils002: folds 
MrPufies: folds 
Uncalled bet (1504) returned to zetorrao
zetorrao collected 1504 from pot
*** SUMMARY ***
Total pot 1504 | Rake 0 
Board [5c 5d Qd 3d 6c]
Seat 1: MrPufies (button) folded on the River
Seat 2: zetorrao (small blind) collected (1504)
Seat 3: nucho25 (big blind) folded on the River
Seat 4: LordAzils002 folded on the River
Seat 5: Kevin12345Mc folded before Flop (didn't bet)
Seat 6: kloun7 folded before Flop (didn't bet)
Seat 7: D0MAGE folded before Flop (didn't bet)
Seat 8: KungPowNuts folded before Flop (didn't bet)



PokerStars Hand #255213633131: Tournament #3863783058, $9.80+$1.20 USD Hold'em No Limit - Level VI (80/160) - 2025/03/09 19:05:01 WET [2025/03/09 15:05:01 ET]
Table '3863783058 225' 8-max Seat #2 is the button
Seat 1: MrPufies (15805 in chips) 
Seat 2: zetorrao (21468 in chips) 
Seat 3: nucho25 (9624 in chips) 
Seat 4: LordAzils002 (16574 in chips) 
Seat 5: Kevin12345Mc (11613 in chips) 
Seat 6: kloun7 (10476 in chips) 
Seat 7: D0MAGE (14332 in chips) 
Seat 8: KungPowNuts (10192 in chips) 
MrPufies: posts the ante 20
zetorrao: posts the ante 20
nucho25: posts the ante 20
LordAzils002: posts the ante 20
Kevin12345Mc: posts the ante 20
kloun7: posts the ante 20
D0MAGE: posts the ante 20
KungPowNuts: posts the ante 20
nucho25: posts small blind 80
LordAzils002: posts big blind 160
*** HOLE CARDS ***
Dealt to Kevin12345Mc [3d Th]
Kevin12345Mc: folds 
kloun7: raises 320 to 480
D0MAGE: folds 
KungPowNuts: folds 
MrPufies: folds 
zetorrao: folds 
nucho25: calls 400
LordAzils002: calls 320
*** FLOP *** [5d 7s Jc]
nucho25: checks 
LordAzils002: checks 
kloun7: bets 640
nucho25: folds 
LordAzils002: folds 
Uncalled bet (640) returned to kloun7
kloun7 collected 1600 from pot
kloun7: doesn't show hand 
*** SUMMARY ***
Total pot 1600 | Rake 0 
Board [5d 7s Jc]
Seat 1: MrPufies folded before Flop (didn't bet)
Seat 2: zetorrao (button) folded before Flop (didn't bet)
Seat 3: nucho25 (small blind) folded on the Flop
Seat 4: LordAzils002 (big blind) folded on the Flop
Seat 5: Kevin12345Mc folded before Flop (didn't bet)
Seat 6: kloun7 collected (1600)
Seat 7: D0MAGE folded before Flop (didn't bet)
Seat 8: KungPowNuts folded before Flop (didn't bet)



PokerStars Hand #255213654261: Tournament #3863783058, $9.80+$1.20 USD Hold'em No Limit - Level VI (80/160) - 2025/03/09 19:06:03 WET [2025/03/09 15:06:03 ET]
Table '3863783058 225' 8-max Seat #3 is the button
Seat 1: MrPufies (15785 in chips) 
Seat 2: zetorrao (21448 in chips) 
Seat 3: nucho25 (9124 in chips) 
Seat 4: LordAzils002 (16074 in chips) 
Seat 5: Kevin12345Mc (11593 in chips) 
Seat 6: kloun7 (11576 in chips) 
Seat 7: D0MAGE (14312 in chips) 
Seat 8: KungPowNuts (10172 in chips) 
MrPufies: posts the ante 20
zetorrao: posts the ante 20
nucho25: posts the ante 20
LordAzils002: posts the ante 20
Kevin12345Mc: posts the ante 20
kloun7: posts the ante 20
D0MAGE: posts the ante 20
KungPowNuts: posts the ante 20
LordAzils002: posts small blind 80
Kevin12345Mc: posts big blind 160
*** HOLE CARDS ***
Dealt to Kevin12345Mc [2h 8d]
kloun7: folds 
D0MAGE: folds 
KungPowNuts: raises 219 to 379
MrPufies: folds 
zetorrao: calls 379
nucho25: folds 
LordAzils002: calls 299
Kevin12345Mc: folds 
*** FLOP *** [3h Qc Th]
LordAzils002: checks 
KungPowNuts: bets 481
zetorrao: folds 
LordAzils002: folds 
Uncalled bet (481) returned to KungPowNuts
KungPowNuts collected 1457 from pot
KungPowNuts: doesn't show hand 
*** SUMMARY ***
Total pot 1457 | Rake 0 
Board [3h Qc Th]
Seat 1: MrPufies folded before Flop (didn't bet)
Seat 2: zetorrao folded on the Flop
Seat 3: nucho25 (button) folded before Flop (didn't bet)
Seat 4: LordAzils002 (small blind) folded on the Flop
Seat 5: Kevin12345Mc (big blind) folded before Flop
Seat 6: kloun7 folded before Flop (didn't bet)
Seat 7: D0MAGE folded before Flop (didn't bet)
Seat 8: KungPowNuts collected (1457)



PokerStars Hand #255213676673: Tournament #3863783058, $9.80+$1.20 USD Hold'em No Limit - Level VI (80/160) - 2025/03/09 19:07:07 WET [2025/03/09 15:07:07 ET]
Table '3863783058 225' 8-max Seat #4 is the button
Seat 1: MrPufies (15765 in chips) 
Seat 2: zetorrao (21049 in chips) 
Seat 3: nucho25 (9104 in chips) 
Seat 4: LordAzils002 (15675 in chips) 
Seat 5: Kevin12345Mc (11413 in chips) 
Seat 6: kloun7 (11556 in chips) 
Seat 7: D0MAGE (14292 in chips) 
Seat 8: KungPowNuts (11230 in chips) 
MrPufies: posts the ante 20
zetorrao: posts the ante 20
nucho25: posts the ante 20
LordAzils002: posts the ante 20
Kevin12345Mc: posts the ante 20
kloun7: posts the ante 20
D0MAGE: posts the ante 20
KungPowNuts: posts the ante 20
Kevin12345Mc: posts small blind 80
kloun7: posts big blind 160
*** HOLE CARDS ***
Dealt to Kevin12345Mc [Jd Td]
D0MAGE: folds 
KungPowNuts: folds 
MrPufies: folds 
zetorrao: calls 160
nucho25: folds 
LordAzils002: raises 480 to 640
Kevin12345Mc: calls 560
kloun7: folds 
zetorrao: folds 
*** FLOP *** [4d 3h Ah]
Kevin12345Mc: checks 
LordAzils002: bets 581
Kevin12345Mc: folds 
Uncalled bet (581) returned to LordAzils002
LordAzils002 collected 1760 from pot
LordAzils002: doesn't show hand 
*** SUMMARY ***
Total pot 1760 | Rake 0 
Board [4d 3h Ah]
Seat 1: MrPufies folded before Flop (didn't bet)
Seat 2: zetorrao folded before Flop
Seat 3: nucho25 folded before Flop (didn't bet)
Seat 4: LordAzils002 (button) collected (1760)
Seat 5: Kevin12345Mc (small blind) folded on the Flop
Seat 6: kloun7 (big blind) folded before Flop
Seat 7: D0MAGE folded before Flop (didn't bet)
Seat 8: KungPowNuts folded before Flop (didn't bet)



PokerStars Hand #255213697499: Tournament #3863783058, $9.80+$1.20 USD Hold'em No Limit - Level VII (100/200) - 2025/03/09 19:08:08 WET [2025/03/09 15:08:08 ET]
Table '3863783058 225' 8-max Seat #5 is the button
Seat 1: MrPufies (15745 in chips) 
Seat 2: zetorrao (20869 in chips) 
Seat 3: nucho25 (9084 in chips) 
Seat 4: LordAzils002 (16775 in chips) 
Seat 5: Kevin12345Mc (10753 in chips) 
Seat 6: kloun7 (11376 in chips) 
Seat 7: D0MAGE (14272 in chips) 
Seat 8: KungPowNuts (11210 in chips) 
MrPufies: posts the ante 25
zetorrao: posts the ante 25
nucho25: posts the ante 25
LordAzils002: posts the ante 25
Kevin12345Mc: posts the ante 25
kloun7: posts the ante 25
D0MAGE: posts the ante 25
KungPowNuts: posts the ante 25
kloun7: posts small blind 100
D0MAGE: posts big blind 200
*** HOLE CARDS ***
Dealt to Kevin12345Mc [9c 3c]
KungPowNuts: folds 
MrPufies: folds 
zetorrao: folds 
nucho25: folds 
LordAzils002: raises 220 to 420
Kevin12345Mc: folds 
kloun7: folds 
D0MAGE: folds 
Uncalled bet (220) returned to LordAzils002
LordAzils002 collected 700 from pot
LordAzils002: doesn't show hand 
*** SUMMARY ***
Total pot 700 | Rake 0 
Seat 1: MrPufies folded before Flop (didn't bet)
Seat 2: zetorrao folded before Flop (didn't bet)
Seat 3: nucho25 folded before Flop (didn't bet)
Seat 4: LordAzils002 collected (700)
Seat 5: Kevin12345Mc (button) folded before Flop (didn't bet)
Seat 6: kloun7 (small blind) folded before Flop
Seat 7: D0MAGE (big blind) folded before Flop
Seat 8: KungPowNuts folded before Flop (didn't bet)



PokerStars Hand #255213709267: Tournament #3863783058, $9.80+$1.20 USD Hold'em No Limit - Level VII (100/200) - 2025/03/09 19:08:42 WET [2025/03/09 15:08:42 ET]
Table '3863783058 225' 8-max Seat #6 is the button
Seat 1: MrPufies (15720 in chips) 
Seat 2: zetorrao (20844 in chips) 
Seat 3: nucho25 (9059 in chips) 
Seat 4: LordAzils002 (17250 in chips) 
Seat 5: Kevin12345Mc (10728 in chips) 
Seat 6: kloun7 (11251 in chips) 
Seat 7: D0MAGE (14047 in chips) 
Seat 8: KungPowNuts (11185 in chips) 
MrPufies: posts the ante 25
zetorrao: posts the ante 25
nucho25: posts the ante 25
LordAzils002: posts the ante 25
Kevin12345Mc: posts the ante 25
kloun7: posts the ante 25
D0MAGE: posts the ante 25
KungPowNuts: posts the ante 25
D0MAGE: posts small blind 100
KungPowNuts: posts big blind 200
*** HOLE CARDS ***
Dealt to Kevin12345Mc [Qd 7s]
MrPufies: folds 
zetorrao: folds 
nucho25: folds 
LordAzils002: folds 
Kevin12345Mc: folds 
kloun7: raises 200 to 400
D0MAGE: folds 
KungPowNuts: folds 
Uncalled bet (200) returned to kloun7
kloun7 collected 700 from pot
kloun7: doesn't show hand 
*** SUMMARY ***
Total pot 700 | Rake 0 
Seat 1: MrPufies folded before Flop (didn't bet)
Seat 2: zetorrao folded before Flop (didn't bet)
Seat 3: nucho25 folded before Flop (didn't bet)
Seat 4: LordAzils002 folded before Flop (didn't bet)
Seat 5: Kevin12345Mc folded before Flop (didn't bet)
Seat 6: kloun7 (button) collected (700)
Seat 7: D0MAGE (small blind) folded before Flop
Seat 8: KungPowNuts (big blind) folded before Flop



PokerStars Hand #255213721316: Tournament #3863783058, $9.80+$1.20 USD Hold'em No Limit - Level VII (100/200) - 2025/03/09 19:09:17 WET [2025/03/09 15:09:17 ET]
Table '3863783058 225' 8-max Seat #7 is the button
Seat 1: MrPufies (15695 in chips) 
Seat 2: zetorrao (20819 in chips) 
Seat 3: nucho25 (9034 in chips) 
Seat 4: LordAzils002 (17225 in chips) 
Seat 5: Kevin12345Mc (10703 in chips) 
Seat 6: kloun7 (11726 in chips) 
Seat 7: D0MAGE (13922 in chips) 
Seat 8: KungPowNuts (10960 in chips) 
MrPufies: posts the ante 25
zetorrao: posts the ante 25
nucho25: posts the ante 25
LordAzils002: posts the ante 25
Kevin12345Mc: posts the ante 25
kloun7: posts the ante 25
D0MAGE: posts the ante 25
KungPowNuts: posts the ante 25
KungPowNuts: posts small blind 100
MrPufies: posts big blind 200
*** HOLE CARDS ***
Dealt to Kevin12345Mc [6c 9h]
zetorrao: folds 
nucho25: folds 
LordAzils002: folds 
Kevin12345Mc: folds 
kloun7: folds 
D0MAGE: folds 
KungPowNuts: folds 
Uncalled bet (100) returned to MrPufies
MrPufies collected 400 from pot
MrPufies: doesn't show hand 
*** SUMMARY ***
Total pot 400 | Rake 0 
Seat 1: MrPufies (big blind) collected (400)
Seat 2: zetorrao folded before Flop (didn't bet)
Seat 3: nucho25 folded before Flop (didn't bet)
Seat 4: LordAzils002 folded before Flop (didn't bet)
Seat 5: Kevin12345Mc folded before Flop (didn't bet)
Seat 6: kloun7 folded before Flop (didn't bet)
Seat 7: D0MAGE (button) folded before Flop (didn't bet)
Seat 8: KungPowNuts (small blind) folded before Flop



PokerStars Hand #255213748513: Tournament #3863783058, $9.80+$1.20 USD Hold'em No Limit - Level VII (100/200) - 2025/03/09 19:10:35 WET [2025/03/09 15:10:35 ET]
Table '3863783058 225' 8-max Seat #8 is the button
Seat 1: MrPufies (15970 in chips) 
Seat 2: zetorrao (20794 in chips) 
Seat 3: nucho25 (9009 in chips) 
Seat 4: LordAzils002 (17200 in chips) 
Seat 5: Kevin12345Mc (10678 in chips) 
Seat 6: kloun7 (11701 in chips) 
Seat 7: D0MAGE (13897 in chips) 
Seat 8: KungPowNuts (10835 in chips) 
MrPufies: posts the ante 25
zetorrao: posts the ante 25
nucho25: posts the ante 25
LordAzils002: posts the ante 25
Kevin12345Mc: posts the ante 25
kloun7: posts the ante 25
D0MAGE: posts the ante 25
KungPowNuts: posts the ante 25
MrPufies: posts small blind 100
zetorrao: posts big blind 200
*** HOLE CARDS ***
Dealt to Kevin12345Mc [4s 6d]
nucho25: folds 
LordAzils002: folds 
Kevin12345Mc: folds 
kloun7: folds 
D0MAGE: folds 
KungPowNuts: raises 274 to 474
MrPufies: folds 
zetorrao: calls 274
*** FLOP *** [8s 5d Qc]
zetorrao: checks 
KungPowNuts: bets 412
zetorrao: calls 412
*** TURN *** [8s 5d Qc] [Ks]
zetorrao: checks 
KungPowNuts: bets 684
zetorrao: calls 684
*** RIVER *** [8s 5d Qc Ks] [8h]
zetorrao: checks 
KungPowNuts: bets 1135
zetorrao: calls 1135
*** SHOW DOWN ***
KungPowNuts: shows [Js As] (a pair of Eights)
zetorrao: shows [Ts Td] (two pair, Tens and Eights)
zetorrao collected 5710 from pot
*** SUMMARY ***
Total pot 5710 | Rake 0 
Board [8s 5d Qc Ks 8h]
Seat 1: MrPufies (small blind) folded before Flop
Seat 2: zetorrao (big blind) showed [Ts Td] and won (5710) with two pair, Tens and Eights
Seat 3: nucho25 folded before Flop (didn't bet)
Seat 4: LordAzils002 folded before Flop (didn't bet)
Seat 5: Kevin12345Mc folded before Flop (didn't bet)
Seat 6: kloun7 folded before Flop (didn't bet)
Seat 7: D0MAGE folded before Flop (didn't bet)
Seat 8: KungPowNuts (button) showed [Js As] and lost with a pair of Eights



PokerStars Hand #255213777306: Tournament #3863783058, $9.80+$1.20 USD Hold'em No Limit - Level VII (100/200) - 2025/03/09 19:11:58 WET [2025/03/09 15:11:58 ET]
Table '3863783058 225' 8-max Seat #1 is the button
Seat 1: MrPufies (15845 in chips) 
Seat 2: zetorrao (23774 in chips) 
Seat 3: nucho25 (8984 in chips) 
Seat 4: LordAzils002 (17175 in chips) 
Seat 5: Kevin12345Mc (10653 in chips) 
Seat 6: kloun7 (11676 in chips) 
Seat 7: D0MAGE (13872 in chips) 
Seat 8: KungPowNuts (8105 in chips) 
MrPufies: posts the ante 25
zetorrao: posts the ante 25
nucho25: posts the ante 25
LordAzils002: posts the ante 25
Kevin12345Mc: posts the ante 25
kloun7: posts the ante 25
D0MAGE: posts the ante 25
KungPowNuts: posts the ante 25
zetorrao: posts small blind 100
nucho25: posts big blind 200
*** HOLE CARDS ***
Dealt to Kevin12345Mc [7d 5c]
LordAzils002: folds 
Kevin12345Mc: folds 
kloun7: folds 
D0MAGE: folds 
KungPowNuts: raises 274 to 474
MrPufies: folds 
zetorrao: folds 
nucho25: calls 274
*** FLOP *** [6h 3s Ks]
nucho25: checks 
KungPowNuts: bets 412
nucho25: folds 
Uncalled bet (412) returned to KungPowNuts
KungPowNuts collected 1248 from pot
KungPowNuts: doesn't show hand 
*** SUMMARY ***
Total pot 1248 | Rake 0 
Board [6h 3s Ks]
Seat 1: MrPufies (button) folded before Flop (didn't bet)
Seat 2: zetorrao (small blind) folded before Flop
Seat 3: nucho25 (big blind) folded on the Flop
Seat 4: LordAzils002 folded before Flop (didn't bet)
Seat 5: Kevin12345Mc folded before Flop (didn't bet)
Seat 6: kloun7 folded before Flop (didn't bet)
Seat 7: D0MAGE folded before Flop (didn't bet)
Seat 8: KungPowNuts collected (1248)



PokerStars Hand #255213795186: Tournament #3863783058, $9.80+$1.20 USD Hold'em No Limit - Level VII (100/200) - 2025/03/09 19:12:49 WET [2025/03/09 15:12:49 ET]
Table '3863783058 225' 8-max Seat #2 is the button
Seat 1: MrPufies (15820 in chips) 
Seat 2: zetorrao (23649 in chips) 
Seat 3: nucho25 (8485 in chips) 
Seat 4: LordAzils002 (17150 in chips) 
Seat 5: Kevin12345Mc (10628 in chips) 
Seat 6: kloun7 (11651 in chips) 
Seat 7: D0MAGE (13847 in chips) 
Seat 8: KungPowNuts (8854 in chips) 
MrPufies: posts the ante 25
zetorrao: posts the ante 25
nucho25: posts the ante 25
LordAzils002: posts the ante 25
Kevin12345Mc: posts the ante 25
kloun7: posts the ante 25
D0MAGE: posts the ante 25
KungPowNuts: posts the ante 25
nucho25: posts small blind 100
LordAzils002: posts big blind 200
*** HOLE CARDS ***
Dealt to Kevin12345Mc [Ac 2h]
Kevin12345Mc: folds 
kloun7: folds 
D0MAGE: folds 
KungPowNuts: folds 
MrPufies: calls 200
zetorrao is connected 
zetorrao is disconnected 
zetorrao is connected 
zetorrao: calls 200
nucho25: folds 
LordAzils002: checks 
*** FLOP *** [6c Qs 4d]
LordAzils002: checks 
MrPufies: checks 
zetorrao: checks 
*** TURN *** [6c Qs 4d] [3d]
LordAzils002: bets 497
MrPufies: folds 
zetorrao: folds 
Uncalled bet (497) returned to LordAzils002
LordAzils002 collected 900 from pot
LordAzils002: doesn't show hand 
*** SUMMARY ***
Total pot 900 | Rake 0 
Board [6c Qs 4d 3d]
Seat 1: MrPufies folded on the Turn
Seat 2: zetorrao (button) folded on the Turn
Seat 3: nucho25 (small blind) folded before Flop
Seat 4: LordAzils002 (big blind) collected (900)
Seat 5: Kevin12345Mc folded before Flop (didn't bet)
Seat 6: kloun7 folded before Flop (didn't bet)
Seat 7: D0MAGE folded before Flop (didn't bet)
Seat 8: KungPowNuts folded before Flop (didn't bet)



PokerStars Hand #255213817639: Tournament #3863783058, $9.80+$1.20 USD Hold'em No Limit - Level VII (100/200) - 2025/03/09 19:13:54 WET [2025/03/09 15:13:54 ET]
Table '3863783058 225' 8-max Seat #3 is the button
Seat 1: MrPufies (15595 in chips) 
Seat 2: zetorrao (23424 in chips) 
Seat 3: nucho25 (8360 in chips) 
Seat 4: LordAzils002 (17825 in chips) 
Seat 5: Kevin12345Mc (10603 in chips) 
Seat 6: kloun7 (11626 in chips) 
Seat 7: D0MAGE (13822 in chips) 
Seat 8: KungPowNuts (8829 in chips) 
MrPufies: posts the ante 25
zetorrao: posts the ante 25
nucho25: posts the ante 25
LordAzils002: posts the ante 25
Kevin12345Mc: posts the ante 25
kloun7: posts the ante 25
D0MAGE: posts the ante 25
KungPowNuts: posts the ante 25
LordAzils002: posts small blind 100
Kevin12345Mc: posts big blind 200
*** HOLE CARDS ***
Dealt to Kevin12345Mc [7h 2s]
kloun7: folds 
D0MAGE: folds 
KungPowNuts: folds 
MrPufies: folds 
zetorrao: folds 
nucho25: raises 400 to 600
LordAzils002: calls 500
Kevin12345Mc: folds 
*** FLOP *** [2d 3s 6c]
LordAzils002: checks 
nucho25: bets 800
LordAzils002: folds 
Uncalled bet (800) returned to nucho25
nucho25 collected 1600 from pot
nucho25: doesn't show hand 
*** SUMMARY ***
Total pot 1600 | Rake 0 
Board [2d 3s 6c]
Seat 1: MrPufies folded before Flop (didn't bet)
Seat 2: zetorrao folded before Flop (didn't bet)
Seat 3: nucho25 (button) collected (1600)
Seat 4: LordAzils002 (small blind) folded on the Flop
Seat 5: Kevin12345Mc (big blind) folded before Flop
Seat 6: kloun7 folded before Flop (didn't bet)
Seat 7: D0MAGE folded before Flop (didn't bet)
Seat 8: KungPowNuts folded before Flop (didn't bet)



PokerStars Hand #255213829304: Tournament #3863783058, $9.80+$1.20 USD Hold'em No Limit - Level VII (100/200) - 2025/03/09 19:14:27 WET [2025/03/09 15:14:27 ET]
Table '3863783058 225' 8-max Seat #4 is the button
Seat 1: MrPufies (15570 in chips) 
Seat 2: zetorrao (23399 in chips) 
Seat 3: nucho25 (9335 in chips) 
Seat 4: LordAzils002 (17200 in chips) 
Seat 5: Kevin12345Mc (10378 in chips) 
Seat 6: kloun7 (11601 in chips) 
Seat 7: D0MAGE (13797 in chips) 
Seat 8: KungPowNuts (8804 in chips) 
MrPufies: posts the ante 25
zetorrao: posts the ante 25
nucho25: posts the ante 25
LordAzils002: posts the ante 25
Kevin12345Mc: posts the ante 25
kloun7: posts the ante 25
D0MAGE: posts the ante 25
KungPowNuts: posts the ante 25
Kevin12345Mc: posts small blind 100
kloun7: posts big blind 200
*** HOLE CARDS ***
Dealt to Kevin12345Mc [7c Qs]
D0MAGE: folds 
KungPowNuts: folds 
MrPufies: folds 
zetorrao: calls 200
nucho25: folds 
LordAzils002: folds 
Kevin12345Mc: folds 
kloun7: checks 
*** FLOP *** [Ad 9s 5d]
kloun7: checks 
zetorrao: checks 
*** TURN *** [Ad 9s 5d] [Ks]
kloun7 has timed out
kloun7: checks 
zetorrao: checks 
*** RIVER *** [Ad 9s 5d Ks] [As]
kloun7 has timed out
kloun7: checks 
zetorrao: checks 
*** SHOW DOWN ***
kloun7: shows [3d 2c] (a pair of Aces)
zetorrao: shows [2d Td] (a pair of Aces - King+Ten kicker)
zetorrao collected 700 from pot
*** SUMMARY ***
Total pot 700 | Rake 0 
Board [Ad 9s 5d Ks As]
Seat 1: MrPufies folded before Flop (didn't bet)
Seat 2: zetorrao showed [2d Td] and won (700) with a pair of Aces
Seat 3: nucho25 folded before Flop (didn't bet)
Seat 4: LordAzils002 (button) folded before Flop (didn't bet)
Seat 5: Kevin12345Mc (small blind) folded before Flop
Seat 6: kloun7 (big blind) showed [3d 2c] and lost with a pair of Aces
Seat 7: D0MAGE folded before Flop (didn't bet)
Seat 8: KungPowNuts folded before Flop (didn't bet)



PokerStars Hand #255213862245: Tournament #3863783058, $9.80+$1.20 USD Hold'em No Limit - Level VII (100/200) - 2025/03/09 19:16:00 WET [2025/03/09 15:16:00 ET]
Table '3863783058 225' 8-max Seat #5 is the button
Seat 1: MrPufies (15545 in chips) 
Seat 2: zetorrao (23874 in chips) 
Seat 3: nucho25 (9310 in chips) 
Seat 4: LordAzils002 (17175 in chips) 
Seat 5: Kevin12345Mc (10253 in chips) 
Seat 6: kloun7 (11376 in chips) 
Seat 7: D0MAGE (13772 in chips) 
Seat 8: KungPowNuts (8779 in chips) 
MrPufies: posts the ante 25
zetorrao: posts the ante 25
nucho25: posts the ante 25
LordAzils002: posts the ante 25
Kevin12345Mc: posts the ante 25
kloun7: posts the ante 25
D0MAGE: posts the ante 25
KungPowNuts: posts the ante 25
kloun7: posts small blind 100
D0MAGE: posts big blind 200
*** HOLE CARDS ***
Dealt to Kevin12345Mc [2h Qs]
KungPowNuts: raises 200 to 400
MrPufies: folds 
zetorrao: folds 
nucho25: calls 400
LordAzils002: folds 
Kevin12345Mc: folds 
kloun7: calls 300
D0MAGE: calls 200
*** FLOP *** [4d 5d Jc]
kloun7: checks 
D0MAGE: checks 
KungPowNuts: bets 594
nucho25: folds 
kloun7: folds 
D0MAGE: folds 
Uncalled bet (594) returned to KungPowNuts
KungPowNuts collected 1800 from pot
KungPowNuts: doesn't show hand 
*** SUMMARY ***
Total pot 1800 | Rake 0 
Board [4d 5d Jc]
Seat 1: MrPufies folded before Flop (didn't bet)
Seat 2: zetorrao folded before Flop (didn't bet)
Seat 3: nucho25 folded on the Flop
Seat 4: LordAzils002 folded before Flop (didn't bet)
Seat 5: Kevin12345Mc (button) folded before Flop (didn't bet)
Seat 6: kloun7 (small blind) folded on the Flop
Seat 7: D0MAGE (big blind) folded on the Flop
Seat 8: KungPowNuts collected (1800)



PokerStars Hand #255213882390: Tournament #3863783058, $9.80+$1.20 USD Hold'em No Limit - Level VII (100/200) - 2025/03/09 19:16:57 WET [2025/03/09 15:16:57 ET]
Table '3863783058 225' 8-max Seat #6 is the button
Seat 1: MrPufies (15520 in chips) 
Seat 2: zetorrao (23849 in chips) 
Seat 3: nucho25 (8885 in chips) 
Seat 4: LordAzils002 (17150 in chips) 
Seat 5: Kevin12345Mc (10228 in chips) 
Seat 6: kloun7 (10951 in chips) 
Seat 7: D0MAGE (13347 in chips) 
Seat 8: KungPowNuts (10154 in chips) 
MrPufies: posts the ante 25
zetorrao: posts the ante 25
nucho25: posts the ante 25
LordAzils002: posts the ante 25
Kevin12345Mc: posts the ante 25
kloun7: posts the ante 25
D0MAGE: posts the ante 25
KungPowNuts: posts the ante 25
D0MAGE: posts small blind 100
KungPowNuts: posts big blind 200
*** HOLE CARDS ***
Dealt to Kevin12345Mc [Qh 7s]
MrPufies: folds 
zetorrao: calls 200
nucho25: folds 
LordAzils002: raises 500 to 700
Kevin12345Mc: folds 
kloun7: folds 
D0MAGE: folds 
KungPowNuts: folds 
zetorrao: folds 
Uncalled bet (500) returned to LordAzils002
LordAzils002 collected 900 from pot
LordAzils002: doesn't show hand 
*** SUMMARY ***
Total pot 900 | Rake 0 
Seat 1: MrPufies folded before Flop (didn't bet)
Seat 2: zetorrao folded before Flop
Seat 3: nucho25 folded before Flop (didn't bet)
Seat 4: LordAzils002 collected (900)
Seat 5: Kevin12345Mc folded before Flop (didn't bet)
Seat 6: kloun7 (button) folded before Flop (didn't bet)
Seat 7: D0MAGE (small blind) folded before Flop
Seat 8: KungPowNuts (big blind) folded before Flop



PokerStars Hand #255213903714: Tournament #3863783058, $9.80+$1.20 USD Hold'em No Limit - Level VIII (125/250) - 2025/03/09 19:17:58 WET [2025/03/09 15:17:58 ET]
Table '3863783058 225' 8-max Seat #7 is the button
Seat 1: MrPufies (15495 in chips) 
Seat 2: zetorrao (23624 in chips) 
Seat 3: nucho25 (8860 in chips) 
Seat 4: LordAzils002 (17825 in chips) 
Seat 5: Kevin12345Mc (10203 in chips) 
Seat 6: kloun7 (10926 in chips) 
Seat 7: D0MAGE (13222 in chips) 
Seat 8: KungPowNuts (9929 in chips) 
MrPufies: posts the ante 30
zetorrao: posts the ante 30
nucho25: posts the ante 30
LordAzils002: posts the ante 30
Kevin12345Mc: posts the ante 30
kloun7: posts the ante 30
D0MAGE: posts the ante 30
KungPowNuts: posts the ante 30
KungPowNuts: posts small blind 125
MrPufies: posts big blind 250
*** HOLE CARDS ***
Dealt to Kevin12345Mc [2h 5h]
zetorrao: folds 
nucho25: raises 250 to 500
LordAzils002: folds 
Kevin12345Mc: folds 
kloun7: calls 500
D0MAGE: folds 
KungPowNuts: calls 375
MrPufies: folds 
*** FLOP *** [Ah 8h 4c]
KungPowNuts: checks 
nucho25: checks 
kloun7: checks 
*** TURN *** [Ah 8h 4c] [Td]
KungPowNuts: checks 
nucho25: bets 750
kloun7: folds 
KungPowNuts: calls 750
*** RIVER *** [Ah 8h 4c Td] [Th]
KungPowNuts: checks 
nucho25: checks 
*** SHOW DOWN ***
KungPowNuts: shows [Ks Jd] (a pair of Tens)
nucho25: shows [Qc Kd] (a pair of Tens - Ace+King+Queen kicker)
nucho25 collected 3490 from pot
*** SUMMARY ***
Total pot 3490 | Rake 0 
Board [Ah 8h 4c Td Th]
Seat 1: MrPufies (big blind) folded before Flop
Seat 2: zetorrao folded before Flop (didn't bet)
Seat 3: nucho25 showed [Qc Kd] and won (3490) with a pair of Tens
Seat 4: LordAzils002 folded before Flop (didn't bet)
Seat 5: Kevin12345Mc folded before Flop (didn't bet)
Seat 6: kloun7 folded on the Turn
Seat 7: D0MAGE (button) folded before Flop (didn't bet)
Seat 8: KungPowNuts (small blind) showed [Ks Jd] and lost with a pair of Tens



PokerStars Hand #255213931868: Tournament #3863783058, $9.80+$1.20 USD Hold'em No Limit - Level VIII (125/250) - 2025/03/09 19:19:17 WET [2025/03/09 15:19:17 ET]
Table '3863783058 225' 8-max Seat #8 is the button
Seat 1: MrPufies (15215 in chips) 
Seat 2: zetorrao (23594 in chips) 
Seat 3: nucho25 (11070 in chips) 
Seat 4: LordAzils002 (17795 in chips) 
Seat 5: Kevin12345Mc (10173 in chips) 
Seat 6: kloun7 (10396 in chips) 
Seat 7: D0MAGE (13192 in chips) 
Seat 8: KungPowNuts (8649 in chips) 
MrPufies: posts the ante 30
zetorrao: posts the ante 30
nucho25: posts the ante 30
LordAzils002: posts the ante 30
Kevin12345Mc: posts the ante 30
kloun7: posts the ante 30
D0MAGE: posts the ante 30
KungPowNuts: posts the ante 30
MrPufies: posts small blind 125
zetorrao: posts big blind 250
*** HOLE CARDS ***
Dealt to Kevin12345Mc [3s Jc]
nucho25: folds 
LordAzils002: folds 
Kevin12345Mc: folds 
kloun7: folds 
D0MAGE: raises 250 to 500
KungPowNuts: folds 
MrPufies: folds 
zetorrao: calls 250
*** FLOP *** [6s 4c 6h]
zetorrao: checks 
D0MAGE: bets 341
zetorrao: folds 
Uncalled bet (341) returned to D0MAGE
D0MAGE collected 1365 from pot
D0MAGE: doesn't show hand 
*** SUMMARY ***
Total pot 1365 | Rake 0 
Board [6s 4c 6h]
Seat 1: MrPufies (small blind) folded before Flop
Seat 2: zetorrao (big blind) folded on the Flop
Seat 3: nucho25 folded before Flop (didn't bet)
Seat 4: LordAzils002 folded before Flop (didn't bet)
Seat 5: Kevin12345Mc folded before Flop (didn't bet)
Seat 6: kloun7 folded before Flop (didn't bet)
Seat 7: D0MAGE collected (1365)
Seat 8: KungPowNuts (button) folded before Flop (didn't bet)



PokerStars Hand #255213948706: Tournament #3863783058, $9.80+$1.20 USD Hold'em No Limit - Level VIII (125/250) - 2025/03/09 19:20:05 WET [2025/03/09 15:20:05 ET]
Table '3863783058 225' 8-max Seat #1 is the button
Seat 1: MrPufies (15060 in chips) 
Seat 2: zetorrao (23064 in chips) 
Seat 3: nucho25 (11040 in chips) 
Seat 4: LordAzils002 (17765 in chips) 
Seat 5: Kevin12345Mc (10143 in chips) 
Seat 6: kloun7 (10366 in chips) 
Seat 7: D0MAGE (14027 in chips) 
Seat 8: KungPowNuts (8619 in chips) 
MrPufies: posts the ante 30
zetorrao: posts the ante 30
nucho25: posts the ante 30
LordAzils002: posts the ante 30
Kevin12345Mc: posts the ante 30
kloun7: posts the ante 30
D0MAGE: posts the ante 30
KungPowNuts: posts the ante 30
zetorrao: posts small blind 125
nucho25: posts big blind 250
*** HOLE CARDS ***
Dealt to Kevin12345Mc [Qc As]
LordAzils002: folds 
Kevin12345Mc: raises 325 to 575
kloun7: folds 
D0MAGE: folds 
KungPowNuts: folds 
MrPufies: folds 
zetorrao: folds 
nucho25: calls 325
*** FLOP *** [Th 7d 6s]
nucho25: checks 
Kevin12345Mc: bets 500
nucho25: calls 500
*** TURN *** [Th 7d 6s] [6d]
nucho25: checks 
Kevin12345Mc: checks 
*** RIVER *** [Th 7d 6s 6d] [3h]
nucho25: bets 9935 and is all-in
Kevin12345Mc: folds 
Uncalled bet (9935) returned to nucho25
nucho25 collected 2515 from pot
nucho25: doesn't show hand 
*** SUMMARY ***
Total pot 2515 | Rake 0 
Board [Th 7d 6s 6d 3h]
Seat 1: MrPufies (button) folded before Flop (didn't bet)
Seat 2: zetorrao (small blind) folded before Flop
Seat 3: nucho25 (big blind) collected (2515)
Seat 4: LordAzils002 folded before Flop (didn't bet)
Seat 5: Kevin12345Mc folded on the River
Seat 6: kloun7 folded before Flop (didn't bet)
Seat 7: D0MAGE folded before Flop (didn't bet)
Seat 8: KungPowNuts folded before Flop (didn't bet)



PokerStars Hand #255213967987: Tournament #3863783058, $9.80+$1.20 USD Hold'em No Limit - Level VIII (125/250) - 2025/03/09 19:21:00 WET [2025/03/09 15:21:00 ET]
Table '3863783058 225' 8-max Seat #2 is the button
Seat 1: MrPufies (15030 in chips) 
Seat 2: zetorrao (22909 in chips) 
Seat 3: nucho25 (12450 in chips) 
Seat 4: LordAzils002 (17735 in chips) 
Seat 5: Kevin12345Mc (9038 in chips) 
Seat 6: kloun7 (10336 in chips) 
Seat 7: D0MAGE (13997 in chips) 
Seat 8: KungPowNuts (8589 in chips) 
MrPufies: posts the ante 30
zetorrao: posts the ante 30
nucho25: posts the ante 30
LordAzils002: posts the ante 30
Kevin12345Mc: posts the ante 30
kloun7: posts the ante 30
D0MAGE: posts the ante 30
KungPowNuts: posts the ante 30
nucho25: posts small blind 125
LordAzils002: posts big blind 250
*** HOLE CARDS ***
Dealt to Kevin12345Mc [3d Ac]
Kevin12345Mc: folds 
kloun7: folds 
D0MAGE: folds 
KungPowNuts: raises 250 to 500
MrPufies: calls 500
zetorrao: calls 500
nucho25: folds 
LordAzils002: folds 
*** FLOP *** [9d Kh 9h]
KungPowNuts: checks 
MrPufies: checks 
zetorrao: checks 
*** TURN *** [9d Kh 9h] [Js]
KungPowNuts: checks 
MrPufies: checks 
zetorrao: checks 
*** RIVER *** [9d Kh 9h Js] [Qc]
KungPowNuts: checks 
MrPufies: checks 
zetorrao: checks 
*** SHOW DOWN ***
KungPowNuts: shows [7s 7c] (two pair, Nines and Sevens)
MrPufies: mucks hand 
zetorrao: mucks hand 
KungPowNuts collected 2115 from pot
*** SUMMARY ***
Total pot 2115 | Rake 0 
Board [9d Kh 9h Js Qc]
Seat 1: MrPufies mucked [5s 5c]
Seat 2: zetorrao (button) mucked [5d 4d]
Seat 3: nucho25 (small blind) folded before Flop
Seat 4: LordAzils002 (big blind) folded before Flop
Seat 5: Kevin12345Mc folded before Flop (didn't bet)
Seat 6: kloun7 folded before Flop (didn't bet)
Seat 7: D0MAGE folded before Flop (didn't bet)
Seat 8: KungPowNuts showed [7s 7c] and won (2115) with two pair, Nines and Sevens



PokerStars Hand #255213990750: Tournament #3863783058, $9.80+$1.20 USD Hold'em No Limit - Level VIII (125/250) - 2025/03/09 19:22:04 WET [2025/03/09 15:22:04 ET]
Table '3863783058 225' 8-max Seat #3 is the button
Seat 1: MrPufies (14500 in chips) 
Seat 2: zetorrao (22379 in chips) 
Seat 3: nucho25 (12295 in chips) 
Seat 4: LordAzils002 (17455 in chips) 
Seat 5: Kevin12345Mc (9008 in chips) 
Seat 6: kloun7 (10306 in chips) 
Seat 7: D0MAGE (13967 in chips) 
Seat 8: KungPowNuts (10174 in chips) 
MrPufies: posts the ante 30
zetorrao: posts the ante 30
nucho25: posts the ante 30
LordAzils002: posts the ante 30
Kevin12345Mc: posts the ante 30
kloun7: posts the ante 30
D0MAGE: posts the ante 30
KungPowNuts: posts the ante 30
LordAzils002: posts small blind 125
Kevin12345Mc: posts big blind 250
*** HOLE CARDS ***
Dealt to Kevin12345Mc [6d 8s]
kloun7: folds 
D0MAGE: folds 
KungPowNuts: raises 342 to 592
MrPufies: calls 592
zetorrao: folds 
nucho25: folds 
LordAzils002: folds 
Kevin12345Mc: folds 
*** FLOP *** [9c 2h Qh]
KungPowNuts: bets 594
MrPufies: calls 594
*** TURN *** [9c 2h Qh] [Kc]
KungPowNuts: bets 986
MrPufies: calls 986
*** RIVER *** [9c 2h Qh Kc] [Ks]
KungPowNuts: bets 1636
MrPufies: raises 10662 to 12298 and is all-in
KungPowNuts: calls 6336 and is all-in
Uncalled bet (4326) returned to MrPufies
*** SHOW DOWN ***
MrPufies: shows [Jh Td] (a straight, Nine to King)
KungPowNuts: shows [As Kd] (three of a kind, Kings)
MrPufies collected 20903 from pot
KungPowNuts finished the tournament
*** SUMMARY ***
Total pot 20903 | Rake 0 
Board [9c 2h Qh Kc Ks]
Seat 1: MrPufies showed [Jh Td] and won (20903) with a straight, Nine to King
Seat 2: zetorrao folded before Flop (didn't bet)
Seat 3: nucho25 (button) folded before Flop (didn't bet)
Seat 4: LordAzils002 (small blind) folded before Flop
Seat 5: Kevin12345Mc (big blind) folded before Flop
Seat 6: kloun7 folded before Flop (didn't bet)
Seat 7: D0MAGE folded before Flop (didn't bet)
Seat 8: KungPowNuts showed [As Kd] and lost with three of a kind, Kings



PokerStars Hand #255214018060: Tournament #3863783058, $9.80+$1.20 USD Hold'em No Limit - Level VIII (125/250) - 2025/03/09 19:23:22 WET [2025/03/09 15:23:22 ET]
Table '3863783058 225' 8-max Seat #4 is the button
Seat 1: MrPufies (25229 in chips) 
Seat 2: zetorrao (22349 in chips) 
Seat 3: nucho25 (12265 in chips) 
Seat 4: LordAzils002 (17300 in chips) 
Seat 5: Kevin12345Mc (8728 in chips) 
Seat 6: kloun7 (10276 in chips) 
Seat 7: D0MAGE (13937 in chips) 
MrPufies: posts the ante 30
zetorrao: posts the ante 30
nucho25: posts the ante 30
LordAzils002: posts the ante 30
Kevin12345Mc: posts the ante 30
kloun7: posts the ante 30
D0MAGE: posts the ante 30
Kevin12345Mc: posts small blind 125
kloun7: posts big blind 250
*** HOLE CARDS ***
Dealt to Kevin12345Mc [Kd 2s]
D0MAGE: raises 250 to 500
must59 is disconnected 
MrPufies: calls 500
zetorrao: folds 
nucho25: folds 
LordAzils002: folds 
Kevin12345Mc: folds 
kloun7: calls 250
*** FLOP *** [Ah 5d Jh]
kloun7: checks 
D0MAGE: bets 918
MrPufies: folds 
kloun7: folds 
Uncalled bet (918) returned to D0MAGE
D0MAGE collected 1835 from pot
D0MAGE: doesn't show hand 
*** SUMMARY ***
Total pot 1835 | Rake 0 
Board [Ah 5d Jh]
Seat 1: MrPufies folded on the Flop
Seat 2: zetorrao folded before Flop (didn't bet)
Seat 3: nucho25 folded before Flop (didn't bet)
Seat 4: LordAzils002 (button) folded before Flop (didn't bet)
Seat 5: Kevin12345Mc (small blind) folded before Flop
Seat 6: kloun7 (big blind) folded on the Flop
Seat 7: D0MAGE collected (1835)



PokerStars Hand #255214033676: Tournament #3863783058, $9.80+$1.20 USD Hold'em No Limit - Level VIII (125/250) - 2025/03/09 19:24:07 WET [2025/03/09 15:24:07 ET]
Table '3863783058 225' 8-max Seat #5 is the button
Seat 1: MrPufies (24699 in chips) 
Seat 2: zetorrao (22319 in chips) 
Seat 3: nucho25 (12235 in chips) 
Seat 4: LordAzils002 (17270 in chips) 
Seat 5: Kevin12345Mc (8573 in chips) 
Seat 6: kloun7 (9746 in chips) 
Seat 7: D0MAGE (15242 in chips) 
Seat 8: must59 (10000 in chips) 
MrPufies: posts the ante 30
zetorrao: posts the ante 30
nucho25: posts the ante 30
LordAzils002: posts the ante 30
Kevin12345Mc: posts the ante 30
kloun7: posts the ante 30
D0MAGE: posts the ante 30
must59: posts the ante 30
kloun7: posts small blind 125
D0MAGE: posts big blind 250
*** HOLE CARDS ***
Dealt to Kevin12345Mc [4h 3d]
must59: folds 
MrPufies: folds 
zetorrao: calls 250
nucho25: folds 
LordAzils002: folds 
Kevin12345Mc: folds 
kloun7: calls 125
D0MAGE: checks 
*** FLOP *** [3c 6c Ah]
kloun7 has timed out
kloun7: checks 
D0MAGE: checks 
zetorrao: bets 495
kloun7: folds 
D0MAGE: calls 495
*** TURN *** [3c 6c Ah] [9c]
D0MAGE: checks 
zetorrao: checks 
*** RIVER *** [3c 6c Ah 9c] [Jh]
D0MAGE: bets 620
zetorrao: calls 620
*** SHOW DOWN ***
D0MAGE: shows [8h Ad] (a pair of Aces)
zetorrao: shows [As 3h] (two pair, Aces and Threes)
zetorrao collected 3220 from pot
*** SUMMARY ***
Total pot 3220 | Rake 0 
Board [3c 6c Ah 9c Jh]
Seat 1: MrPufies folded before Flop (didn't bet)
Seat 2: zetorrao showed [As 3h] and won (3220) with two pair, Aces and Threes
Seat 3: nucho25 folded before Flop (didn't bet)
Seat 4: LordAzils002 folded before Flop (didn't bet)
Seat 5: Kevin12345Mc (button) folded before Flop (didn't bet)
Seat 6: kloun7 (small blind) folded on the Flop
Seat 7: D0MAGE (big blind) showed [8h Ad] and lost with a pair of Aces
Seat 8: must59 folded before Flop (didn't bet)



PokerStars Hand #255214071933: Tournament #3863783058, $9.80+$1.20 USD Hold'em No Limit - Level VIII (125/250) - 2025/03/09 19:25:56 WET [2025/03/09 15:25:56 ET]
Table '3863783058 225' 8-max Seat #6 is the button
Seat 1: MrPufies (24669 in chips) 
Seat 2: zetorrao (24144 in chips) 
Seat 3: nucho25 (12205 in chips) 
Seat 4: LordAzils002 (17240 in chips) 
Seat 5: Kevin12345Mc (8543 in chips) 
Seat 6: kloun7 (9466 in chips) 
Seat 7: D0MAGE (13847 in chips) 
Seat 8: must59 (9970 in chips) 
MrPufies: posts the ante 30
zetorrao: posts the ante 30
nucho25: posts the ante 30
LordAzils002: posts the ante 30
Kevin12345Mc: posts the ante 30
kloun7: posts the ante 30
D0MAGE: posts the ante 30
must59: posts the ante 30
D0MAGE: posts small blind 125
must59: posts big blind 250
*** HOLE CARDS ***
Dealt to Kevin12345Mc [5d Ah]
MrPufies: folds 
zetorrao: calls 250
nucho25: folds 
LordAzils002: folds 
Kevin12345Mc: folds 
kloun7: calls 250
D0MAGE: folds 
must59: checks 
*** FLOP *** [3h 6d Kc]
must59: checks 
zetorrao: checks 
kloun7: checks 
*** TURN *** [3h 6d Kc] [6s]
must59: checks 
zetorrao: checks 
kloun7: checks 
*** RIVER *** [3h 6d Kc 6s] [3c]
must59: checks 
zetorrao: bets 558
kloun7: folds 
must59: folds 
Uncalled bet (558) returned to zetorrao
zetorrao collected 1115 from pot
*** SUMMARY ***
Total pot 1115 | Rake 0 
Board [3h 6d Kc 6s 3c]
Seat 1: MrPufies folded before Flop (didn't bet)
Seat 2: zetorrao collected (1115)
Seat 3: nucho25 folded before Flop (didn't bet)
Seat 4: LordAzils002 folded before Flop (didn't bet)
Seat 5: Kevin12345Mc folded before Flop (didn't bet)
Seat 6: kloun7 (button) folded on the River
Seat 7: D0MAGE (small blind) folded before Flop
Seat 8: must59 (big blind) folded on the River



PokerStars Hand #255214099480: Tournament #3863783058, $9.80+$1.20 USD Hold'em No Limit - Level VIII (125/250) - 2025/03/09 19:27:15 WET [2025/03/09 15:27:15 ET]
Table '3863783058 225' 8-max Seat #7 is the button
Seat 1: MrPufies (24639 in chips) 
Seat 2: zetorrao (24979 in chips) 
Seat 3: nucho25 (12175 in chips) 
Seat 4: LordAzils002 (17210 in chips) 
Seat 5: Kevin12345Mc (8513 in chips) 
Seat 6: kloun7 (9186 in chips) 
Seat 7: D0MAGE (13692 in chips) 
Seat 8: must59 (9690 in chips) 
MrPufies: posts the ante 30
zetorrao: posts the ante 30
nucho25: posts the ante 30
LordAzils002: posts the ante 30
Kevin12345Mc: posts the ante 30
kloun7: posts the ante 30
D0MAGE: posts the ante 30
must59: posts the ante 30
must59: posts small blind 125
MrPufies: posts big blind 250
*** HOLE CARDS ***
Dealt to Kevin12345Mc [3c 8h]
zetorrao: calls 250
nucho25: folds 
LordAzils002: folds 
Kevin12345Mc: folds 
kloun7: raises 250 to 500
D0MAGE: folds 
must59: calls 375
MrPufies: calls 250
zetorrao: calls 250
*** FLOP *** [8s 5d Qs]
must59: checks 
MrPufies: checks 
zetorrao: checks 
kloun7: checks 
*** TURN *** [8s 5d Qs] [5c]
must59: checks 
MrPufies: checks 
zetorrao: checks 
kloun7: checks 
*** RIVER *** [8s 5d Qs 5c] [9s]
must59: bets 1500
MrPufies: folds 
zetorrao: folds 
kloun7: folds 
Uncalled bet (1500) returned to must59
must59 collected 2240 from pot
must59: doesn't show hand 
*** SUMMARY ***
Total pot 2240 | Rake 0 
Board [8s 5d Qs 5c 9s]
Seat 1: MrPufies (big blind) folded on the River
Seat 2: zetorrao folded on the River
Seat 3: nucho25 folded before Flop (didn't bet)
Seat 4: LordAzils002 folded before Flop (didn't bet)
Seat 5: Kevin12345Mc folded before Flop (didn't bet)
Seat 6: kloun7 folded on the River
Seat 7: D0MAGE (button) folded before Flop (didn't bet)
Seat 8: must59 (small blind) collected (2240)



PokerStars Hand #255214129394: Tournament #3863783058, $9.80+$1.20 USD Hold'em No Limit - Level IX (150/300) - 2025/03/09 19:28:41 WET [2025/03/09 15:28:41 ET]
Table '3863783058 225' 8-max Seat #8 is the button
Seat 1: MrPufies (24109 in chips) 
Seat 2: zetorrao (24449 in chips) 
Seat 3: nucho25 (12145 in chips) 
Seat 4: LordAzils002 (17180 in chips) 
Seat 5: Kevin12345Mc (8483 in chips) 
Seat 6: kloun7 (8656 in chips) 
Seat 7: D0MAGE (13662 in chips) 
Seat 8: must59 (11400 in chips) 
MrPufies: posts the ante 40
zetorrao: posts the ante 40
nucho25: posts the ante 40
LordAzils002: posts the ante 40
Kevin12345Mc: posts the ante 40
kloun7: posts the ante 40
D0MAGE: posts the ante 40
must59: posts the ante 40
MrPufies: posts small blind 150
zetorrao: posts big blind 300
*** HOLE CARDS ***
Dealt to Kevin12345Mc [6s Kd]
nucho25: raises 300 to 600
LordAzils002: folds 
Kevin12345Mc: folds 
kloun7: folds 
D0MAGE: folds 
must59: folds 
MrPufies: calls 450
zetorrao: folds 
*** FLOP *** [Jh 8c 5d]
MrPufies: checks 
nucho25: checks 
*** TURN *** [Jh 8c 5d] [Qh]
MrPufies: checks 
nucho25: checks 
*** RIVER *** [Jh 8c 5d Qh] [6h]
MrPufies: checks 
nucho25: checks 
*** SHOW DOWN ***
MrPufies: shows [9h 9d] (a pair of Nines)
nucho25: mucks hand 
MrPufies collected 1820 from pot
*** SUMMARY ***
Total pot 1820 | Rake 0 
Board [Jh 8c 5d Qh 6h]
Seat 1: MrPufies (small blind) showed [9h 9d] and won (1820) with a pair of Nines
Seat 2: zetorrao (big blind) folded before Flop
Seat 3: nucho25 mucked [9c Ah]
Seat 4: LordAzils002 folded before Flop (didn't bet)
Seat 5: Kevin12345Mc folded before Flop (didn't bet)
Seat 6: kloun7 folded before Flop (didn't bet)
Seat 7: D0MAGE folded before Flop (didn't bet)
Seat 8: must59 (button) folded before Flop (didn't bet)



PokerStars Hand #255214152100: Tournament #3863783058, $9.80+$1.20 USD Hold'em No Limit - Level IX (150/300) - 2025/03/09 19:29:46 WET [2025/03/09 15:29:46 ET]
Table '3863783058 225' 8-max Seat #1 is the button
Seat 1: MrPufies (25289 in chips) 
Seat 2: zetorrao (24109 in chips) 
Seat 3: nucho25 (11505 in chips) 
Seat 4: LordAzils002 (17140 in chips) 
Seat 5: Kevin12345Mc (8443 in chips) 
Seat 6: kloun7 (8616 in chips) 
Seat 7: D0MAGE (13622 in chips) 
Seat 8: must59 (11360 in chips) 
MrPufies: posts the ante 40
zetorrao: posts the ante 40
nucho25: posts the ante 40
LordAzils002: posts the ante 40
Kevin12345Mc: posts the ante 40
kloun7: posts the ante 40
D0MAGE: posts the ante 40
must59: posts the ante 40
zetorrao: posts small blind 150
nucho25: posts big blind 300
*** HOLE CARDS ***
Dealt to Kevin12345Mc [3s 2h]
LordAzils002: folds 
Kevin12345Mc: folds 
kloun7: folds 
D0MAGE: raises 300 to 600
must59: calls 600
MrPufies: folds 
zetorrao: calls 450
nucho25: folds 
*** FLOP *** [4d Qs Ad]
zetorrao: checks 
D0MAGE: checks 
must59: bets 1210
zetorrao: folds 
D0MAGE: raises 2420 to 3630
must59: calls 2420
*** TURN *** [4d Qs Ad] [3d]
D0MAGE: bets 2420
must59: folds 
Uncalled bet (2420) returned to D0MAGE
D0MAGE collected 9680 from pot
D0MAGE: doesn't show hand 
*** SUMMARY ***
Total pot 9680 | Rake 0 
Board [4d Qs Ad 3d]
Seat 1: MrPufies (button) folded before Flop (didn't bet)
Seat 2: zetorrao (small blind) folded on the Flop
Seat 3: nucho25 (big blind) folded before Flop
Seat 4: LordAzils002 folded before Flop (didn't bet)
Seat 5: Kevin12345Mc folded before Flop (didn't bet)
Seat 6: kloun7 folded before Flop (didn't bet)
Seat 7: D0MAGE collected (9680)
Seat 8: must59 folded on the Turn



PokerStars Hand #255214187282: Tournament #3863783058, $9.80+$1.20 USD Hold'em No Limit - Level IX (150/300) - 2025/03/09 19:31:25 WET [2025/03/09 15:31:25 ET]
Table '3863783058 225' 8-max Seat #2 is the button
Seat 1: MrPufies (25249 in chips) 
Seat 2: zetorrao (23469 in chips) 
Seat 3: nucho25 (11165 in chips) 
Seat 4: LordAzils002 (17100 in chips) 
Seat 5: Kevin12345Mc (8403 in chips) 
Seat 6: kloun7 (8576 in chips) 
Seat 7: D0MAGE (19032 in chips) 
Seat 8: must59 (7090 in chips) 
MrPufies: posts the ante 40
zetorrao: posts the ante 40
nucho25: posts the ante 40
LordAzils002: posts the ante 40
Kevin12345Mc: posts the ante 40
kloun7: posts the ante 40
D0MAGE: posts the ante 40
must59: posts the ante 40
nucho25: posts small blind 150
LordAzils002: posts big blind 300
*** HOLE CARDS ***
Dealt to Kevin12345Mc [Kh 3h]
Kevin12345Mc: folds 
kloun7: folds 
D0MAGE: raises 300 to 600
must59: calls 600
MrPufies: folds 
zetorrao: folds 
nucho25: calls 450
LordAzils002: folds 
*** FLOP *** [6h 2s 7s]
nucho25: checks 
D0MAGE: checks 
must59: bets 6450 and is all-in
nucho25: folds 
D0MAGE: folds 
Uncalled bet (6450) returned to must59
must59 collected 2420 from pot
must59: doesn't show hand 
*** SUMMARY ***
Total pot 2420 | Rake 0 
Board [6h 2s 7s]
Seat 1: MrPufies folded before Flop (didn't bet)
Seat 2: zetorrao (button) folded before Flop (didn't bet)
Seat 3: nucho25 (small blind) folded on the Flop
Seat 4: LordAzils002 (big blind) folded before Flop
Seat 5: Kevin12345Mc folded before Flop (didn't bet)
Seat 6: kloun7 folded before Flop (didn't bet)
Seat 7: D0MAGE folded on the Flop
Seat 8: must59 collected (2420)



PokerStars Hand #255214210024: Tournament #3863783058, $9.80+$1.20 USD Hold'em No Limit - Level IX (150/300) - 2025/03/09 19:32:28 WET [2025/03/09 15:32:28 ET]
Table '3863783058 225' 8-max Seat #3 is the button
Seat 1: MrPufies (25209 in chips) 
Seat 2: zetorrao (23429 in chips) 
Seat 3: nucho25 (10525 in chips) 
Seat 4: LordAzils002 (16760 in chips) 
Seat 5: Kevin12345Mc (8363 in chips) 
Seat 6: kloun7 (8536 in chips) 
Seat 7: D0MAGE (18392 in chips) 
Seat 8: must59 (8870 in chips) 
MrPufies: posts the ante 40
zetorrao: posts the ante 40
nucho25: posts the ante 40
LordAzils002: posts the ante 40
Kevin12345Mc: posts the ante 40
kloun7: posts the ante 40
D0MAGE: posts the ante 40
must59: posts the ante 40
LordAzils002: posts small blind 150
Kevin12345Mc: posts big blind 300
*** HOLE CARDS ***
Dealt to Kevin12345Mc [Jd 6h]
kloun7: folds 
D0MAGE: folds 
must59: folds 
MrPufies: folds 
zetorrao: folds 
nucho25: folds 
LordAzils002: raises 450 to 750
Kevin12345Mc: folds 
Uncalled bet (450) returned to LordAzils002
LordAzils002 collected 920 from pot
LordAzils002: doesn't show hand 
*** SUMMARY ***
Total pot 920 | Rake 0 
Seat 1: MrPufies folded before Flop (didn't bet)
Seat 2: zetorrao folded before Flop (didn't bet)
Seat 3: nucho25 (button) folded before Flop (didn't bet)
Seat 4: LordAzils002 (small blind) collected (920)
Seat 5: Kevin12345Mc (big blind) folded before Flop
Seat 6: kloun7 folded before Flop (didn't bet)
Seat 7: D0MAGE folded before Flop (didn't bet)
Seat 8: must59 folded before Flop (didn't bet)



PokerStars Hand #255214218275: Tournament #3863783058, $9.80+$1.20 USD Hold'em No Limit - Level IX (150/300) - 2025/03/09 19:32:51 WET [2025/03/09 15:32:51 ET]
Table '3863783058 225' 8-max Seat #4 is the button
Seat 1: MrPufies (25169 in chips) 
Seat 2: zetorrao (23389 in chips) 
Seat 3: nucho25 (10485 in chips) 
Seat 4: LordAzils002 (17340 in chips) 
Seat 5: Kevin12345Mc (8023 in chips) 
Seat 6: kloun7 (8496 in chips) 
Seat 7: D0MAGE (18352 in chips) 
Seat 8: must59 (8830 in chips) 
MrPufies: posts the ante 40
zetorrao: posts the ante 40
nucho25: posts the ante 40
LordAzils002: posts the ante 40
Kevin12345Mc: posts the ante 40
kloun7: posts the ante 40
D0MAGE: posts the ante 40
must59: posts the ante 40
Kevin12345Mc: posts small blind 150
kloun7: posts big blind 300
*** HOLE CARDS ***
Dealt to Kevin12345Mc [Kd 6c]
D0MAGE: raises 300 to 600
must59: folds 
MrPufies: calls 600
zetorrao: folds 
nucho25: calls 600
LordAzils002: folds 
Kevin12345Mc: folds 
kloun7: folds 
*** FLOP *** [Ad 7d 4h]
D0MAGE: checks 
MrPufies: checks 
nucho25: bets 900
D0MAGE: calls 900
MrPufies: folds 
*** TURN *** [Ad 7d 4h] [Kc]
D0MAGE: checks 
nucho25: bets 2400
D0MAGE: folds 
Uncalled bet (2400) returned to nucho25
nucho25 collected 4370 from pot
nucho25: doesn't show hand 
*** SUMMARY ***
Total pot 4370 | Rake 0 
Board [Ad 7d 4h Kc]
Seat 1: MrPufies folded on the Flop
Seat 2: zetorrao folded before Flop (didn't bet)
Seat 3: nucho25 collected (4370)
Seat 4: LordAzils002 (button) folded before Flop (didn't bet)
Seat 5: Kevin12345Mc (small blind) folded before Flop
Seat 6: kloun7 (big blind) folded before Flop
Seat 7: D0MAGE folded on the Turn
Seat 8: must59 folded before Flop (didn't bet)



PokerStars Hand #255214245808: Tournament #3863783058, $9.80+$1.20 USD Hold'em No Limit - Level IX (150/300) - 2025/03/09 19:34:08 WET [2025/03/09 15:34:08 ET]
Table '3863783058 225' 8-max Seat #5 is the button
Seat 1: MrPufies (24529 in chips) 
Seat 2: zetorrao (23349 in chips) 
Seat 3: nucho25 (13315 in chips) 
Seat 4: LordAzils002 (17300 in chips) 
Seat 5: Kevin12345Mc (7833 in chips) 
Seat 6: kloun7 (8156 in chips) 
Seat 7: D0MAGE (16812 in chips) 
Seat 8: must59 (8790 in chips) 
MrPufies: posts the ante 40
zetorrao: posts the ante 40
nucho25: posts the ante 40
LordAzils002: posts the ante 40
Kevin12345Mc: posts the ante 40
kloun7: posts the ante 40
D0MAGE: posts the ante 40
must59: posts the ante 40
kloun7: posts small blind 150
D0MAGE: posts big blind 300
*** HOLE CARDS ***
Dealt to Kevin12345Mc [Ad 3s]
must59: folds 
MrPufies: folds 
zetorrao: calls 300
nucho25: folds 
LordAzils002: raises 900 to 1200
Kevin12345Mc: folds 
kloun7: folds 
D0MAGE: folds 
zetorrao: folds 
Uncalled bet (900) returned to LordAzils002
LordAzils002 collected 1370 from pot
LordAzils002: doesn't show hand 
*** SUMMARY ***
Total pot 1370 | Rake 0 
Seat 1: MrPufies folded before Flop (didn't bet)
Seat 2: zetorrao folded before Flop
Seat 3: nucho25 folded before Flop (didn't bet)
Seat 4: LordAzils002 collected (1370)
Seat 5: Kevin12345Mc (button) folded before Flop (didn't bet)
Seat 6: kloun7 (small blind) folded before Flop
Seat 7: D0MAGE (big blind) folded before Flop
Seat 8: must59 folded before Flop (didn't bet)



PokerStars Hand #255214265025: Tournament #3863783058, $9.80+$1.20 USD Hold'em No Limit - Level IX (150/300) - 2025/03/09 19:35:02 WET [2025/03/09 15:35:02 ET]
Table '3863783058 225' 8-max Seat #6 is the button
Seat 1: MrPufies (24489 in chips) 
Seat 2: zetorrao (23009 in chips) 
Seat 3: nucho25 (13275 in chips) 
Seat 4: LordAzils002 (18330 in chips) 
Seat 5: Kevin12345Mc (7793 in chips) 
Seat 6: kloun7 (7966 in chips) 
Seat 7: D0MAGE (16472 in chips) 
Seat 8: must59 (8750 in chips) 
MrPufies: posts the ante 40
zetorrao: posts the ante 40
nucho25: posts the ante 40
LordAzils002: posts the ante 40
Kevin12345Mc: posts the ante 40
kloun7: posts the ante 40
D0MAGE: posts the ante 40
must59: posts the ante 40
D0MAGE: posts small blind 150
must59: posts big blind 300
*** HOLE CARDS ***
Dealt to Kevin12345Mc [6s Jc]
MrPufies: raises 300 to 600
zetorrao: folds 
nucho25: folds 
LordAzils002: folds 
Kevin12345Mc: folds 
kloun7: calls 600
D0MAGE: folds 
must59: calls 300
*** FLOP *** [Jd Qd 5c]
must59: checks 
MrPufies: bets 908
kloun7: calls 908
must59: calls 908
*** TURN *** [Jd Qd 5c] [Js]
must59: checks 
MrPufies: checks 
kloun7: checks 
*** RIVER *** [Jd Qd 5c Js] [Qs]
must59: checks 
MrPufies: checks 
kloun7: checks 
*** SHOW DOWN ***
must59: shows [5s 8h] (two pair, Queens and Jacks)
MrPufies: mucks hand 
kloun7: shows [Kd 3d] (two pair, Queens and Jacks - King kicker)
kloun7 collected 4994 from pot
*** SUMMARY ***
Total pot 4994 | Rake 0 
Board [Jd Qd 5c Js Qs]
Seat 1: MrPufies mucked [6c 6h]
Seat 2: zetorrao folded before Flop (didn't bet)
Seat 3: nucho25 folded before Flop (didn't bet)
Seat 4: LordAzils002 folded before Flop (didn't bet)
Seat 5: Kevin12345Mc folded before Flop (didn't bet)
Seat 6: kloun7 (button) showed [Kd 3d] and won (4994) with two pair, Queens and Jacks
Seat 7: D0MAGE (small blind) folded before Flop
Seat 8: must59 (big blind) showed [5s 8h] and lost with two pair, Queens and Jacks



PokerStars Hand #255214292320: Tournament #3863783058, $9.80+$1.20 USD Hold'em No Limit - Level IX (150/300) - 2025/03/09 19:36:18 WET [2025/03/09 15:36:18 ET]
Table '3863783058 225' 8-max Seat #7 is the button
Seat 1: MrPufies (22941 in chips) 
Seat 2: zetorrao (22969 in chips) 
Seat 3: nucho25 (13235 in chips) 
Seat 4: LordAzils002 (18290 in chips) 
Seat 5: Kevin12345Mc (7753 in chips) 
Seat 6: kloun7 (11412 in chips) 
Seat 7: D0MAGE (16282 in chips) 
Seat 8: must59 (7202 in chips) 
MrPufies: posts the ante 40
zetorrao: posts the ante 40
nucho25: posts the ante 40
LordAzils002: posts the ante 40
Kevin12345Mc: posts the ante 40
kloun7: posts the ante 40
D0MAGE: posts the ante 40
must59: posts the ante 40
must59: posts small blind 150
MrPufies: posts big blind 300
*** HOLE CARDS ***
Dealt to Kevin12345Mc [3c 2s]
zetorrao: calls 300
nucho25: folds 
LordAzils002: folds 
Kevin12345Mc: folds 
kloun7: raises 300 to 600
D0MAGE: folds 
must59: folds 
MrPufies: folds 
zetorrao: calls 300
*** FLOP *** [5d Jc 6h]
zetorrao: checks 
kloun7: bets 600
zetorrao: calls 600
*** TURN *** [5d Jc 6h] [7c]
zetorrao: checks 
kloun7: checks 
*** RIVER *** [5d Jc 6h 7c] [Qc]
zetorrao: bets 1585
kloun7: folds 
Uncalled bet (1585) returned to zetorrao
zetorrao collected 3170 from pot
*** SUMMARY ***
Total pot 3170 | Rake 0 
Board [5d Jc 6h 7c Qc]
Seat 1: MrPufies (big blind) folded before Flop
Seat 2: zetorrao collected (3170)
Seat 3: nucho25 folded before Flop (didn't bet)
Seat 4: LordAzils002 folded before Flop (didn't bet)
Seat 5: Kevin12345Mc folded before Flop (didn't bet)
Seat 6: kloun7 folded on the River
Seat 7: D0MAGE (button) folded before Flop (didn't bet)
Seat 8: must59 (small blind) folded before Flop



PokerStars Hand #255214315675: Tournament #3863783058, $9.80+$1.20 USD Hold'em No Limit - Level X (200/400) - 2025/03/09 19:37:23 WET [2025/03/09 15:37:23 ET]
Table '3863783058 225' 8-max Seat #8 is the button
Seat 1: MrPufies (22601 in chips) 
Seat 2: zetorrao (24899 in chips) 
Seat 3: nucho25 (13195 in chips) 
Seat 4: LordAzils002 (18250 in chips) 
Seat 5: Kevin12345Mc (7713 in chips) 
Seat 6: kloun7 (10172 in chips) 
Seat 7: D0MAGE (16242 in chips) 
Seat 8: must59 (7012 in chips) 
MrPufies: posts the ante 50
zetorrao: posts the ante 50
nucho25: posts the ante 50
LordAzils002: posts the ante 50
Kevin12345Mc: posts the ante 50
kloun7: posts the ante 50
D0MAGE: posts the ante 50
must59: posts the ante 50
MrPufies: posts small blind 200
zetorrao: posts big blind 400
*** HOLE CARDS ***
Dealt to Kevin12345Mc [7d Tc]
nucho25: folds 
LordAzils002: folds 
Kevin12345Mc: folds 
kloun7: folds 
D0MAGE: folds 
must59: folds 
MrPufies: folds 
Uncalled bet (200) returned to zetorrao
zetorrao collected 800 from pot
*** SUMMARY ***
Total pot 800 | Rake 0 
Seat 1: MrPufies (small blind) folded before Flop
Seat 2: zetorrao (big blind) collected (800)
Seat 3: nucho25 folded before Flop (didn't bet)
Seat 4: LordAzils002 folded before Flop (didn't bet)
Seat 5: Kevin12345Mc folded before Flop (didn't bet)
Seat 6: kloun7 folded before Flop (didn't bet)
Seat 7: D0MAGE folded before Flop (didn't bet)
Seat 8: must59 (button) folded before Flop (didn't bet)



PokerStars Hand #255214323971: Tournament #3863783058, $9.80+$1.20 USD Hold'em No Limit - Level X (200/400) - 2025/03/09 19:37:46 WET [2025/03/09 15:37:46 ET]
Table '3863783058 225' 8-max Seat #1 is the button
Seat 1: MrPufies (22351 in chips) 
Seat 2: zetorrao (25449 in chips) 
Seat 3: nucho25 (13145 in chips) 
Seat 4: LordAzils002 (18200 in chips) 
Seat 5: Kevin12345Mc (7663 in chips) 
Seat 6: kloun7 (10122 in chips) 
Seat 7: D0MAGE (16192 in chips) 
Seat 8: must59 (6962 in chips) 
MrPufies: posts the ante 50
zetorrao: posts the ante 50
nucho25: posts the ante 50
LordAzils002: posts the ante 50
Kevin12345Mc: posts the ante 50
kloun7: posts the ante 50
D0MAGE: posts the ante 50
must59: posts the ante 50
zetorrao: posts small blind 200
nucho25: posts big blind 400
*** HOLE CARDS ***
Dealt to Kevin12345Mc [8c 2s]
LordAzils002: folds 
Kevin12345Mc: folds 
kloun7: folds 
D0MAGE: folds 
must59: calls 400
MrPufies: raises 800 to 1200
zetorrao: calls 1000
nucho25: folds 
must59: calls 800
*** FLOP *** [Ts 2c Td]
zetorrao: checks 
must59: checks 
MrPufies: bets 1760
zetorrao: folds 
must59: calls 1760
*** TURN *** [Ts 2c Td] [4h]
must59: checks 
MrPufies: bets 5861
must59: calls 3952 and is all-in
Uncalled bet (1909) returned to MrPufies
*** RIVER *** [Ts 2c Td 4h] [7d]
*** SHOW DOWN ***
must59: shows [8h Th] (three of a kind, Tens)
MrPufies: shows [9d 9h] (two pair, Tens and Nines)
must59 collected 15824 from pot
*** SUMMARY ***
Total pot 15824 | Rake 0 
Board [Ts 2c Td 4h 7d]
Seat 1: MrPufies (button) showed [9d 9h] and lost with two pair, Tens and Nines
Seat 2: zetorrao (small blind) folded on the Flop
Seat 3: nucho25 (big blind) folded before Flop
Seat 4: LordAzils002 folded before Flop (didn't bet)
Seat 5: Kevin12345Mc folded before Flop (didn't bet)
Seat 6: kloun7 folded before Flop (didn't bet)
Seat 7: D0MAGE folded before Flop (didn't bet)
Seat 8: must59 showed [8h Th] and won (15824) with three of a kind, Tens



PokerStars Hand #255214351257: Tournament #3863783058, $9.80+$1.20 USD Hold'em No Limit - Level X (200/400) - 2025/03/09 19:39:01 WET [2025/03/09 15:39:01 ET]
Table '3863783058 225' 8-max Seat #2 is the button
Seat 1: MrPufies (15389 in chips) 
Seat 2: zetorrao (24199 in chips) 
Seat 3: nucho25 (12695 in chips) 
Seat 4: LordAzils002 (18150 in chips) 
Seat 5: Kevin12345Mc (7613 in chips) 
Seat 6: kloun7 (10072 in chips) 
Seat 7: D0MAGE (16142 in chips) 
Seat 8: must59 (15824 in chips) 
MrPufies: posts the ante 50
zetorrao: posts the ante 50
nucho25: posts the ante 50
LordAzils002: posts the ante 50
Kevin12345Mc: posts the ante 50
kloun7: posts the ante 50
D0MAGE: posts the ante 50
must59: posts the ante 50
nucho25: posts small blind 200
LordAzils002: posts big blind 400
*** HOLE CARDS ***
Dealt to Kevin12345Mc [4s 5h]
Kevin12345Mc: folds 
kloun7: folds 
D0MAGE: folds 
must59: raises 400 to 800
MrPufies: folds 
zetorrao: folds 
nucho25: folds 
LordAzils002: calls 400
*** FLOP *** [6d Kd 9h]
LordAzils002: checks 
must59: bets 1600
LordAzils002: folds 
Uncalled bet (1600) returned to must59
must59 collected 2200 from pot
must59: doesn't show hand 
*** SUMMARY ***
Total pot 2200 | Rake 0 
Board [6d Kd 9h]
Seat 1: MrPufies folded before Flop (didn't bet)
Seat 2: zetorrao (button) folded before Flop (didn't bet)
Seat 3: nucho25 (small blind) folded before Flop
Seat 4: LordAzils002 (big blind) folded on the Flop
Seat 5: Kevin12345Mc folded before Flop (didn't bet)
Seat 6: kloun7 folded before Flop (didn't bet)
Seat 7: D0MAGE folded before Flop (didn't bet)
Seat 8: must59 collected (2200)



PokerStars Hand #255214373650: Tournament #3863783058, $9.80+$1.20 USD Hold'em No Limit - Level X (200/400) - 2025/03/09 19:40:04 WET [2025/03/09 15:40:04 ET]
Table '3863783058 225' 8-max Seat #3 is the button
Seat 1: MrPufies (15339 in chips) 
Seat 2: zetorrao (24149 in chips) 
Seat 3: nucho25 (12445 in chips) 
Seat 4: LordAzils002 (17300 in chips) 
Seat 5: Kevin12345Mc (7563 in chips) 
Seat 6: kloun7 (10022 in chips) 
Seat 7: D0MAGE (16092 in chips) 
Seat 8: must59 (17174 in chips) 
MrPufies: posts the ante 50
zetorrao: posts the ante 50
nucho25: posts the ante 50
LordAzils002: posts the ante 50
Kevin12345Mc: posts the ante 50
kloun7: posts the ante 50
D0MAGE: posts the ante 50
must59: posts the ante 50
LordAzils002: posts small blind 200
Kevin12345Mc: posts big blind 400
*** HOLE CARDS ***
Dealt to Kevin12345Mc [Ts Ks]
kloun7: folds 
D0MAGE: folds 
must59: folds 
MrPufies: raises 400 to 800
zetorrao: folds 
nucho25: folds 
LordAzils002: raises 2000 to 2800
Kevin12345Mc: folds 
MrPufies: calls 2000
*** FLOP *** [3h Jh 6c]
LordAzils002: bets 2112
MrPufies: raises 10377 to 12489 and is all-in
LordAzils002: folds 
Uncalled bet (10377) returned to MrPufies
MrPufies collected 10624 from pot
MrPufies: doesn't show hand 
*** SUMMARY ***
Total pot 10624 | Rake 0 
Board [3h Jh 6c]
Seat 1: MrPufies collected (10624)
Seat 2: zetorrao folded before Flop (didn't bet)
Seat 3: nucho25 (button) folded before Flop (didn't bet)
Seat 4: LordAzils002 (small blind) folded on the Flop
Seat 5: Kevin12345Mc (big blind) folded before Flop
Seat 6: kloun7 folded before Flop (didn't bet)
Seat 7: D0MAGE folded before Flop (didn't bet)
Seat 8: must59 folded before Flop (didn't bet)



PokerStars Hand #255214398143: Tournament #3863783058, $9.80+$1.20 USD Hold'em No Limit - Level X (200/400) - 2025/03/09 19:41:12 WET [2025/03/09 15:41:12 ET]
Table '3863783058 225' 8-max Seat #4 is the button
Seat 1: MrPufies (21001 in chips) 
Seat 2: zetorrao (24099 in chips) 
Seat 3: nucho25 (12395 in chips) 
Seat 4: LordAzils002 (12338 in chips) 
Seat 5: Kevin12345Mc (7113 in chips) 
Seat 6: kloun7 (9972 in chips) 
Seat 7: D0MAGE (16042 in chips) 
Seat 8: must59 (17124 in chips) 
MrPufies: posts the ante 50
zetorrao: posts the ante 50
nucho25: posts the ante 50
LordAzils002: posts the ante 50
Kevin12345Mc: posts the ante 50
kloun7: posts the ante 50
D0MAGE: posts the ante 50
must59: posts the ante 50
Kevin12345Mc: posts small blind 200
kloun7: posts big blind 400
*** HOLE CARDS ***
Dealt to Kevin12345Mc [6d As]
D0MAGE: raises 400 to 800
must59: calls 800
MrPufies: calls 800
zetorrao: folds 
nucho25: folds 
LordAzils002: folds 
Kevin12345Mc: folds 
kloun7: calls 400
*** FLOP *** [Tc Td 2h]
kloun7: checks 
D0MAGE: bets 950
must59: folds 
MrPufies: folds 
kloun7: calls 950
*** TURN *** [Tc Td 2h] [8h]
kloun7: checks 
D0MAGE: bets 1625
kloun7: calls 1625
*** RIVER *** [Tc Td 2h 8h] [9h]
kloun7: bets 1600
D0MAGE: raises 11017 to 12617 and is all-in
kloun7: calls 4947 and is all-in
Uncalled bet (6070) returned to D0MAGE
*** SHOW DOWN ***
D0MAGE: shows [9d 9s] (a full house, Nines full of Tens)
kloun7: shows [8s 8c] (a full house, Eights full of Tens)
D0MAGE collected 22044 from pot
kloun7 finished the tournament
*** SUMMARY ***
Total pot 22044 | Rake 0 
Board [Tc Td 2h 8h 9h]
Seat 1: MrPufies folded on the Flop
Seat 2: zetorrao folded before Flop (didn't bet)
Seat 3: nucho25 folded before Flop (didn't bet)
Seat 4: LordAzils002 (button) folded before Flop (didn't bet)
Seat 5: Kevin12345Mc (small blind) folded before Flop
Seat 6: kloun7 (big blind) showed [8s 8c] and lost with a full house, Eights full of Tens
Seat 7: D0MAGE showed [9d 9s] and won (22044) with a full house, Nines full of Tens
Seat 8: must59 folded on the Flop



PokerStars Hand #255214444409: Tournament #3863783058, $9.80+$1.20 USD Hold'em No Limit - Level X (200/400) - 2025/03/09 19:43:21 WET [2025/03/09 15:43:21 ET]
Table '3863783058 225' 8-max Seat #5 is the button
Seat 1: MrPufies (20151 in chips) 
Seat 2: zetorrao (24049 in chips) 
Seat 3: nucho25 (12345 in chips) 
Seat 4: LordAzils002 (12288 in chips) 
Seat 5: Kevin12345Mc (6863 in chips) 
Seat 7: D0MAGE (28114 in chips) 
Seat 8: must59 (16274 in chips) 
MrPufies: posts the ante 50
zetorrao: posts the ante 50
nucho25: posts the ante 50
LordAzils002: posts the ante 50
Kevin12345Mc: posts the ante 50
D0MAGE: posts the ante 50
must59: posts the ante 50
D0MAGE: posts small blind 200
must59: posts big blind 400
*** HOLE CARDS ***
Dealt to Kevin12345Mc [Ad Ah]
MrPufies: folds 
jhonsounAA is disconnected 
zetorrao: calls 400
nucho25: folds 
LordAzils002: folds 
Kevin12345Mc: raises 400 to 800
D0MAGE: folds 
must59: calls 400
zetorrao: calls 400
*** FLOP *** [6s 9c Tc]
must59: checks 
zetorrao: checks 
Kevin12345Mc: bets 974
must59: folds 
zetorrao: calls 974
*** TURN *** [6s 9c Tc] [7c]
zetorrao: checks 
Kevin12345Mc: bets 5039 and is all-in
zetorrao: calls 5039
*** RIVER *** [6s 9c Tc 7c] [Kh]
*** SHOW DOWN ***
zetorrao: shows [Jh Ac] (high card Ace)
Kevin12345Mc: shows [Ad Ah] (a pair of Aces)
Kevin12345Mc collected 14976 from pot
*** SUMMARY ***
Total pot 14976 | Rake 0 
Board [6s 9c Tc 7c Kh]
Seat 1: MrPufies folded before Flop (didn't bet)
Seat 2: zetorrao showed [Jh Ac] and lost with high card Ace
Seat 3: nucho25 folded before Flop (didn't bet)
Seat 4: LordAzils002 folded before Flop (didn't bet)
Seat 5: Kevin12345Mc (button) showed [Ad Ah] and won (14976) with a pair of Aces
Seat 7: D0MAGE (small blind) folded before Flop
Seat 8: must59 (big blind) folded on the Flop



PokerStars Hand #255214469908: Tournament #3863783058, $9.80+$1.20 USD Hold'em No Limit - Level X (200/400) - 2025/03/09 19:44:33 WET [2025/03/09 15:44:33 ET]
Table '3863783058 225' 8-max Seat #7 is the button
Seat 1: MrPufies (20101 in chips) 
Seat 2: zetorrao (17186 in chips) 
Seat 3: nucho25 (12295 in chips) 
Seat 4: LordAzils002 (12238 in chips) 
Seat 5: Kevin12345Mc (14976 in chips) 
Seat 6: jhonsounAA (10000 in chips) 
Seat 7: D0MAGE (27864 in chips) 
Seat 8: must59 (15424 in chips) 
MrPufies: posts the ante 50
zetorrao: posts the ante 50
nucho25: posts the ante 50
LordAzils002: posts the ante 50
Kevin12345Mc: posts the ante 50
jhonsounAA: posts the ante 50
D0MAGE: posts the ante 50
must59: posts the ante 50
must59: posts small blind 200
MrPufies: posts big blind 400
*** HOLE CARDS ***
Dealt to Kevin12345Mc [7d 8h]
zetorrao: folds 
nucho25: folds 
LordAzils002: folds 
Kevin12345Mc: folds 
jhonsounAA: raises 400 to 800
D0MAGE: calls 800
must59: calls 600
MrPufies: calls 400
*** FLOP *** [3s Td 8d]
must59: checks 
MrPufies: checks 
jhonsounAA: checks 
D0MAGE: checks 
*** TURN *** [3s Td 8d] [Kd]
must59: checks 
MrPufies: bets 1440
jhonsounAA: folds 
D0MAGE: folds 
must59: calls 1440
*** RIVER *** [3s Td 8d Kd] [8c]
must59: checks 
MrPufies: checks 
*** SHOW DOWN ***
must59: shows [Ad 7s] (a pair of Eights)
MrPufies: shows [Kc 5s] (two pair, Kings and Eights)
MrPufies collected 6480 from pot
*** SUMMARY ***
Total pot 6480 | Rake 0 
Board [3s Td 8d Kd 8c]
Seat 1: MrPufies (big blind) showed [Kc 5s] and won (6480) with two pair, Kings and Eights
Seat 2: zetorrao folded before Flop (didn't bet)
Seat 3: nucho25 folded before Flop (didn't bet)
Seat 4: LordAzils002 folded before Flop (didn't bet)
Seat 5: Kevin12345Mc folded before Flop (didn't bet)
Seat 6: jhonsounAA folded on the Turn
Seat 7: D0MAGE (button) folded on the Turn
Seat 8: must59 (small blind) showed [Ad 7s] and lost with a pair of Eights



PokerStars Hand #255214498841: Tournament #3863783058, $9.80+$1.20 USD Hold'em No Limit - Level X (200/400) - 2025/03/09 19:45:54 WET [2025/03/09 15:45:54 ET]
Table '3863783058 225' 8-max Seat #8 is the button
Seat 1: MrPufies (24291 in chips) 
Seat 2: zetorrao (17136 in chips) 
Seat 3: nucho25 (12245 in chips) 
Seat 4: LordAzils002 (12188 in chips) 
Seat 5: Kevin12345Mc (14926 in chips) 
Seat 6: jhonsounAA (9150 in chips) 
Seat 7: D0MAGE (27014 in chips) 
Seat 8: must59 (13134 in chips) 
MrPufies: posts the ante 50
zetorrao: posts the ante 50
nucho25: posts the ante 50
LordAzils002: posts the ante 50
Kevin12345Mc: posts the ante 50
jhonsounAA: posts the ante 50
D0MAGE: posts the ante 50
must59: posts the ante 50
MrPufies: posts small blind 200
zetorrao: posts big blind 400
*** HOLE CARDS ***
Dealt to Kevin12345Mc [Jd 6h]
nucho25: folds 
LordAzils002: folds 
Kevin12345Mc: folds 
jhonsounAA: folds 
D0MAGE: folds 
must59: raises 400 to 800
MrPufies: calls 600
zetorrao: folds 
*** FLOP *** [Th 3c 2c]
MrPufies: checks 
must59: bets 2000
MrPufies: calls 2000
*** TURN *** [Th 3c 2c] [9s]
MrPufies: checks 
must59: bets 10284 and is all-in
MrPufies: folds 
Uncalled bet (10284) returned to must59
must59 collected 6400 from pot
must59: doesn't show hand 
*** SUMMARY ***
Total pot 6400 | Rake 0 
Board [Th 3c 2c 9s]
Seat 1: MrPufies (small blind) folded on the Turn
Seat 2: zetorrao (big blind) folded before Flop
Seat 3: nucho25 folded before Flop (didn't bet)
Seat 4: LordAzils002 folded before Flop (didn't bet)
Seat 5: Kevin12345Mc folded before Flop (didn't bet)
Seat 6: jhonsounAA folded before Flop (didn't bet)
Seat 7: D0MAGE folded before Flop (didn't bet)
Seat 8: must59 (button) collected (6400)



PokerStars Hand #255214525762: Tournament #3863783058, $9.80+$1.20 USD Hold'em No Limit - Level X (200/400) - 2025/03/09 19:47:09 WET [2025/03/09 15:47:09 ET]
Table '3863783058 225' 8-max Seat #1 is the button
Seat 1: MrPufies (21441 in chips) 
Seat 2: zetorrao (16686 in chips) 
Seat 3: nucho25 (12195 in chips) 
Seat 4: LordAzils002 (12138 in chips) 
Seat 5: Kevin12345Mc (14876 in chips) 
Seat 6: jhonsounAA (9100 in chips) 
Seat 7: D0MAGE (26964 in chips) 
Seat 8: must59 (16684 in chips) 
MrPufies: posts the ante 50
zetorrao: posts the ante 50
nucho25: posts the ante 50
LordAzils002: posts the ante 50
Kevin12345Mc: posts the ante 50
jhonsounAA: posts the ante 50
D0MAGE: posts the ante 50
must59: posts the ante 50
zetorrao: posts small blind 200
nucho25: posts big blind 400
*** HOLE CARDS ***
Dealt to Kevin12345Mc [7s Qs]
LordAzils002: folds 
Kevin12345Mc: folds 
jhonsounAA: folds 
D0MAGE: folds 
must59: folds 
MrPufies: raises 400 to 800
zetorrao: calls 600
nucho25: calls 400
*** FLOP *** [5h Ad Jc]
zetorrao: checks 
nucho25: checks 
MrPufies: bets 1120
zetorrao: folds 
nucho25: folds 
Uncalled bet (1120) returned to MrPufies
MrPufies collected 2800 from pot
MrPufies: doesn't show hand 
*** SUMMARY ***
Total pot 2800 | Rake 0 
Board [5h Ad Jc]
Seat 1: MrPufies (button) collected (2800)
Seat 2: zetorrao (small blind) folded on the Flop
Seat 3: nucho25 (big blind) folded on the Flop
Seat 4: LordAzils002 folded before Flop (didn't bet)
Seat 5: Kevin12345Mc folded before Flop (didn't bet)
Seat 6: jhonsounAA folded before Flop (didn't bet)
Seat 7: D0MAGE folded before Flop (didn't bet)
Seat 8: must59 folded before Flop (didn't bet)



PokerStars Hand #255214546697: Tournament #3863783058, $9.80+$1.20 USD Hold'em No Limit - Level XI (250/500) - 2025/03/09 19:48:08 WET [2025/03/09 15:48:08 ET]
Table '3863783058 225' 8-max Seat #2 is the button
Seat 1: MrPufies (23391 in chips) 
Seat 2: zetorrao (15836 in chips) 
Seat 3: nucho25 (11345 in chips) 
Seat 4: LordAzils002 (12088 in chips) 
Seat 5: Kevin12345Mc (14826 in chips) 
Seat 6: jhonsounAA (9050 in chips) 
Seat 7: D0MAGE (26914 in chips) 
Seat 8: must59 (16634 in chips) 
MrPufies: posts the ante 60
zetorrao: posts the ante 60
nucho25: posts the ante 60
LordAzils002: posts the ante 60
Kevin12345Mc: posts the ante 60
jhonsounAA: posts the ante 60
D0MAGE: posts the ante 60
must59: posts the ante 60
nucho25: posts small blind 250
LordAzils002: posts big blind 500
*** HOLE CARDS ***
Dealt to Kevin12345Mc [Qh Qs]
Kevin12345Mc: raises 550 to 1050
jhonsounAA: folds 
D0MAGE: folds 
must59: folds 
MrPufies: calls 1050
zetorrao: folds 
nucho25: folds 
LordAzils002: calls 550
*** FLOP *** [Ad 3c 8c]
LordAzils002: checks 
Kevin12345Mc: bets 1280
MrPufies: folds 
LordAzils002: calls 1280
*** TURN *** [Ad 3c 8c] [5h]
LordAzils002: checks 
Kevin12345Mc: checks 
*** RIVER *** [Ad 3c 8c 5h] [Jh]
LordAzils002: bets 2125
Kevin12345Mc: calls 2125
*** SHOW DOWN ***
LordAzils002: shows [Ac 6h] (a pair of Aces)
Kevin12345Mc: mucks hand 
LordAzils002 collected 10690 from pot
*** SUMMARY ***
Total pot 10690 | Rake 0 
Board [Ad 3c 8c 5h Jh]
Seat 1: MrPufies folded on the Flop
Seat 2: zetorrao (button) folded before Flop (didn't bet)
Seat 3: nucho25 (small blind) folded before Flop
Seat 4: LordAzils002 (big blind) showed [Ac 6h] and won (10690) with a pair of Aces
Seat 5: Kevin12345Mc mucked [Qh Qs]
Seat 6: jhonsounAA folded before Flop (didn't bet)
Seat 7: D0MAGE folded before Flop (didn't bet)
Seat 8: must59 folded before Flop (didn't bet)



PokerStars Hand #255214567539: Tournament #3863783058, $9.80+$1.20 USD Hold'em No Limit - Level XI (250/500) - 2025/03/09 19:49:06 WET [2025/03/09 15:49:06 ET]
Table '3863783058 225' 8-max Seat #3 is the button
Seat 1: MrPufies (22281 in chips) 
Seat 2: zetorrao (15776 in chips) 
Seat 3: nucho25 (11035 in chips) 
Seat 4: LordAzils002 (18263 in chips) 
Seat 5: Kevin12345Mc (10311 in chips) 
Seat 6: jhonsounAA (8990 in chips) 
Seat 7: D0MAGE (26854 in chips) 
Seat 8: must59 (16574 in chips) 
MrPufies: posts the ante 60
zetorrao: posts the ante 60
nucho25: posts the ante 60
LordAzils002: posts the ante 60
Kevin12345Mc: posts the ante 60
jhonsounAA: posts the ante 60
D0MAGE: posts the ante 60
must59: posts the ante 60
LordAzils002: posts small blind 250
Kevin12345Mc: posts big blind 500
*** HOLE CARDS ***
Dealt to Kevin12345Mc [Kh Jh]
jhonsounAA: raises 8430 to 8930 and is all-in
D0MAGE: raises 17864 to 26794 and is all-in
must59: folds 
MrPufies: folds 
zetorrao: folds 
nucho25: folds 
LordAzils002: folds 
Kevin12345Mc: folds 
Uncalled bet (17864) returned to D0MAGE
*** FLOP *** [Tc 3c 9h]
*** TURN *** [Tc 3c 9h] [Qh]
*** RIVER *** [Tc 3c 9h Qh] [3d]
*** SHOW DOWN ***
jhonsounAA: shows [Ac 4h] (a pair of Threes)
D0MAGE: shows [Kc Ad] (a pair of Threes - Ace+King kicker)
D0MAGE collected 19090 from pot
jhonsounAA finished the tournament
*** SUMMARY ***
Total pot 19090 | Rake 0 
Board [Tc 3c 9h Qh 3d]
Seat 1: MrPufies folded before Flop (didn't bet)
Seat 2: zetorrao folded before Flop (didn't bet)
Seat 3: nucho25 (button) folded before Flop (didn't bet)
Seat 4: LordAzils002 (small blind) folded before Flop
Seat 5: Kevin12345Mc (big blind) folded before Flop
Seat 6: jhonsounAA showed [Ac 4h] and lost with a pair of Threes
Seat 7: D0MAGE showed [Kc Ad] and won (19090) with a pair of Threes
Seat 8: must59 folded before Flop (didn't bet)



PokerStars Hand #255214586500: Tournament #3863783058, $9.80+$1.20 USD Hold'em No Limit - Level XI (250/500) - 2025/03/09 19:50:00 WET [2025/03/09 15:50:00 ET]
Table '3863783058 225' 8-max Seat #4 is the button
Seat 1: MrPufies (22221 in chips) 
Seat 2: zetorrao (15716 in chips) 
Seat 3: nucho25 (10975 in chips) 
Seat 4: LordAzils002 (17953 in chips) 
Seat 5: Kevin12345Mc (9751 in chips) 
Seat 7: D0MAGE (36954 in chips) 
Seat 8: must59 (16514 in chips) 
MrPufies: posts the ante 60
zetorrao: posts the ante 60
nucho25: posts the ante 60
LordAzils002: posts the ante 60
Kevin12345Mc: posts the ante 60
D0MAGE: posts the ante 60
must59: posts the ante 60
Kevin12345Mc: posts small blind 250
D0MAGE: posts big blind 500
*** HOLE CARDS ***
Dealt to Kevin12345Mc [Qd 4c]
must59: folds 
$ampaioBruno is disconnected 
MrPufies: raises 500 to 1000
zetorrao: folds 
nucho25: folds 
LordAzils002: folds 
Kevin12345Mc: folds 
D0MAGE: calls 500
*** FLOP *** [Jh Ac 7d]
D0MAGE: checks 
MrPufies: bets 1068
D0MAGE: calls 1068
*** TURN *** [Jh Ac 7d] [7c]
D0MAGE: checks 
MrPufies: bets 1922
D0MAGE: calls 1922
*** RIVER *** [Jh Ac 7d 7c] [8h]
D0MAGE: checks 
MrPufies: checks 
*** SHOW DOWN ***
D0MAGE: shows [Jd Th] (two pair, Jacks and Sevens)
MrPufies: mucks hand 
D0MAGE collected 8650 from pot
*** SUMMARY ***
Total pot 8650 | Rake 0 
Board [Jh Ac 7d 7c 8h]
Seat 1: MrPufies mucked [5s 5d]
Seat 2: zetorrao folded before Flop (didn't bet)
Seat 3: nucho25 folded before Flop (didn't bet)
Seat 4: LordAzils002 (button) folded before Flop (didn't bet)
Seat 5: Kevin12345Mc (small blind) folded before Flop
Seat 7: D0MAGE (big blind) showed [Jd Th] and won (8650) with two pair, Jacks and Sevens
Seat 8: must59 folded before Flop (didn't bet)



PokerStars Hand #255214617167: Tournament #3863783058, $9.80+$1.20 USD Hold'em No Limit - Level XI (250/500) - 2025/03/09 19:51:26 WET [2025/03/09 15:51:26 ET]
Table '3863783058 225' 8-max Seat #5 is the button
Seat 1: MrPufies (18171 in chips) 
Seat 2: zetorrao (15656 in chips) 
Seat 3: nucho25 (10915 in chips) 
Seat 4: LordAzils002 (17893 in chips) 
Seat 5: Kevin12345Mc (9441 in chips) 
Seat 6: $ampaioBruno (10000 in chips) out of hand (moved from another table into small blind)
Seat 7: D0MAGE (41554 in chips) 
Seat 8: must59 (16454 in chips) 
$ampaioBruno will be allowed to play after the button
MrPufies: posts the ante 60
zetorrao: posts the ante 60
nucho25: posts the ante 60
LordAzils002: posts the ante 60
Kevin12345Mc: posts the ante 60
D0MAGE: posts the ante 60
must59: posts the ante 60
D0MAGE: posts small blind 250
must59: posts big blind 500
*** HOLE CARDS ***
Dealt to Kevin12345Mc [Qd 3c]
MrPufies: folds 
zetorrao: folds 
nucho25: folds 
LordAzils002: raises 500 to 1000
Kevin12345Mc: folds 
D0MAGE: folds 
must59: folds 
Uncalled bet (500) returned to LordAzils002
LordAzils002 collected 1670 from pot
LordAzils002: doesn't show hand 
*** SUMMARY ***
Total pot 1670 | Rake 0 
Seat 1: MrPufies folded before Flop (didn't bet)
Seat 2: zetorrao folded before Flop (didn't bet)
Seat 3: nucho25 folded before Flop (didn't bet)
Seat 4: LordAzils002 collected (1670)
Seat 5: Kevin12345Mc (button) folded before Flop (didn't bet)
Seat 7: D0MAGE (small blind) folded before Flop
Seat 8: must59 (big blind) folded before Flop



PokerStars Hand #255214628156: Tournament #3863783058, $9.80+$1.20 USD Hold'em No Limit - Level XI (250/500) - 2025/03/09 19:51:57 WET [2025/03/09 15:51:57 ET]
Table '3863783058 225' 8-max Seat #7 is the button
Seat 1: MrPufies (18111 in chips) 
Seat 2: zetorrao (15596 in chips) 
Seat 3: nucho25 (10855 in chips) 
Seat 4: LordAzils002 (19003 in chips) 
Seat 5: Kevin12345Mc (9381 in chips) 
Seat 6: $ampaioBruno (10000 in chips) 
Seat 7: D0MAGE (41244 in chips) 
Seat 8: must59 (15894 in chips) 
MrPufies: posts the ante 60
zetorrao: posts the ante 60
nucho25: posts the ante 60
LordAzils002: posts the ante 60
Kevin12345Mc: posts the ante 60
$ampaioBruno: posts the ante 60
D0MAGE: posts the ante 60
must59: posts the ante 60
must59: posts small blind 250
MrPufies: posts big blind 500
*** HOLE CARDS ***
Dealt to Kevin12345Mc [6s 9d]
zetorrao: folds 
nucho25: raises 500 to 1000
LordAzils002: folds 
Kevin12345Mc: folds 
$ampaioBruno: folds 
D0MAGE: folds 
must59: folds 
MrPufies: raises 2500 to 3500
nucho25: calls 2500
*** FLOP *** [6c 5d 7c]
MrPufies: bets 11131
nucho25: calls 7295 and is all-in
Uncalled bet (3836) returned to MrPufies
*** TURN *** [6c 5d 7c] [5s]
*** RIVER *** [6c 5d 7c 5s] [5c]
*** SHOW DOWN ***
MrPufies: shows [As Ad] (a full house, Fives full of Aces)
nucho25: shows [Kc 9c] (a flush, King high)
MrPufies collected 22320 from pot
nucho25 finished the tournament
*** SUMMARY ***
Total pot 22320 | Rake 0 
Board [6c 5d 7c 5s 5c]
Seat 1: MrPufies (big blind) showed [As Ad] and won (22320) with a full house, Fives full of Aces
Seat 2: zetorrao folded before Flop (didn't bet)
Seat 3: nucho25 showed [Kc 9c] and lost with a flush, King high
Seat 4: LordAzils002 folded before Flop (didn't bet)
Seat 5: Kevin12345Mc folded before Flop (didn't bet)
Seat 6: $ampaioBruno folded before Flop (didn't bet)
Seat 7: D0MAGE (button) folded before Flop (didn't bet)
Seat 8: must59 (small blind) folded before Flop



PokerStars Hand #255214644981: Tournament #3863783058, $9.80+$1.20 USD Hold'em No Limit - Level XI (250/500) - 2025/03/09 19:52:44 WET [2025/03/09 15:52:44 ET]
Table '3863783058 225' 8-max Seat #8 is the button
Seat 1: MrPufies (29576 in chips) 
Seat 2: zetorrao (15536 in chips) 
Seat 4: LordAzils002 (18943 in chips) 
Seat 5: Kevin12345Mc (9321 in chips) 
Seat 6: $ampaioBruno (9940 in chips) 
Seat 7: D0MAGE (41184 in chips) 
Seat 8: must59 (15584 in chips) 
MrPufies: posts the ante 60
zetorrao: posts the ante 60
LordAzils002: posts the ante 60
Kevin12345Mc: posts the ante 60
$ampaioBruno: posts the ante 60
D0MAGE: posts the ante 60
must59: posts the ante 60
MrPufies: posts small blind 250
zetorrao: posts big blind 500
*** HOLE CARDS ***
Dealt to Kevin12345Mc [6d Qh]
LordAzils002: folds 
Kevin12345Mc: folds 
onlydrunkreg is disconnected 
$ampaioBruno: folds 
D0MAGE: folds 
must59: folds 
MrPufies: raises 1500 to 2000
zetorrao: folds 
Uncalled bet (1500) returned to MrPufies
MrPufies collected 1420 from pot
MrPufies: doesn't show hand 
*** SUMMARY ***
Total pot 1420 | Rake 0 
Seat 1: MrPufies (small blind) collected (1420)
Seat 2: zetorrao (big blind) folded before Flop
Seat 4: LordAzils002 folded before Flop (didn't bet)
Seat 5: Kevin12345Mc folded before Flop (didn't bet)
Seat 6: $ampaioBruno folded before Flop (didn't bet)
Seat 7: D0MAGE folded before Flop (didn't bet)
Seat 8: must59 (button) folded before Flop (didn't bet)



PokerStars Hand #255214654130: Tournament #3863783058, $9.80+$1.20 USD Hold'em No Limit - Level XI (250/500) - 2025/03/09 19:53:10 WET [2025/03/09 15:53:10 ET]
Table '3863783058 225' 8-max Seat #1 is the button
Seat 1: MrPufies (30436 in chips) 
Seat 2: zetorrao (14976 in chips) 
Seat 3: onlydrunkreg (10000 in chips) 
Seat 4: LordAzils002 (18883 in chips) 
Seat 5: Kevin12345Mc (9261 in chips) 
Seat 6: $ampaioBruno (9880 in chips) 
Seat 7: D0MAGE (41124 in chips) 
Seat 8: must59 (15524 in chips) 
MrPufies: posts the ante 60
zetorrao: posts the ante 60
onlydrunkreg: posts the ante 60
LordAzils002: posts the ante 60
Kevin12345Mc: posts the ante 60
$ampaioBruno: posts the ante 60
D0MAGE: posts the ante 60
must59: posts the ante 60
zetorrao: posts small blind 250
onlydrunkreg: posts big blind 500
*** HOLE CARDS ***
Dealt to Kevin12345Mc [Qs 7c]
LordAzils002: folds 
Kevin12345Mc: folds 
$ampaioBruno: folds 
D0MAGE: folds 
must59: folds 
MrPufies: folds 
zetorrao: calls 250
onlydrunkreg: checks 
*** FLOP *** [As 2d 4d]
zetorrao: checks 
onlydrunkreg: checks 
*** TURN *** [As 2d 4d] [Tc]
zetorrao: checks 
onlydrunkreg: checks 
*** RIVER *** [As 2d 4d Tc] [Ks]
zetorrao: checks 
onlydrunkreg: checks 
*** SHOW DOWN ***
zetorrao: shows [5h 6c] (high card Ace)
onlydrunkreg: shows [Js 8d] (high card Ace - King+Jack kicker)
onlydrunkreg collected 1480 from pot
*** SUMMARY ***
Total pot 1480 | Rake 0 
Board [As 2d 4d Tc Ks]
Seat 1: MrPufies (button) folded before Flop (didn't bet)
Seat 2: zetorrao (small blind) showed [5h 6c] and lost with high card Ace
Seat 3: onlydrunkreg (big blind) showed [Js 8d] and won (1480) with high card Ace
Seat 4: LordAzils002 folded before Flop (didn't bet)
Seat 5: Kevin12345Mc folded before Flop (didn't bet)
Seat 6: $ampaioBruno folded before Flop (didn't bet)
Seat 7: D0MAGE folded before Flop (didn't bet)
Seat 8: must59 folded before Flop (didn't bet)



PokerStars Hand #255214671349: Tournament #3863783058, $9.80+$1.20 USD Hold'em No Limit - Level XI (250/500) - 2025/03/09 19:53:59 WET [2025/03/09 15:53:59 ET]
Table '3863783058 225' 8-max Seat #2 is the button
Seat 1: MrPufies (30376 in chips) 
Seat 2: zetorrao (14416 in chips) 
Seat 3: onlydrunkreg (10920 in chips) 
Seat 4: LordAzils002 (18823 in chips) 
Seat 5: Kevin12345Mc (9201 in chips) 
Seat 6: $ampaioBruno (9820 in chips) 
Seat 7: D0MAGE (41064 in chips) 
Seat 8: must59 (15464 in chips) 
MrPufies: posts the ante 60
zetorrao: posts the ante 60
onlydrunkreg: posts the ante 60
LordAzils002: posts the ante 60
Kevin12345Mc: posts the ante 60
$ampaioBruno: posts the ante 60
D0MAGE: posts the ante 60
must59: posts the ante 60
onlydrunkreg: posts small blind 250
LordAzils002: posts big blind 500
*** HOLE CARDS ***
Dealt to Kevin12345Mc [3h 7c]
Kevin12345Mc: folds 
$ampaioBruno: folds 
D0MAGE: folds 
must59: raises 500 to 1000
MrPufies: calls 1000
zetorrao: folds 
onlydrunkreg: folds 
LordAzils002: folds 
*** FLOP *** [Ac Kd 8s]
must59: checks 
MrPufies: checks 
*** TURN *** [Ac Kd 8s] [6s]
must59: bets 2000
MrPufies: calls 2000
*** RIVER *** [Ac Kd 8s 6s] [Jc]
must59: bets 5000
MrPufies: calls 5000
*** SHOW DOWN ***
must59: shows [Tc Qh] (a straight, Ten to Ace)
MrPufies: mucks hand 
must59 collected 17230 from pot
*** SUMMARY ***
Total pot 17230 | Rake 0 
Board [Ac Kd 8s 6s Jc]
Seat 1: MrPufies mucked [4c Ad]
Seat 2: zetorrao (button) folded before Flop (didn't bet)
Seat 3: onlydrunkreg (small blind) folded before Flop
Seat 4: LordAzils002 (big blind) folded before Flop
Seat 5: Kevin12345Mc folded before Flop (didn't bet)
Seat 6: $ampaioBruno folded before Flop (didn't bet)
Seat 7: D0MAGE folded before Flop (didn't bet)
Seat 8: must59 showed [Tc Qh] and won (17230) with a straight, Ten to Ace



PokerStars Hand #255214794431: Tournament #3863783058, $9.80+$1.20 USD Hold'em No Limit - Level XI (250/500) - 2025/03/09 20:02:18 WET [2025/03/09 16:02:18 ET]
Table '3863783058 225' 8-max Seat #3 is the button
Seat 1: MrPufies (22316 in chips) 
Seat 2: zetorrao (14356 in chips) 
Seat 3: onlydrunkreg (10610 in chips) 
Seat 4: LordAzils002 (18263 in chips) 
Seat 5: Kevin12345Mc (9141 in chips) 
Seat 6: $ampaioBruno (9760 in chips) 
Seat 7: D0MAGE (41004 in chips) 
Seat 8: must59 (24634 in chips) 
MrPufies: posts the ante 60
zetorrao: posts the ante 60
onlydrunkreg: posts the ante 60
LordAzils002: posts the ante 60
Kevin12345Mc: posts the ante 60
$ampaioBruno: posts the ante 60
D0MAGE: posts the ante 60
must59: posts the ante 60
LordAzils002: posts small blind 250
Kevin12345Mc: posts big blind 500
*** HOLE CARDS ***
Dealt to Kevin12345Mc [7c 8h]
$ampaioBruno: folds 
D0MAGE: folds 
must59: folds 
MrPufies: folds 
zetorrao: calls 500
onlydrunkreg: folds 
LordAzils002: calls 250
Kevin12345Mc: checks 
*** FLOP *** [4c 3c Kc]
LordAzils002: checks 
Kevin12345Mc: checks 
zetorrao: checks 
*** TURN *** [4c 3c Kc] [9c]
LordAzils002: checks 
Kevin12345Mc: checks 
zetorrao: checks 
*** RIVER *** [4c 3c Kc 9c] [Qs]
LordAzils002: bets 1307
Kevin12345Mc: calls 1307
zetorrao: folds 
*** SHOW DOWN ***
LordAzils002: shows [Tc 8d] (a flush, King high)
Kevin12345Mc: mucks hand 
LordAzils002 collected 4594 from pot
*** SUMMARY ***
Total pot 4594 | Rake 0 
Board [4c 3c Kc 9c Qs]
Seat 1: MrPufies folded before Flop (didn't bet)
Seat 2: zetorrao folded on the River
Seat 3: onlydrunkreg (button) folded before Flop (didn't bet)
Seat 4: LordAzils002 (small blind) showed [Tc 8d] and won (4594) with a flush, King high
Seat 5: Kevin12345Mc (big blind) mucked [7c 8h]
Seat 6: $ampaioBruno folded before Flop (didn't bet)
Seat 7: D0MAGE folded before Flop (didn't bet)
Seat 8: must59 folded before Flop (didn't bet)



PokerStars Hand #255214821164: Tournament #3863783058, $9.80+$1.20 USD Hold'em No Limit - Level XI (250/500) - 2025/03/09 20:03:36 WET [2025/03/09 16:03:36 ET]
Table '3863783058 225' 8-max Seat #4 is the button
Seat 1: MrPufies (22256 in chips) 
Seat 2: zetorrao (13796 in chips) 
Seat 3: onlydrunkreg (10550 in chips) 
Seat 4: LordAzils002 (20990 in chips) 
Seat 5: Kevin12345Mc (7274 in chips) 
Seat 6: $ampaioBruno (9700 in chips) 
Seat 7: D0MAGE (40944 in chips) 
Seat 8: must59 (24574 in chips) 
MrPufies: posts the ante 60
zetorrao: posts the ante 60
onlydrunkreg: posts the ante 60
LordAzils002: posts the ante 60
Kevin12345Mc: posts the ante 60
$ampaioBruno: posts the ante 60
D0MAGE: posts the ante 60
must59: posts the ante 60
Kevin12345Mc: posts small blind 250
$ampaioBruno: posts big blind 500
*** HOLE CARDS ***
Dealt to Kevin12345Mc [Qc 4c]
D0MAGE: folds 
must59: raises 500 to 1000
MrPufies: raises 2000 to 3000
zetorrao: folds 
onlydrunkreg: folds 
LordAzils002: folds 
Kevin12345Mc: folds 
$ampaioBruno: folds 
must59: calls 2000
*** FLOP *** [6c Jc Ac]
must59: checks 
MrPufies: bets 2892
must59: folds 
Uncalled bet (2892) returned to MrPufies
MrPufies collected 7230 from pot
MrPufies: doesn't show hand 
*** SUMMARY ***
Total pot 7230 | Rake 0 
Board [6c Jc Ac]
Seat 1: MrPufies collected (7230)
Seat 2: zetorrao folded before Flop (didn't bet)
Seat 3: onlydrunkreg folded before Flop (didn't bet)
Seat 4: LordAzils002 (button) folded before Flop (didn't bet)
Seat 5: Kevin12345Mc (small blind) folded before Flop
Seat 6: $ampaioBruno (big blind) folded before Flop
Seat 7: D0MAGE folded before Flop (didn't bet)
Seat 8: must59 folded on the Flop



PokerStars Hand #255214850161: Tournament #3863783058, $9.80+$1.20 USD Hold'em No Limit - Level XII (300/600) - 2025/03/09 20:04:57 WET [2025/03/09 16:04:57 ET]
Table '3863783058 225' 8-max Seat #5 is the button
Seat 1: MrPufies (26426 in chips) 
Seat 2: zetorrao (13736 in chips) 
Seat 3: onlydrunkreg (10490 in chips) 
Seat 4: LordAzils002 (20930 in chips) 
Seat 5: Kevin12345Mc (6964 in chips) 
Seat 6: $ampaioBruno (9140 in chips) 
Seat 7: D0MAGE (40884 in chips) 
Seat 8: must59 (21514 in chips) 
MrPufies: posts the ante 70
zetorrao: posts the ante 70
onlydrunkreg: posts the ante 70
LordAzils002: posts the ante 70
Kevin12345Mc: posts the ante 70
$ampaioBruno: posts the ante 70
D0MAGE: posts the ante 70
must59: posts the ante 70
$ampaioBruno: posts small blind 300
D0MAGE: posts big blind 600
*** HOLE CARDS ***
Dealt to Kevin12345Mc [Ac Kc]
must59: raises 600 to 1200
MrPufies: folds 
zetorrao: calls 1200
onlydrunkreg: folds 
LordAzils002: folds 
Kevin12345Mc: raises 5694 to 6894 and is all-in
$ampaioBruno: folds 
D0MAGE: folds 
must59: calls 5694
zetorrao: folds 
*** FLOP *** [5d Ad 7s]
*** TURN *** [5d Ad 7s] [Jh]
*** RIVER *** [5d Ad 7s Jh] [7h]
*** SHOW DOWN ***
must59: shows [Kd Js] (two pair, Jacks and Sevens)
Kevin12345Mc: shows [Ac Kc] (two pair, Aces and Sevens)
Kevin12345Mc collected 16448 from pot
*** SUMMARY ***
Total pot 16448 | Rake 0 
Board [5d Ad 7s Jh 7h]
Seat 1: MrPufies folded before Flop (didn't bet)
Seat 2: zetorrao folded before Flop
Seat 3: onlydrunkreg folded before Flop (didn't bet)
Seat 4: LordAzils002 folded before Flop (didn't bet)
Seat 5: Kevin12345Mc (button) showed [Ac Kc] and won (16448) with two pair, Aces and Sevens
Seat 6: $ampaioBruno (small blind) folded before Flop
Seat 7: D0MAGE (big blind) folded before Flop
Seat 8: must59 showed [Kd Js] and lost with two pair, Jacks and Sevens



PokerStars Hand #255214868954: Tournament #3863783058, $9.80+$1.20 USD Hold'em No Limit - Level XII (300/600) - 2025/03/09 20:05:49 WET [2025/03/09 16:05:49 ET]
Table '3863783058 225' 8-max Seat #6 is the button
Seat 1: MrPufies (26356 in chips) 
Seat 2: zetorrao (12466 in chips) 
Seat 3: onlydrunkreg (10420 in chips) 
Seat 4: LordAzils002 (20860 in chips) 
Seat 5: Kevin12345Mc (16448 in chips) 
Seat 6: $ampaioBruno (8770 in chips) 
Seat 7: D0MAGE (40214 in chips) 
Seat 8: must59 (14550 in chips) 
MrPufies: posts the ante 70
zetorrao: posts the ante 70
onlydrunkreg: posts the ante 70
LordAzils002: posts the ante 70
Kevin12345Mc: posts the ante 70
$ampaioBruno: posts the ante 70
D0MAGE: posts the ante 70
must59: posts the ante 70
D0MAGE: posts small blind 300
must59: posts big blind 600
*** HOLE CARDS ***
Dealt to Kevin12345Mc [4c Ks]
MrPufies: folds 
zetorrao: folds 
onlydrunkreg: folds 
LordAzils002: folds 
Kevin12345Mc: folds 
$ampaioBruno: folds 
D0MAGE: raises 1500 to 2100
must59: calls 1500
*** FLOP *** [9s 8s 8c]
D0MAGE: checks 
must59: checks 
*** TURN *** [9s 8s 8c] [Ad]
D0MAGE: bets 3142
must59: folds 
Uncalled bet (3142) returned to D0MAGE
D0MAGE collected 4760 from pot
D0MAGE: doesn't show hand 
*** SUMMARY ***
Total pot 4760 | Rake 0 
Board [9s 8s 8c Ad]
Seat 1: MrPufies folded before Flop (didn't bet)
Seat 2: zetorrao folded before Flop (didn't bet)
Seat 3: onlydrunkreg folded before Flop (didn't bet)
Seat 4: LordAzils002 folded before Flop (didn't bet)
Seat 5: Kevin12345Mc folded before Flop (didn't bet)
Seat 6: $ampaioBruno (button) folded before Flop (didn't bet)
Seat 7: D0MAGE (small blind) collected (4760)
Seat 8: must59 (big blind) folded on the Turn



PokerStars Hand #255214887533: Tournament #3863783058, $9.80+$1.20 USD Hold'em No Limit - Level XII (300/600) - 2025/03/09 20:06:41 WET [2025/03/09 16:06:41 ET]
Table '3863783058 225' 8-max Seat #7 is the button
Seat 1: MrPufies (26286 in chips) 
Seat 2: zetorrao (12396 in chips) 
Seat 3: onlydrunkreg (10350 in chips) 
Seat 4: LordAzils002 (20790 in chips) 
Seat 5: Kevin12345Mc (16378 in chips) 
Seat 6: $ampaioBruno (8700 in chips) 
Seat 7: D0MAGE (42804 in chips) 
Seat 8: must59 (12380 in chips) 
MrPufies: posts the ante 70
zetorrao: posts the ante 70
onlydrunkreg: posts the ante 70
LordAzils002: posts the ante 70
Kevin12345Mc: posts the ante 70
$ampaioBruno: posts the ante 70
D0MAGE: posts the ante 70
must59: posts the ante 70
must59: posts small blind 300
MrPufies: posts big blind 600
*** HOLE CARDS ***
Dealt to Kevin12345Mc [9s Qd]
zetorrao: calls 600
onlydrunkreg: folds 
LordAzils002: folds 
Kevin12345Mc: folds 
$ampaioBruno: folds 
D0MAGE: folds 
must59: folds 
MrPufies: checks 
*** FLOP *** [Jh Ah 8c]
MrPufies: checks 
zetorrao: checks 
*** TURN *** [Jh Ah 8c] [9d]
MrPufies: checks 
zetorrao: checks 
*** RIVER *** [Jh Ah 8c 9d] [3s]
MrPufies: checks 
zetorrao: checks 
*** SHOW DOWN ***
MrPufies: shows [Th 2d] (high card Ace)
zetorrao: shows [6d 6s] (a pair of Sixes)
zetorrao collected 2060 from pot
*** SUMMARY ***
Total pot 2060 | Rake 0 
Board [Jh Ah 8c 9d 3s]
Seat 1: MrPufies (big blind) showed [Th 2d] and lost with high card Ace
Seat 2: zetorrao showed [6d 6s] and won (2060) with a pair of Sixes
Seat 3: onlydrunkreg folded before Flop (didn't bet)
Seat 4: LordAzils002 folded before Flop (didn't bet)
Seat 5: Kevin12345Mc folded before Flop (didn't bet)
Seat 6: $ampaioBruno folded before Flop (didn't bet)
Seat 7: D0MAGE (button) folded before Flop (didn't bet)
Seat 8: must59 (small blind) folded before Flop



PokerStars Hand #255214904356: Tournament #3863783058, $9.80+$1.20 USD Hold'em No Limit - Level XII (300/600) - 2025/03/09 20:07:27 WET [2025/03/09 16:07:27 ET]
Table '3863783058 225' 8-max Seat #8 is the button
Seat 1: MrPufies (25616 in chips) 
Seat 2: zetorrao (13786 in chips) 
Seat 3: onlydrunkreg (10280 in chips) 
Seat 4: LordAzils002 (20720 in chips) 
Seat 5: Kevin12345Mc (16308 in chips) 
Seat 6: $ampaioBruno (8630 in chips) 
Seat 7: D0MAGE (42734 in chips) 
Seat 8: must59 (12010 in chips) 
MrPufies: posts the ante 70
zetorrao: posts the ante 70
onlydrunkreg: posts the ante 70
LordAzils002: posts the ante 70
Kevin12345Mc: posts the ante 70
$ampaioBruno: posts the ante 70
D0MAGE: posts the ante 70
must59: posts the ante 70
MrPufies: posts small blind 300
zetorrao: posts big blind 600
*** HOLE CARDS ***
Dealt to Kevin12345Mc [2h Kd]
onlydrunkreg: folds 
LordAzils002: folds 
Kevin12345Mc: folds 
$ampaioBruno: folds 
D0MAGE: folds 
must59: folds 
MrPufies: calls 300
zetorrao: checks 
*** FLOP *** [7s 6d 3d]
MrPufies: checks 
zetorrao: checks 
*** TURN *** [7s 6d 3d] [9c]
MrPufies: bets 1302
zetorrao: folds 
Uncalled bet (1302) returned to MrPufies
MrPufies collected 1760 from pot
MrPufies: doesn't show hand 
*** SUMMARY ***
Total pot 1760 | Rake 0 
Board [7s 6d 3d 9c]
Seat 1: MrPufies (small blind) collected (1760)
Seat 2: zetorrao (big blind) folded on the Turn
Seat 3: onlydrunkreg folded before Flop (didn't bet)
Seat 4: LordAzils002 folded before Flop (didn't bet)
Seat 5: Kevin12345Mc folded before Flop (didn't bet)
Seat 6: $ampaioBruno folded before Flop (didn't bet)
Seat 7: D0MAGE folded before Flop (didn't bet)
Seat 8: must59 (button) folded before Flop (didn't bet)



PokerStars Hand #255214920766: Tournament #3863783058, $9.80+$1.20 USD Hold'em No Limit - Level XII (300/600) - 2025/03/09 20:08:13 WET [2025/03/09 16:08:13 ET]
Table '3863783058 225' 8-max Seat #1 is the button
Seat 1: MrPufies (26706 in chips) 
Seat 2: zetorrao (13116 in chips) 
Seat 3: onlydrunkreg (10210 in chips) 
Seat 4: LordAzils002 (20650 in chips) 
Seat 5: Kevin12345Mc (16238 in chips) 
Seat 6: $ampaioBruno (8560 in chips) 
Seat 7: D0MAGE (42664 in chips) 
Seat 8: must59 (11940 in chips) 
MrPufies: posts the ante 70
zetorrao: posts the ante 70
onlydrunkreg: posts the ante 70
LordAzils002: posts the ante 70
Kevin12345Mc: posts the ante 70
$ampaioBruno: posts the ante 70
D0MAGE: posts the ante 70
must59: posts the ante 70
zetorrao: posts small blind 300
onlydrunkreg: posts big blind 600
*** HOLE CARDS ***
Dealt to Kevin12345Mc [5d 2h]
LordAzils002: folds 
Kevin12345Mc: folds 
$ampaioBruno: folds 
D0MAGE: raises 600 to 1200
must59: folds 
MrPufies: folds 
zetorrao: calls 900
onlydrunkreg: calls 600
*** FLOP *** [Ks 8h 6s]
zetorrao: checks 
onlydrunkreg: checks 
D0MAGE: checks 
*** TURN *** [Ks 8h 6s] [3c]
zetorrao: checks 
onlydrunkreg: checks 
D0MAGE: checks 
*** RIVER *** [Ks 8h 6s 3c] [4h]
zetorrao: checks 
onlydrunkreg: checks 
D0MAGE: checks 
*** SHOW DOWN ***
zetorrao: shows [Tc Jd] (high card King)
onlydrunkreg: shows [Qd Ts] (high card King - Queen kicker)
D0MAGE: mucks hand 
onlydrunkreg collected 4160 from pot
*** SUMMARY ***
Total pot 4160 | Rake 0 
Board [Ks 8h 6s 3c 4h]
Seat 1: MrPufies (button) folded before Flop (didn't bet)
Seat 2: zetorrao (small blind) showed [Tc Jd] and lost with high card King
Seat 3: onlydrunkreg (big blind) showed [Qd Ts] and won (4160) with high card King
Seat 4: LordAzils002 folded before Flop (didn't bet)
Seat 5: Kevin12345Mc folded before Flop (didn't bet)
Seat 6: $ampaioBruno folded before Flop (didn't bet)
Seat 7: D0MAGE mucked [Td Jc]
Seat 8: must59 folded before Flop (didn't bet)



PokerStars Hand #255214959223: Tournament #3863783058, $9.80+$1.20 USD Hold'em No Limit - Level XII (300/600) - 2025/03/09 20:09:59 WET [2025/03/09 16:09:59 ET]
Table '3863783058 225' 8-max Seat #2 is the button
Seat 1: MrPufies (26636 in chips) 
Seat 2: zetorrao (11846 in chips) 
Seat 3: onlydrunkreg (13100 in chips) 
Seat 4: LordAzils002 (20580 in chips) 
Seat 5: Kevin12345Mc (16168 in chips) 
Seat 6: $ampaioBruno (8490 in chips) 
Seat 7: D0MAGE (41394 in chips) 
Seat 8: must59 (11870 in chips) 
MrPufies: posts the ante 70
zetorrao: posts the ante 70
onlydrunkreg: posts the ante 70
LordAzils002: posts the ante 70
Kevin12345Mc: posts the ante 70
$ampaioBruno: posts the ante 70
D0MAGE: posts the ante 70
must59: posts the ante 70
onlydrunkreg: posts small blind 300
LordAzils002: posts big blind 600
*** HOLE CARDS ***
Dealt to Kevin12345Mc [2d Td]
Kevin12345Mc: folds 
$ampaioBruno: raises 600 to 1200
D0MAGE: folds 
must59: folds 
MrPufies: folds 
zetorrao: calls 1200
onlydrunkreg: folds 
LordAzils002: calls 600
*** FLOP *** [5c 8s 4d]
LordAzils002: checks 
$ampaioBruno: checks 
zetorrao: bets 2230
LordAzils002: folds 
$ampaioBruno: folds 
Uncalled bet (2230) returned to zetorrao
zetorrao collected 4460 from pot
*** SUMMARY ***
Total pot 4460 | Rake 0 
Board [5c 8s 4d]
Seat 1: MrPufies folded before Flop (didn't bet)
Seat 2: zetorrao (button) collected (4460)
Seat 3: onlydrunkreg (small blind) folded before Flop
Seat 4: LordAzils002 (big blind) folded on the Flop
Seat 5: Kevin12345Mc folded before Flop (didn't bet)
Seat 6: $ampaioBruno folded on the Flop
Seat 7: D0MAGE folded before Flop (didn't bet)
Seat 8: must59 folded before Flop (didn't bet)



PokerStars Hand #255214986563: Tournament #3863783058, $9.80+$1.20 USD Hold'em No Limit - Level XII (300/600) - 2025/03/09 20:11:15 WET [2025/03/09 16:11:15 ET]
Table '3863783058 225' 8-max Seat #3 is the button
Seat 1: MrPufies (26566 in chips) 
Seat 2: zetorrao (15036 in chips) 
Seat 3: onlydrunkreg (12730 in chips) 
Seat 4: LordAzils002 (19310 in chips) 
Seat 5: Kevin12345Mc (16098 in chips) 
Seat 6: $ampaioBruno (7220 in chips) 
Seat 7: D0MAGE (41324 in chips) 
Seat 8: must59 (11800 in chips) 
MrPufies: posts the ante 70
zetorrao: posts the ante 70
onlydrunkreg: posts the ante 70
LordAzils002: posts the ante 70
Kevin12345Mc: posts the ante 70
$ampaioBruno: posts the ante 70
D0MAGE: posts the ante 70
must59: posts the ante 70
LordAzils002: posts small blind 300
Kevin12345Mc: posts big blind 600
*** HOLE CARDS ***
Dealt to Kevin12345Mc [7s Qd]
$ampaioBruno: folds 
D0MAGE: folds 
must59: raises 900 to 1500
MrPufies: folds 
zetorrao: folds 
onlydrunkreg: folds 
LordAzils002: folds 
Kevin12345Mc: calls 900
*** FLOP *** [5d 4d Ah]
Kevin12345Mc: checks 
must59: bets 1200
Kevin12345Mc: folds 
Uncalled bet (1200) returned to must59
must59 collected 3860 from pot
must59: doesn't show hand 
*** SUMMARY ***
Total pot 3860 | Rake 0 
Board [5d 4d Ah]
Seat 1: MrPufies folded before Flop (didn't bet)
Seat 2: zetorrao folded before Flop (didn't bet)
Seat 3: onlydrunkreg (button) folded before Flop (didn't bet)
Seat 4: LordAzils002 (small blind) folded before Flop
Seat 5: Kevin12345Mc (big blind) folded on the Flop
Seat 6: $ampaioBruno folded before Flop (didn't bet)
Seat 7: D0MAGE folded before Flop (didn't bet)
Seat 8: must59 collected (3860)



PokerStars Hand #255215007488: Tournament #3863783058, $9.80+$1.20 USD Hold'em No Limit - Level XII (300/600) - 2025/03/09 20:12:13 WET [2025/03/09 16:12:13 ET]
Table '3863783058 225' 8-max Seat #4 is the button
Seat 1: MrPufies (26496 in chips) 
Seat 2: zetorrao (14966 in chips) 
Seat 3: onlydrunkreg (12660 in chips) 
Seat 4: LordAzils002 (18940 in chips) 
Seat 5: Kevin12345Mc (14528 in chips) 
Seat 6: $ampaioBruno (7150 in chips) 
Seat 7: D0MAGE (41254 in chips) 
Seat 8: must59 (14090 in chips) 
MrPufies: posts the ante 70
zetorrao: posts the ante 70
onlydrunkreg: posts the ante 70
LordAzils002: posts the ante 70
Kevin12345Mc: posts the ante 70
$ampaioBruno: posts the ante 70
D0MAGE: posts the ante 70
must59: posts the ante 70
Kevin12345Mc: posts small blind 300
$ampaioBruno: posts big blind 600
*** HOLE CARDS ***
Dealt to Kevin12345Mc [7d 7c]
D0MAGE: folds 
must59: folds 
MrPufies: raises 600 to 1200
zetorrao: folds 
onlydrunkreg: folds 
LordAzils002: folds 
Kevin12345Mc: raises 13258 to 14458 and is all-in
$ampaioBruno: folds 
MrPufies: folds 
Uncalled bet (13258) returned to Kevin12345Mc
Kevin12345Mc collected 3560 from pot
Kevin12345Mc: doesn't show hand 
*** SUMMARY ***
Total pot 3560 | Rake 0 
Seat 1: MrPufies folded before Flop
Seat 2: zetorrao folded before Flop (didn't bet)
Seat 3: onlydrunkreg folded before Flop (didn't bet)
Seat 4: LordAzils002 (button) folded before Flop (didn't bet)
Seat 5: Kevin12345Mc (small blind) collected (3560)
Seat 6: $ampaioBruno (big blind) folded before Flop
Seat 7: D0MAGE folded before Flop (didn't bet)
Seat 8: must59 folded before Flop (didn't bet)



PokerStars Hand #255215024010: Tournament #3863783058, $9.80+$1.20 USD Hold'em No Limit - Level XII (300/600) - 2025/03/09 20:13:00 WET [2025/03/09 16:13:00 ET]
Table '3863783058 225' 8-max Seat #5 is the button
Seat 1: MrPufies (25226 in chips) 
Seat 2: zetorrao (14896 in chips) 
Seat 3: onlydrunkreg (12590 in chips) 
Seat 4: LordAzils002 (18870 in chips) 
Seat 5: Kevin12345Mc (16818 in chips) 
Seat 6: $ampaioBruno (6480 in chips) 
Seat 7: D0MAGE (41184 in chips) 
Seat 8: must59 (14020 in chips) 
MrPufies: posts the ante 70
zetorrao: posts the ante 70
onlydrunkreg: posts the ante 70
LordAzils002: posts the ante 70
Kevin12345Mc: posts the ante 70
$ampaioBruno: posts the ante 70
D0MAGE: posts the ante 70
must59: posts the ante 70
$ampaioBruno: posts small blind 300
D0MAGE: posts big blind 600
*** HOLE CARDS ***
Dealt to Kevin12345Mc [7c Jc]
must59: folds 
MrPufies: folds 
zetorrao: folds 
onlydrunkreg: folds 
LordAzils002: raises 600 to 1200
Kevin12345Mc: folds 
$ampaioBruno: folds 
D0MAGE: calls 600
*** FLOP *** [6h Qc Tc]
D0MAGE: checks 
LordAzils002: checks 
*** TURN *** [6h Qc Tc] [Jd]
D0MAGE: checks 
LordAzils002: bets 1914
D0MAGE: folds 
Uncalled bet (1914) returned to LordAzils002
LordAzils002 collected 3260 from pot
LordAzils002: doesn't show hand 
*** SUMMARY ***
Total pot 3260 | Rake 0 
Board [6h Qc Tc Jd]
Seat 1: MrPufies folded before Flop (didn't bet)
Seat 2: zetorrao folded before Flop (didn't bet)
Seat 3: onlydrunkreg folded before Flop (didn't bet)
Seat 4: LordAzils002 collected (3260)
Seat 5: Kevin12345Mc (button) folded before Flop (didn't bet)
Seat 6: $ampaioBruno (small blind) folded before Flop
Seat 7: D0MAGE (big blind) folded on the Turn
Seat 8: must59 folded before Flop (didn't bet)



PokerStars Hand #255215045862: Tournament #3863783058, $9.80+$1.20 USD Hold'em No Limit - Level XII (300/600) - 2025/03/09 20:14:01 WET [2025/03/09 16:14:01 ET]
Table '3863783058 225' 8-max Seat #6 is the button
Seat 1: MrPufies (25156 in chips) 
Seat 2: zetorrao (14826 in chips) 
Seat 3: onlydrunkreg (12520 in chips) 
Seat 4: LordAzils002 (20860 in chips) 
Seat 5: Kevin12345Mc (16748 in chips) 
Seat 6: $ampaioBruno (6110 in chips) 
Seat 7: D0MAGE (39914 in chips) 
Seat 8: must59 (13950 in chips) 
MrPufies: posts the ante 70
zetorrao: posts the ante 70
onlydrunkreg: posts the ante 70
LordAzils002: posts the ante 70
Kevin12345Mc: posts the ante 70
$ampaioBruno: posts the ante 70
D0MAGE: posts the ante 70
must59: posts the ante 70
D0MAGE: posts small blind 300
must59: posts big blind 600
*** HOLE CARDS ***
Dealt to Kevin12345Mc [7c 5h]
MrPufies: folds 
zetorrao: calls 600
onlydrunkreg: folds 
LordAzils002: raises 1800 to 2400
Kevin12345Mc: folds 
$ampaioBruno: folds 
D0MAGE: folds 
must59: folds 
zetorrao: folds 
Uncalled bet (1800) returned to LordAzils002
LordAzils002 collected 2660 from pot
LordAzils002: doesn't show hand 
*** SUMMARY ***
Total pot 2660 | Rake 0 
Seat 1: MrPufies folded before Flop (didn't bet)
Seat 2: zetorrao folded before Flop
Seat 3: onlydrunkreg folded before Flop (didn't bet)
Seat 4: LordAzils002 collected (2660)
Seat 5: Kevin12345Mc folded before Flop (didn't bet)
Seat 6: $ampaioBruno (button) folded before Flop (didn't bet)
Seat 7: D0MAGE (small blind) folded before Flop
Seat 8: must59 (big blind) folded before Flop



PokerStars Hand #255215059634: Tournament #3863783058, $9.80+$1.20 USD Hold'em No Limit - Level XIII (350/700) - 2025/03/09 20:14:40 WET [2025/03/09 16:14:40 ET]
Table '3863783058 225' 8-max Seat #7 is the button
Seat 1: MrPufies (25086 in chips) 
Seat 2: zetorrao (14156 in chips) 
Seat 3: onlydrunkreg (12450 in chips) 
Seat 4: LordAzils002 (22850 in chips) 
Seat 5: Kevin12345Mc (16678 in chips) 
Seat 6: $ampaioBruno (6040 in chips) 
Seat 7: D0MAGE (39544 in chips) 
Seat 8: must59 (13280 in chips) 
MrPufies: posts the ante 80
zetorrao: posts the ante 80
onlydrunkreg: posts the ante 80
LordAzils002: posts the ante 80
Kevin12345Mc: posts the ante 80
$ampaioBruno: posts the ante 80
D0MAGE: posts the ante 80
must59: posts the ante 80
must59: posts small blind 350
MrPufies: posts big blind 700
*** HOLE CARDS ***
Dealt to Kevin12345Mc [5c 4c]
zetorrao: folds 
onlydrunkreg: raises 875 to 1575
LordAzils002: folds 
Kevin12345Mc: folds 
$ampaioBruno: folds 
D0MAGE: folds 
must59: folds 
MrPufies: folds 
Uncalled bet (875) returned to onlydrunkreg
onlydrunkreg collected 2390 from pot
*** SUMMARY ***
Total pot 2390 | Rake 0 
Seat 1: MrPufies (big blind) folded before Flop
Seat 2: zetorrao folded before Flop (didn't bet)
Seat 3: onlydrunkreg collected (2390)
Seat 4: LordAzils002 folded before Flop (didn't bet)
Seat 5: Kevin12345Mc folded before Flop (didn't bet)
Seat 6: $ampaioBruno folded before Flop (didn't bet)
Seat 7: D0MAGE (button) folded before Flop (didn't bet)
Seat 8: must59 (small blind) folded before Flop



PokerStars Hand #255215070574: Tournament #3863783058, $9.80+$1.20 USD Hold'em No Limit - Level XIII (350/700) - 2025/03/09 20:15:11 WET [2025/03/09 16:15:11 ET]
Table '3863783058 225' 8-max Seat #8 is the button
Seat 1: MrPufies (24306 in chips) 
Seat 2: zetorrao (14076 in chips) 
Seat 3: onlydrunkreg (14060 in chips) 
Seat 4: LordAzils002 (22770 in chips) 
Seat 5: Kevin12345Mc (16598 in chips) 
Seat 6: $ampaioBruno (5960 in chips) 
Seat 7: D0MAGE (39464 in chips) 
Seat 8: must59 (12850 in chips) 
MrPufies: posts the ante 80
zetorrao: posts the ante 80
onlydrunkreg: posts the ante 80
LordAzils002: posts the ante 80
Kevin12345Mc: posts the ante 80
$ampaioBruno: posts the ante 80
D0MAGE: posts the ante 80
must59: posts the ante 80
MrPufies: posts small blind 350
zetorrao: posts big blind 700
*** HOLE CARDS ***
Dealt to Kevin12345Mc [2c 3d]
onlydrunkreg: raises 875 to 1575
LordAzils002: folds 
Kevin12345Mc: folds 
$ampaioBruno: folds 
D0MAGE: folds 
must59: calls 1575
MrPufies: raises 22651 to 24226 and is all-in
zetorrao: folds 
onlydrunkreg: calls 12405 and is all-in
must59: calls 11195 and is all-in
Uncalled bet (10246) returned to MrPufies
*** FLOP *** [7h 3h 7s]
*** TURN *** [7h 3h 7s] [8s]
*** RIVER *** [7h 3h 7s 8s] [9s]
*** SHOW DOWN ***
MrPufies: shows [Td Th] (two pair, Tens and Sevens)
onlydrunkreg: shows [As Kh] (a pair of Sevens)
MrPufies collected 2420 from side pot
must59: shows [Tc Kc] (a pair of Sevens)
MrPufies collected 39650 from main pot
onlydrunkreg finished the tournament
must59 finished the tournament
*** SUMMARY ***
Total pot 42070 Main pot 39650. Side pot 2420. | Rake 0 
Board [7h 3h 7s 8s 9s]
Seat 1: MrPufies (small blind) showed [Td Th] and won (42070) with two pair, Tens and Sevens
Seat 2: zetorrao (big blind) folded before Flop
Seat 3: onlydrunkreg showed [As Kh] and lost with a pair of Sevens
Seat 4: LordAzils002 folded before Flop (didn't bet)
Seat 5: Kevin12345Mc folded before Flop (didn't bet)
Seat 6: $ampaioBruno folded before Flop (didn't bet)
Seat 7: D0MAGE folded before Flop (didn't bet)
Seat 8: must59 (button) showed [Tc Kc] and lost with a pair of Sevens



PokerStars Hand #255215090947: Tournament #3863783058, $9.80+$1.20 USD Hold'em No Limit - Level XIII (350/700) - 2025/03/09 20:16:08 WET [2025/03/09 16:16:08 ET]
Table '3863783058 225' 8-max Seat #1 is the button
Seat 1: MrPufies (52316 in chips) 
Seat 2: zetorrao (13296 in chips) 
Seat 3: mrhom1 (10000 in chips) 
Seat 4: LordAzils002 (22690 in chips) 
Seat 5: Kevin12345Mc (16518 in chips) 
Seat 6: $ampaioBruno (5880 in chips) 
Seat 7: D0MAGE (39384 in chips) 
MrPufies: posts the ante 80
zetorrao: posts the ante 80
mrhom1: posts the ante 80
LordAzils002: posts the ante 80
Kevin12345Mc: posts the ante 80
$ampaioBruno: posts the ante 80
D0MAGE: posts the ante 80
zetorrao: posts small blind 350
mrhom1: posts big blind 700
*** HOLE CARDS ***
Dealt to Kevin12345Mc [5c 4h]
LordAzils002: folds 
Kevin12345Mc: folds 
$ampaioBruno: raises 5100 to 5800 and is all-in
AresVaettur is disconnected 
D0MAGE: folds 
MrPufies: folds 
zetorrao: raises 5100 to 10900
mrhom1: folds 
Uncalled bet (5100) returned to zetorrao
*** FLOP *** [Ts 6h 9s]
*** TURN *** [Ts 6h 9s] [6c]
*** RIVER *** [Ts 6h 9s 6c] [7h]
*** SHOW DOWN ***
zetorrao: shows [As Ad] (two pair, Aces and Sixes)
$ampaioBruno: shows [Jc Qs] (a pair of Sixes)
zetorrao collected 12860 from pot
$ampaioBruno finished the tournament
*** SUMMARY ***
Total pot 12860 | Rake 0 
Board [Ts 6h 9s 6c 7h]
Seat 1: MrPufies (button) folded before Flop (didn't bet)
Seat 2: zetorrao (small blind) showed [As Ad] and won (12860) with two pair, Aces and Sixes
Seat 3: mrhom1 (big blind) folded before Flop
Seat 4: LordAzils002 folded before Flop (didn't bet)
Seat 5: Kevin12345Mc folded before Flop (didn't bet)
Seat 6: $ampaioBruno showed [Jc Qs] and lost with a pair of Sixes
Seat 7: D0MAGE folded before Flop (didn't bet)



PokerStars Hand #255215102804: Tournament #3863783058, $9.80+$1.20 USD Hold'em No Limit - Level XIII (350/700) - 2025/03/09 20:16:41 WET [2025/03/09 16:16:41 ET]
Table '3863783058 225' 8-max Seat #2 is the button
Seat 1: MrPufies (52236 in chips) 
Seat 2: zetorrao (20276 in chips) 
Seat 3: mrhom1 (9220 in chips) 
Seat 4: LordAzils002 (22610 in chips) 
Seat 5: Kevin12345Mc (16438 in chips) 
Seat 7: D0MAGE (39304 in chips) 
Seat 8: AresVaettur (16890 in chips) 
MrPufies: posts the ante 80
zetorrao: posts the ante 80
mrhom1: posts the ante 80
LordAzils002: posts the ante 80
Kevin12345Mc: posts the ante 80
D0MAGE: posts the ante 80
AresVaettur: posts the ante 80
mrhom1: posts small blind 350
LordAzils002: posts big blind 700
*** HOLE CARDS ***
Dealt to Kevin12345Mc [2d Th]
Kevin12345Mc: folds 
D0MAGE: folds 
AresVaettur: folds 
SannyMielly is disconnected 
MrPufies: folds 
zetorrao: folds 
mrhom1: calls 350
LordAzils002: raises 21830 to 22530 and is all-in
mrhom1: folds 
Uncalled bet (21830) returned to LordAzils002
LordAzils002 collected 1960 from pot
LordAzils002: doesn't show hand 
*** SUMMARY ***
Total pot 1960 | Rake 0 
Seat 1: MrPufies folded before Flop (didn't bet)
Seat 2: zetorrao (button) folded before Flop (didn't bet)
Seat 3: mrhom1 (small blind) folded before Flop
Seat 4: LordAzils002 (big blind) collected (1960)
Seat 5: Kevin12345Mc folded before Flop (didn't bet)
Seat 7: D0MAGE folded before Flop (didn't bet)
Seat 8: AresVaettur folded before Flop (didn't bet)



PokerStars Hand #255215121714: Tournament #3863783058, $9.80+$1.20 USD Hold'em No Limit - Level XIII (350/700) - 2025/03/09 20:17:34 WET [2025/03/09 16:17:34 ET]
Table '3863783058 225' 8-max Seat #3 is the button
Seat 1: MrPufies (52156 in chips) 
Seat 2: zetorrao (20196 in chips) 
Seat 3: mrhom1 (8440 in chips) 
Seat 4: LordAzils002 (23790 in chips) 
Seat 5: Kevin12345Mc (16358 in chips) 
Seat 6: SannyMielly (80420 in chips) 
Seat 7: D0MAGE (39224 in chips) 
Seat 8: AresVaettur (16810 in chips) 
MrPufies: posts the ante 80
zetorrao: posts the ante 80
mrhom1: posts the ante 80
LordAzils002: posts the ante 80
Kevin12345Mc: posts the ante 80
SannyMielly: posts the ante 80
D0MAGE: posts the ante 80
AresVaettur: posts the ante 80
LordAzils002: posts small blind 350
Kevin12345Mc: posts big blind 700
*** HOLE CARDS ***
Dealt to Kevin12345Mc [Jd 9h]
SannyMielly: folds 
D0MAGE: raises 763 to 1463
AresVaettur: folds 
MrPufies: folds 
zetorrao: folds 
mrhom1: folds 
LordAzils002: folds 
Kevin12345Mc: calls 763
*** FLOP *** [7d Kc Qd]
Kevin12345Mc: checks 
D0MAGE: bets 1958
Kevin12345Mc: calls 1958
*** TURN *** [7d Kc Qd] [3d]
Kevin12345Mc: checks 
D0MAGE: checks 
*** RIVER *** [7d Kc Qd 3d] [2c]
Kevin12345Mc: bets 12857 and is all-in
D0MAGE: folds 
Uncalled bet (12857) returned to Kevin12345Mc
Kevin12345Mc collected 7832 from pot
Kevin12345Mc: doesn't show hand 
*** SUMMARY ***
Total pot 7832 | Rake 0 
Board [7d Kc Qd 3d 2c]
Seat 1: MrPufies folded before Flop (didn't bet)
Seat 2: zetorrao folded before Flop (didn't bet)
Seat 3: mrhom1 (button) folded before Flop (didn't bet)
Seat 4: LordAzils002 (small blind) folded before Flop
Seat 5: Kevin12345Mc (big blind) collected (7832)
Seat 6: SannyMielly folded before Flop (didn't bet)
Seat 7: D0MAGE folded on the River
Seat 8: AresVaettur folded before Flop (didn't bet)



PokerStars Hand #255215160326: Tournament #3863783058, $9.80+$1.20 USD Hold'em No Limit - Level XIII (350/700) - 2025/03/09 20:19:22 WET [2025/03/09 16:19:22 ET]
Table '3863783058 225' 8-max Seat #4 is the button
Seat 1: MrPufies (52076 in chips) 
Seat 2: zetorrao (20116 in chips) 
Seat 3: mrhom1 (8360 in chips) 
Seat 4: LordAzils002 (23360 in chips) 
Seat 5: Kevin12345Mc (20689 in chips) 
Seat 6: SannyMielly (80340 in chips) 
Seat 7: D0MAGE (35723 in chips) 
Seat 8: AresVaettur (16730 in chips) 
MrPufies: posts the ante 80
zetorrao: posts the ante 80
mrhom1: posts the ante 80
LordAzils002: posts the ante 80
Kevin12345Mc: posts the ante 80
SannyMielly: posts the ante 80
D0MAGE: posts the ante 80
AresVaettur: posts the ante 80
Kevin12345Mc: posts small blind 350
SannyMielly: posts big blind 700
*** HOLE CARDS ***
Dealt to Kevin12345Mc [Jc Qs]
D0MAGE: folds 
AresVaettur: folds 
MrPufies: calls 700
zetorrao: calls 700
mrhom1: folds 
LordAzils002: raises 2800 to 3500
Kevin12345Mc: folds 
SannyMielly: folds 
MrPufies: folds 
zetorrao: folds 
Uncalled bet (2800) returned to LordAzils002
LordAzils002 collected 3790 from pot
LordAzils002: doesn't show hand 
*** SUMMARY ***
Total pot 3790 | Rake 0 
Seat 1: MrPufies folded before Flop
Seat 2: zetorrao folded before Flop
Seat 3: mrhom1 folded before Flop (didn't bet)
Seat 4: LordAzils002 (button) collected (3790)
Seat 5: Kevin12345Mc (small blind) folded before Flop
Seat 6: SannyMielly (big blind) folded before Flop
Seat 7: D0MAGE folded before Flop (didn't bet)
Seat 8: AresVaettur folded before Flop (didn't bet)



PokerStars Hand #255215181417: Tournament #3863783058, $9.80+$1.20 USD Hold'em No Limit - Level XIII (350/700) - 2025/03/09 20:20:20 WET [2025/03/09 16:20:20 ET]
Table '3863783058 225' 8-max Seat #5 is the button
Seat 1: MrPufies (51296 in chips) 
Seat 2: zetorrao (19336 in chips) 
Seat 3: mrhom1 (8280 in chips) 
Seat 4: LordAzils002 (26370 in chips) 
Seat 5: Kevin12345Mc (20259 in chips) 
Seat 6: SannyMielly (79560 in chips) 
Seat 7: D0MAGE (35643 in chips) 
Seat 8: AresVaettur (16650 in chips) 
MrPufies: posts the ante 80
zetorrao: posts the ante 80
mrhom1: posts the ante 80
LordAzils002: posts the ante 80
Kevin12345Mc: posts the ante 80
SannyMielly: posts the ante 80
D0MAGE: posts the ante 80
AresVaettur: posts the ante 80
SannyMielly: posts small blind 350
D0MAGE: posts big blind 700
*** HOLE CARDS ***
Dealt to Kevin12345Mc [9s 3c]
AresVaettur: folds 
MrPufies: raises 700 to 1400
zetorrao: folds 
mrhom1: folds 
LordAzils002: folds 
Kevin12345Mc: folds 
SannyMielly: folds 
D0MAGE: folds 
Uncalled bet (700) returned to MrPufies
MrPufies collected 2390 from pot
MrPufies: doesn't show hand 
*** SUMMARY ***
Total pot 2390 | Rake 0 
Seat 1: MrPufies collected (2390)
Seat 2: zetorrao folded before Flop (didn't bet)
Seat 3: mrhom1 folded before Flop (didn't bet)
Seat 4: LordAzils002 folded before Flop (didn't bet)
Seat 5: Kevin12345Mc (button) folded before Flop (didn't bet)
Seat 6: SannyMielly (small blind) folded before Flop
Seat 7: D0MAGE (big blind) folded before Flop
Seat 8: AresVaettur folded before Flop (didn't bet)



PokerStars Hand #255215192990: Tournament #3863783058, $9.80+$1.20 USD Hold'em No Limit - Level XIII (350/700) - 2025/03/09 20:20:52 WET [2025/03/09 16:20:52 ET]
Table '3863783058 225' 8-max Seat #6 is the button
Seat 1: MrPufies (52906 in chips) 
Seat 2: zetorrao (19256 in chips) 
Seat 3: mrhom1 (8200 in chips) 
Seat 4: LordAzils002 (26290 in chips) 
Seat 5: Kevin12345Mc (20179 in chips) 
Seat 6: SannyMielly (79130 in chips) 
Seat 7: D0MAGE (34863 in chips) 
Seat 8: AresVaettur (16570 in chips) 
MrPufies: posts the ante 80
zetorrao: posts the ante 80
mrhom1: posts the ante 80
LordAzils002: posts the ante 80
Kevin12345Mc: posts the ante 80
SannyMielly: posts the ante 80
D0MAGE: posts the ante 80
AresVaettur: posts the ante 80
D0MAGE: posts small blind 350
AresVaettur: posts big blind 700
*** HOLE CARDS ***
Dealt to Kevin12345Mc [3d 5c]
MrPufies: folds 
zetorrao: folds 
mrhom1: raises 1400 to 2100
LordAzils002: folds 
Kevin12345Mc: folds 
SannyMielly: folds 
D0MAGE: folds 
AresVaettur: folds 
Uncalled bet (1400) returned to mrhom1
mrhom1 collected 2390 from pot
*** SUMMARY ***
Total pot 2390 | Rake 0 
Seat 1: MrPufies folded before Flop (didn't bet)
Seat 2: zetorrao folded before Flop (didn't bet)
Seat 3: mrhom1 collected (2390)
Seat 4: LordAzils002 folded before Flop (didn't bet)
Seat 5: Kevin12345Mc folded before Flop (didn't bet)
Seat 6: SannyMielly (button) folded before Flop (didn't bet)
Seat 7: D0MAGE (small blind) folded before Flop
Seat 8: AresVaettur (big blind) folded before Flop



PokerStars Hand #255215206487: Tournament #3863783058, $9.80+$1.20 USD Hold'em No Limit - Level XIII (350/700) - 2025/03/09 20:21:29 WET [2025/03/09 16:21:29 ET]
Table '3863783058 225' 8-max Seat #7 is the button
Seat 1: MrPufies (52826 in chips) 
Seat 2: zetorrao (19176 in chips) 
Seat 3: mrhom1 (9810 in chips) 
Seat 4: LordAzils002 (26210 in chips) 
Seat 5: Kevin12345Mc (20099 in chips) 
Seat 6: SannyMielly (79050 in chips) 
Seat 7: D0MAGE (34433 in chips) 
Seat 8: AresVaettur (15790 in chips) 
MrPufies: posts the ante 80
zetorrao: posts the ante 80
mrhom1: posts the ante 80
LordAzils002: posts the ante 80
Kevin12345Mc: posts the ante 80
SannyMielly: posts the ante 80
D0MAGE: posts the ante 80
AresVaettur: posts the ante 80
AresVaettur: posts small blind 350
MrPufies: posts big blind 700
*** HOLE CARDS ***
Dealt to Kevin12345Mc [8h 9d]
zetorrao: folds 
mrhom1: folds 
LordAzils002: folds 
Kevin12345Mc: folds 
SannyMielly: raises 700 to 1400
D0MAGE: folds 
AresVaettur: folds 
MrPufies: folds 
Uncalled bet (700) returned to SannyMielly
SannyMielly collected 2390 from pot
SannyMielly: doesn't show hand 
*** SUMMARY ***
Total pot 2390 | Rake 0 
Seat 1: MrPufies (big blind) folded before Flop
Seat 2: zetorrao folded before Flop (didn't bet)
Seat 3: mrhom1 folded before Flop (didn't bet)
Seat 4: LordAzils002 folded before Flop (didn't bet)
Seat 5: Kevin12345Mc folded before Flop (didn't bet)
Seat 6: SannyMielly collected (2390)
Seat 7: D0MAGE (button) folded before Flop (didn't bet)
Seat 8: AresVaettur (small blind) folded before Flop



PokerStars Hand #255215219891: Tournament #3863783058, $9.80+$1.20 USD Hold'em No Limit - Level XIII (350/700) - 2025/03/09 20:22:05 WET [2025/03/09 16:22:05 ET]
Table '3863783058 225' 8-max Seat #8 is the button
Seat 1: MrPufies (52046 in chips) 
Seat 2: zetorrao (19096 in chips) 
Seat 3: mrhom1 (9730 in chips) 
Seat 4: LordAzils002 (26130 in chips) 
Seat 5: Kevin12345Mc (20019 in chips) 
Seat 6: SannyMielly (80660 in chips) 
Seat 7: D0MAGE (34353 in chips) 
Seat 8: AresVaettur (15360 in chips) 
MrPufies: posts the ante 80
zetorrao: posts the ante 80
mrhom1: posts the ante 80
LordAzils002: posts the ante 80
Kevin12345Mc: posts the ante 80
SannyMielly: posts the ante 80
D0MAGE: posts the ante 80
AresVaettur: posts the ante 80
MrPufies: posts small blind 350
zetorrao: posts big blind 700
*** HOLE CARDS ***
Dealt to Kevin12345Mc [Ad Qd]
mrhom1: folds 
LordAzils002: folds 
Kevin12345Mc: raises 770 to 1470
SannyMielly: folds 
D0MAGE: folds 
AresVaettur: folds 
MrPufies: folds 
zetorrao: folds 
Uncalled bet (770) returned to Kevin12345Mc
Kevin12345Mc collected 2390 from pot
Kevin12345Mc: doesn't show hand 
*** SUMMARY ***
Total pot 2390 | Rake 0 
Seat 1: MrPufies (small blind) folded before Flop
Seat 2: zetorrao (big blind) folded before Flop
Seat 3: mrhom1 folded before Flop (didn't bet)
Seat 4: LordAzils002 folded before Flop (didn't bet)
Seat 5: Kevin12345Mc collected (2390)
Seat 6: SannyMielly folded before Flop (didn't bet)
Seat 7: D0MAGE folded before Flop (didn't bet)
Seat 8: AresVaettur (button) folded before Flop (didn't bet)



PokerStars Hand #255215229464: Tournament #3863783058, $9.80+$1.20 USD Hold'em No Limit - Level XIII (350/700) - 2025/03/09 20:22:31 WET [2025/03/09 16:22:31 ET]
Table '3863783058 225' 8-max Seat #1 is the button
Seat 1: MrPufies (51616 in chips) 
Seat 2: zetorrao (18316 in chips) 
Seat 3: mrhom1 (9650 in chips) 
Seat 4: LordAzils002 (26050 in chips) 
Seat 5: Kevin12345Mc (21629 in chips) 
Seat 6: SannyMielly (80580 in chips) 
Seat 7: D0MAGE (34273 in chips) 
Seat 8: AresVaettur (15280 in chips) 
MrPufies: posts the ante 80
zetorrao: posts the ante 80
mrhom1: posts the ante 80
LordAzils002: posts the ante 80
Kevin12345Mc: posts the ante 80
SannyMielly: posts the ante 80
D0MAGE: posts the ante 80
AresVaettur: posts the ante 80
zetorrao: posts small blind 350
mrhom1: posts big blind 700
*** HOLE CARDS ***
Dealt to Kevin12345Mc [Js Tc]
LordAzils002: folds 
Kevin12345Mc: folds 
SannyMielly: folds 
D0MAGE: folds 
AresVaettur: folds 
MrPufies: calls 700
zetorrao: calls 350
mrhom1: checks 
*** FLOP *** [6c Jh Jd]
zetorrao: checks 
mrhom1: checks 
MrPufies: checks 
*** TURN *** [6c Jh Jd] [Ks]
zetorrao: checks 
mrhom1: checks 
MrPufies: bets 1096
zetorrao: folds 
mrhom1: calls 1096
*** RIVER *** [6c Jh Jd Ks] [Td]
mrhom1: bets 7774 and is all-in
MrPufies: folds 
Uncalled bet (7774) returned to mrhom1
mrhom1 collected 4932 from pot
*** SUMMARY ***
Total pot 4932 | Rake 0 
Board [6c Jh Jd Ks Td]
Seat 1: MrPufies (button) folded on the River
Seat 2: zetorrao (small blind) folded on the Turn
Seat 3: mrhom1 (big blind) collected (4932)
Seat 4: LordAzils002 folded before Flop (didn't bet)
Seat 5: Kevin12345Mc folded before Flop (didn't bet)
Seat 6: SannyMielly folded before Flop (didn't bet)
Seat 7: D0MAGE folded before Flop (didn't bet)
Seat 8: AresVaettur folded before Flop (didn't bet)



PokerStars Hand #255215271056: Tournament #3863783058, $9.80+$1.20 USD Hold'em No Limit - Level XIII (350/700) - 2025/03/09 20:24:25 WET [2025/03/09 16:24:25 ET]
Table '3863783058 225' 8-max Seat #2 is the button
Seat 1: MrPufies (49740 in chips) 
Seat 2: zetorrao (17536 in chips) 
Seat 3: mrhom1 (12706 in chips) 
Seat 4: LordAzils002 (25970 in chips) 
Seat 5: Kevin12345Mc (21549 in chips) 
Seat 6: SannyMielly (80500 in chips) 
Seat 7: D0MAGE (34193 in chips) 
Seat 8: AresVaettur (15200 in chips) 
MrPufies: posts the ante 80
zetorrao: posts the ante 80
mrhom1: posts the ante 80
LordAzils002: posts the ante 80
Kevin12345Mc: posts the ante 80
SannyMielly: posts the ante 80
D0MAGE: posts the ante 80
AresVaettur: posts the ante 80
mrhom1: posts small blind 350
LordAzils002: posts big blind 700
*** HOLE CARDS ***
Dealt to Kevin12345Mc [Kh Td]
Kevin12345Mc: folds 
SannyMielly: raises 700 to 1400
D0MAGE: folds 
AresVaettur: raises 13720 to 15120 and is all-in
MrPufies: folds 
zetorrao: folds 
mrhom1: calls 12276 and is all-in
LordAzils002: folds 
SannyMielly: folds 
Uncalled bet (2494) returned to AresVaettur
*** FLOP *** [9h 4c Th]
*** TURN *** [9h 4c Th] [8s]
*** RIVER *** [9h 4c Th 8s] [8c]
*** SHOW DOWN ***
mrhom1: shows [Qh Jh] (a straight, Eight to Queen)
AresVaettur: shows [7c 7d] (two pair, Eights and Sevens)
mrhom1 collected 27992 from pot
*** SUMMARY ***
Total pot 27992 | Rake 0 
Board [9h 4c Th 8s 8c]
Seat 1: MrPufies folded before Flop (didn't bet)
Seat 2: zetorrao (button) folded before Flop (didn't bet)
Seat 3: mrhom1 (small blind) showed [Qh Jh] and won (27992) with a straight, Eight to Queen
Seat 4: LordAzils002 (big blind) folded before Flop
Seat 5: Kevin12345Mc folded before Flop (didn't bet)
Seat 6: SannyMielly folded before Flop
Seat 7: D0MAGE folded before Flop (didn't bet)
Seat 8: AresVaettur showed [7c 7d] and lost with two pair, Eights and Sevens



PokerStars Hand #255215287476: Tournament #3863783058, $9.80+$1.20 USD Hold'em No Limit - Level XIV (400/800) - 2025/03/09 20:25:10 WET [2025/03/09 16:25:10 ET]
Table '3863783058 225' 8-max Seat #3 is the button
Seat 1: MrPufies (49660 in chips) 
Seat 2: zetorrao (17456 in chips) 
Seat 3: mrhom1 (27992 in chips) 
Seat 4: LordAzils002 (25190 in chips) 
Seat 5: Kevin12345Mc (21469 in chips) 
Seat 6: SannyMielly (79020 in chips) 
Seat 7: D0MAGE (34113 in chips) 
Seat 8: AresVaettur (2494 in chips) 
MrPufies: posts the ante 100
zetorrao: posts the ante 100
mrhom1: posts the ante 100
LordAzils002: posts the ante 100
Kevin12345Mc: posts the ante 100
SannyMielly: posts the ante 100
D0MAGE: posts the ante 100
AresVaettur: posts the ante 100
LordAzils002: posts small blind 400
Kevin12345Mc: posts big blind 800
*** HOLE CARDS ***
Dealt to Kevin12345Mc [Ad Ks]
SannyMielly: folds 
D0MAGE: folds 
AresVaettur: folds 
MrPufies: calls 800
zetorrao: folds 
mrhom1: folds 
LordAzils002: folds 
Kevin12345Mc: raises 3200 to 4000
MrPufies: folds 
Uncalled bet (3200) returned to Kevin12345Mc
Kevin12345Mc collected 2800 from pot
Kevin12345Mc: doesn't show hand 
*** SUMMARY ***
Total pot 2800 | Rake 0 
Seat 1: MrPufies folded before Flop
Seat 2: zetorrao folded before Flop (didn't bet)
Seat 3: mrhom1 (button) folded before Flop (didn't bet)
Seat 4: LordAzils002 (small blind) folded before Flop
Seat 5: Kevin12345Mc (big blind) collected (2800)
Seat 6: SannyMielly folded before Flop (didn't bet)
Seat 7: D0MAGE folded before Flop (didn't bet)
Seat 8: AresVaettur folded before Flop (didn't bet)



PokerStars Hand #255215302073: Tournament #3863783058, $9.80+$1.20 USD Hold'em No Limit - Level XIV (400/800) - 2025/03/09 20:25:50 WET [2025/03/09 16:25:50 ET]
Table '3863783058 225' 8-max Seat #4 is the button
Seat 1: MrPufies (48760 in chips) 
Seat 2: zetorrao (17356 in chips) 
Seat 3: mrhom1 (27892 in chips) 
Seat 4: LordAzils002 (24690 in chips) 
Seat 5: Kevin12345Mc (23369 in chips) 
Seat 6: SannyMielly (78920 in chips) 
Seat 7: D0MAGE (34013 in chips) 
Seat 8: AresVaettur (2394 in chips) 
MrPufies: posts the ante 100
zetorrao: posts the ante 100
mrhom1: posts the ante 100
LordAzils002: posts the ante 100
Kevin12345Mc: posts the ante 100
SannyMielly: posts the ante 100
D0MAGE: posts the ante 100
AresVaettur: posts the ante 100
Kevin12345Mc: posts small blind 400
SannyMielly: posts big blind 800
*** HOLE CARDS ***
Dealt to Kevin12345Mc [2c Js]
D0MAGE: folds 
AresVaettur: folds 
MrPufies: raises 800 to 1600
zetorrao: folds 
mrhom1: calls 1600
LordAzils002: calls 1600
Kevin12345Mc: folds 
SannyMielly: folds 
*** FLOP *** [Jh 6d Td]
MrPufies: checks 
mrhom1: checks 
LordAzils002: bets 2244
MrPufies: calls 2244
mrhom1: folds 
*** TURN *** [Jh 6d Td] [6c]
MrPufies: checks 
LordAzils002: bets 7450
MrPufies: folds 
Uncalled bet (7450) returned to LordAzils002
LordAzils002 collected 11288 from pot
LordAzils002: doesn't show hand 
*** SUMMARY ***
Total pot 11288 | Rake 0 
Board [Jh 6d Td 6c]
Seat 1: MrPufies folded on the Turn
Seat 2: zetorrao folded before Flop (didn't bet)
Seat 3: mrhom1 folded on the Flop
Seat 4: LordAzils002 (button) collected (11288)
Seat 5: Kevin12345Mc (small blind) folded before Flop
Seat 6: SannyMielly (big blind) folded before Flop
Seat 7: D0MAGE folded before Flop (didn't bet)
Seat 8: AresVaettur folded before Flop (didn't bet)



PokerStars Hand #255215341665: Tournament #3863783058, $9.80+$1.20 USD Hold'em No Limit - Level XIV (400/800) - 2025/03/09 20:27:38 WET [2025/03/09 16:27:38 ET]
Table '3863783058 225' 8-max Seat #5 is the button
Seat 1: MrPufies (44816 in chips) 
Seat 2: zetorrao (17256 in chips) 
Seat 3: mrhom1 (26192 in chips) 
Seat 4: LordAzils002 (32034 in chips) 
Seat 5: Kevin12345Mc (22869 in chips) 
Seat 6: SannyMielly (78020 in chips) 
Seat 7: D0MAGE (33913 in chips) 
Seat 8: AresVaettur (2294 in chips) 
MrPufies: posts the ante 100
zetorrao: posts the ante 100
mrhom1: posts the ante 100
LordAzils002: posts the ante 100
Kevin12345Mc: posts the ante 100
SannyMielly: posts the ante 100
D0MAGE: posts the ante 100
AresVaettur: posts the ante 100
SannyMielly: posts small blind 400
D0MAGE: posts big blind 800
*** HOLE CARDS ***
Dealt to Kevin12345Mc [Ts Kc]
AresVaettur: raises 1394 to 2194 and is all-in
MrPufies: folds 
zetorrao: folds 
mrhom1: folds 
LordAzils002: folds 
Kevin12345Mc: calls 2194
SannyMielly: calls 1794
D0MAGE: folds 
*** FLOP *** [6h 8s 4c]
SannyMielly: checks 
Kevin12345Mc: checks 
*** TURN *** [6h 8s 4c] [7s]
SannyMielly: checks 
Kevin12345Mc: checks 
*** RIVER *** [6h 8s 4c 7s] [Jh]
SannyMielly: checks 
Kevin12345Mc: checks 
*** SHOW DOWN ***
SannyMielly: shows [Ad 4d] (a pair of Fours)
AresVaettur: mucks hand 
Kevin12345Mc: mucks hand 
SannyMielly collected 8182 from pot
AresVaettur finished the tournament
*** SUMMARY ***
Total pot 8182 | Rake 0 
Board [6h 8s 4c 7s Jh]
Seat 1: MrPufies folded before Flop (didn't bet)
Seat 2: zetorrao folded before Flop (didn't bet)
Seat 3: mrhom1 folded before Flop (didn't bet)
Seat 4: LordAzils002 folded before Flop (didn't bet)
Seat 5: Kevin12345Mc (button) mucked [Ts Kc]
Seat 6: SannyMielly (small blind) showed [Ad 4d] and won (8182) with a pair of Fours
Seat 7: D0MAGE (big blind) folded before Flop
Seat 8: AresVaettur mucked [2s Ac]



PokerStars Hand #255215363814: Tournament #3863783058, $9.80+$1.20 USD Hold'em No Limit - Level XIV (400/800) - 2025/03/09 20:28:39 WET [2025/03/09 16:28:39 ET]
Table '3863783058 225' 8-max Seat #6 is the button
Seat 1: MrPufies (44716 in chips) 
Seat 2: zetorrao (17156 in chips) 
Seat 3: mrhom1 (26092 in chips) 
Seat 4: LordAzils002 (31934 in chips) 
Seat 5: Kevin12345Mc (20575 in chips) 
Seat 6: SannyMielly (83908 in chips) 
Seat 7: D0MAGE (33013 in chips) 
Seat 8: Evux001 (10000 in chips) 
MrPufies: posts the ante 100
zetorrao: posts the ante 100
mrhom1: posts the ante 100
LordAzils002: posts the ante 100
Kevin12345Mc: posts the ante 100
SannyMielly: posts the ante 100
D0MAGE: posts the ante 100
Evux001: posts the ante 100
D0MAGE: posts small blind 400
Evux001: posts big blind 800
*** HOLE CARDS ***
Dealt to Kevin12345Mc [6s 4d]
MrPufies: folds 
zetorrao: calls 800
mrhom1: folds 
LordAzils002: folds 
Kevin12345Mc: folds 
SannyMielly: folds 
D0MAGE: folds 
Evux001: checks 
*** FLOP *** [3h Ad Js]
Evux001: checks 
zetorrao: checks 
*** TURN *** [3h Ad Js] [Kh]
Evux001: checks 
zetorrao: checks 
*** RIVER *** [3h Ad Js Kh] [2h]
Evux001: checks 
zetorrao: checks 
*** SHOW DOWN ***
Evux001: shows [5d 3s] (a pair of Threes)
zetorrao: shows [Jc 9c] (a pair of Jacks)
zetorrao collected 2800 from pot
*** SUMMARY ***
Total pot 2800 | Rake 0 
Board [3h Ad Js Kh 2h]
Seat 1: MrPufies folded before Flop (didn't bet)
Seat 2: zetorrao showed [Jc 9c] and won (2800) with a pair of Jacks
Seat 3: mrhom1 folded before Flop (didn't bet)
Seat 4: LordAzils002 folded before Flop (didn't bet)
Seat 5: Kevin12345Mc folded before Flop (didn't bet)
Seat 6: SannyMielly (button) folded before Flop (didn't bet)
Seat 7: D0MAGE (small blind) folded before Flop
Seat 8: Evux001 (big blind) showed [5d 3s] and lost with a pair of Threes



PokerStars Hand #255215382772: Tournament #3863783058, $9.80+$1.20 USD Hold'em No Limit - Level XIV (400/800) - 2025/03/09 20:29:31 WET [2025/03/09 16:29:31 ET]
Table '3863783058 225' 8-max Seat #7 is the button
Seat 1: MrPufies (44616 in chips) 
Seat 2: zetorrao (19056 in chips) 
Seat 3: mrhom1 (25992 in chips) 
Seat 4: LordAzils002 (31834 in chips) 
Seat 5: Kevin12345Mc (20475 in chips) 
Seat 6: SannyMielly (83808 in chips) 
Seat 7: D0MAGE (32513 in chips) 
Seat 8: Evux001 (9100 in chips) 
MrPufies: posts the ante 100
zetorrao: posts the ante 100
mrhom1: posts the ante 100
LordAzils002: posts the ante 100
Kevin12345Mc: posts the ante 100
SannyMielly: posts the ante 100
D0MAGE: posts the ante 100
Evux001: posts the ante 100
Evux001: posts small blind 400
MrPufies: posts big blind 800
*** HOLE CARDS ***
Dealt to Kevin12345Mc [8c Qc]
zetorrao: folds 
mrhom1: folds 
LordAzils002: folds 
Kevin12345Mc: raises 880 to 1680
SannyMielly: folds 
D0MAGE: folds 
Evux001: folds 
MrPufies: folds 
Uncalled bet (880) returned to Kevin12345Mc
Kevin12345Mc collected 2800 from pot
Kevin12345Mc: doesn't show hand 
*** SUMMARY ***
Total pot 2800 | Rake 0 
Seat 1: MrPufies (big blind) folded before Flop
Seat 2: zetorrao folded before Flop (didn't bet)
Seat 3: mrhom1 folded before Flop (didn't bet)
Seat 4: LordAzils002 folded before Flop (didn't bet)
Seat 5: Kevin12345Mc collected (2800)
Seat 6: SannyMielly folded before Flop (didn't bet)
Seat 7: D0MAGE (button) folded before Flop (didn't bet)
Seat 8: Evux001 (small blind) folded before Flop



PokerStars Hand #255215396021: Tournament #3863783058, $9.80+$1.20 USD Hold'em No Limit - Level XIV (400/800) - 2025/03/09 20:30:07 WET [2025/03/09 16:30:07 ET]
Table '3863783058 225' 8-max Seat #8 is the button
Seat 1: MrPufies (43716 in chips) 
Seat 2: zetorrao (18956 in chips) 
Seat 3: mrhom1 (25892 in chips) 
Seat 4: LordAzils002 (31734 in chips) 
Seat 5: Kevin12345Mc (22375 in chips) 
Seat 6: SannyMielly (83708 in chips) 
Seat 7: D0MAGE (32413 in chips) 
Seat 8: Evux001 (8600 in chips) 
MrPufies: posts the ante 100
zetorrao: posts the ante 100
mrhom1: posts the ante 100
LordAzils002: posts the ante 100
Kevin12345Mc: posts the ante 100
SannyMielly: posts the ante 100
D0MAGE: posts the ante 100
Evux001: posts the ante 100
MrPufies: posts small blind 400
zetorrao: posts big blind 800
*** HOLE CARDS ***
Dealt to Kevin12345Mc [3s Th]
mrhom1: folds 
LordAzils002: folds 
Kevin12345Mc: folds 
SannyMielly: folds 
D0MAGE: raises 984 to 1784
Evux001: folds 
MrPufies: calls 1384
zetorrao: folds 
*** FLOP *** [Ks Jd 4c]
MrPufies: checks 
D0MAGE: bets 2584
MrPufies: folds 
Uncalled bet (2584) returned to D0MAGE
D0MAGE collected 5168 from pot
D0MAGE: doesn't show hand 
*** SUMMARY ***
Total pot 5168 | Rake 0 
Board [Ks Jd 4c]
Seat 1: MrPufies (small blind) folded on the Flop
Seat 2: zetorrao (big blind) folded before Flop
Seat 3: mrhom1 folded before Flop (didn't bet)
Seat 4: LordAzils002 folded before Flop (didn't bet)
Seat 5: Kevin12345Mc folded before Flop (didn't bet)
Seat 6: SannyMielly folded before Flop (didn't bet)
Seat 7: D0MAGE collected (5168)
Seat 8: Evux001 (button) folded before Flop (didn't bet)



PokerStars Hand #255215418307: Tournament #3863783058, $9.80+$1.20 USD Hold'em No Limit - Level XIV (400/800) - 2025/03/09 20:31:07 WET [2025/03/09 16:31:07 ET]
Table '3863783058 225' 8-max Seat #1 is the button
Seat 1: MrPufies (41832 in chips) 
Seat 2: zetorrao (18056 in chips) 
Seat 3: mrhom1 (25792 in chips) 
Seat 4: LordAzils002 (31634 in chips) 
Seat 5: Kevin12345Mc (22275 in chips) 
Seat 6: SannyMielly (83608 in chips) 
Seat 7: D0MAGE (35697 in chips) 
Seat 8: Evux001 (8500 in chips) 
MrPufies: posts the ante 100
zetorrao: posts the ante 100
mrhom1: posts the ante 100
LordAzils002: posts the ante 100
Kevin12345Mc: posts the ante 100
SannyMielly: posts the ante 100
D0MAGE: posts the ante 100
Evux001: posts the ante 100
zetorrao: posts small blind 400
mrhom1: posts big blind 800
*** HOLE CARDS ***
Dealt to Kevin12345Mc [2d Ad]
LordAzils002: folds 
Kevin12345Mc: raises 880 to 1680
SannyMielly: folds 
D0MAGE: folds 
Evux001: folds 
MrPufies: folds 
zetorrao: folds 
mrhom1: calls 880
*** FLOP *** [Ac 2s 3d]
mrhom1: checks 
Kevin12345Mc: bets 1505
mrhom1: folds 
Uncalled bet (1505) returned to Kevin12345Mc
Kevin12345Mc collected 4560 from pot
Kevin12345Mc: doesn't show hand 
*** SUMMARY ***
Total pot 4560 | Rake 0 
Board [Ac 2s 3d]
Seat 1: MrPufies (button) folded before Flop (didn't bet)
Seat 2: zetorrao (small blind) folded before Flop
Seat 3: mrhom1 (big blind) folded on the Flop
Seat 4: LordAzils002 folded before Flop (didn't bet)
Seat 5: Kevin12345Mc collected (4560)
Seat 6: SannyMielly folded before Flop (didn't bet)
Seat 7: D0MAGE folded before Flop (didn't bet)
Seat 8: Evux001 folded before Flop (didn't bet)



PokerStars Hand #255215440731: Tournament #3863783058, $9.80+$1.20 USD Hold'em No Limit - Level XIV (400/800) - 2025/03/09 20:32:08 WET [2025/03/09 16:32:08 ET]
Table '3863783058 225' 8-max Seat #2 is the button
Seat 1: MrPufies (41732 in chips) 
Seat 2: zetorrao (17556 in chips) 
Seat 3: mrhom1 (24012 in chips) 
Seat 4: LordAzils002 (31534 in chips) 
Seat 5: Kevin12345Mc (25055 in chips) 
Seat 6: SannyMielly (83508 in chips) 
Seat 7: D0MAGE (35597 in chips) 
Seat 8: Evux001 (8400 in chips) 
MrPufies: posts the ante 100
zetorrao: posts the ante 100
mrhom1: posts the ante 100
LordAzils002: posts the ante 100
Kevin12345Mc: posts the ante 100
SannyMielly: posts the ante 100
D0MAGE: posts the ante 100
Evux001: posts the ante 100
mrhom1: posts small blind 400
LordAzils002: posts big blind 800
*** HOLE CARDS ***
Dealt to Kevin12345Mc [Qs 8c]
Kevin12345Mc: folds 
SannyMielly: folds 
D0MAGE: folds 
Evux001: folds 
MrPufies: raises 800 to 1600
zetorrao: folds 
mrhom1: calls 1200
LordAzils002: folds 
*** FLOP *** [6c 5d 3c]
mrhom1: checks 
MrPufies: checks 
*** TURN *** [6c 5d 3c] [Ad]
mrhom1: checks 
MrPufies: bets 1920
mrhom1: folds 
Uncalled bet (1920) returned to MrPufies
MrPufies collected 4800 from pot
MrPufies: doesn't show hand 
*** SUMMARY ***
Total pot 4800 | Rake 0 
Board [6c 5d 3c Ad]
Seat 1: MrPufies collected (4800)
Seat 2: zetorrao (button) folded before Flop (didn't bet)
Seat 3: mrhom1 (small blind) folded on the Turn
Seat 4: LordAzils002 (big blind) folded before Flop
Seat 5: Kevin12345Mc folded before Flop (didn't bet)
Seat 6: SannyMielly folded before Flop (didn't bet)
Seat 7: D0MAGE folded before Flop (didn't bet)
Seat 8: Evux001 folded before Flop (didn't bet)



PokerStars Hand #255215460677: Tournament #3863783058, $9.80+$1.20 USD Hold'em No Limit - Level XIV (400/800) - 2025/03/09 20:33:03 WET [2025/03/09 16:33:03 ET]
Table '3863783058 225' 8-max Seat #3 is the button
Seat 1: MrPufies (44832 in chips) 
Seat 2: zetorrao (17456 in chips) 
Seat 3: mrhom1 (22312 in chips) 
Seat 4: LordAzils002 (30634 in chips) 
Seat 5: Kevin12345Mc (24955 in chips) 
Seat 6: SannyMielly (83408 in chips) 
Seat 7: D0MAGE (35497 in chips) 
Seat 8: Evux001 (8300 in chips) 
MrPufies: posts the ante 100
zetorrao: posts the ante 100
mrhom1: posts the ante 100
LordAzils002: posts the ante 100
Kevin12345Mc: posts the ante 100
SannyMielly: posts the ante 100
D0MAGE: posts the ante 100
Evux001: posts the ante 100
LordAzils002: posts small blind 400
Kevin12345Mc: posts big blind 800
*** HOLE CARDS ***
Dealt to Kevin12345Mc [7s Kd]
SannyMielly: folds 
D0MAGE: folds 
Evux001: folds 
MrPufies: folds 
zetorrao: calls 800
mrhom1: folds 
LordAzils002: calls 400
Kevin12345Mc: checks 
*** FLOP *** [9d 6h 3h]
LordAzils002: checks 
Kevin12345Mc: checks 
zetorrao: checks 
*** TURN *** [9d 6h 3h] [4c]
LordAzils002: checks 
Kevin12345Mc: checks 
zetorrao: checks 
*** RIVER *** [9d 6h 3h 4c] [4d]
LordAzils002: checks 
Kevin12345Mc: checks 
zetorrao: checks 
*** SHOW DOWN ***
LordAzils002: shows [5s Qc] (a pair of Fours)
Kevin12345Mc: shows [7s Kd] (a pair of Fours - King kicker)
zetorrao: mucks hand 
Kevin12345Mc collected 3200 from pot
*** SUMMARY ***
Total pot 3200 | Rake 0 
Board [9d 6h 3h 4c 4d]
Seat 1: MrPufies folded before Flop (didn't bet)
Seat 2: zetorrao mucked [8s Js]
Seat 3: mrhom1 (button) folded before Flop (didn't bet)
Seat 4: LordAzils002 (small blind) showed [5s Qc] and lost with a pair of Fours
Seat 5: Kevin12345Mc (big blind) showed [7s Kd] and won (3200) with a pair of Fours
Seat 6: SannyMielly folded before Flop (didn't bet)
Seat 7: D0MAGE folded before Flop (didn't bet)
Seat 8: Evux001 folded before Flop (didn't bet)



PokerStars Hand #255215488560: Tournament #3863783058, $9.80+$1.20 USD Hold'em No Limit - Level XIV (400/800) - 2025/03/09 20:34:20 WET [2025/03/09 16:34:20 ET]
Table '3863783058 225' 8-max Seat #4 is the button
Seat 1: MrPufies (44732 in chips) 
Seat 2: zetorrao (16556 in chips) 
Seat 3: mrhom1 (22212 in chips) 
Seat 4: LordAzils002 (29734 in chips) 
Seat 5: Kevin12345Mc (27255 in chips) 
Seat 6: SannyMielly (83308 in chips) 
Seat 7: D0MAGE (35397 in chips) 
Seat 8: Evux001 (8200 in chips) 
MrPufies: posts the ante 100
zetorrao: posts the ante 100
mrhom1: posts the ante 100
LordAzils002: posts the ante 100
Kevin12345Mc: posts the ante 100
SannyMielly: posts the ante 100
D0MAGE: posts the ante 100
Evux001: posts the ante 100
Kevin12345Mc: posts small blind 400
SannyMielly: posts big blind 800
*** HOLE CARDS ***
Dealt to Kevin12345Mc [5d 6h]
D0MAGE: folds 
Evux001: folds 
MrPufies: folds 
zetorrao: calls 800
mrhom1: folds 
LordAzils002: folds 
Kevin12345Mc: folds 
SannyMielly: checks 
*** FLOP *** [Qh Qd Qc]
SannyMielly: checks 
zetorrao: checks 
*** TURN *** [Qh Qd Qc] [Jc]
SannyMielly: checks 
zetorrao: checks 
*** RIVER *** [Qh Qd Qc Jc] [3d]
SannyMielly: checks 
zetorrao: checks 
*** SHOW DOWN ***
SannyMielly: shows [8h 4s] (three of a kind, Queens)
zetorrao: shows [Ac 4c] (three of a kind, Queens - Ace kicker)
zetorrao collected 2800 from pot
*** SUMMARY ***
Total pot 2800 | Rake 0 
Board [Qh Qd Qc Jc 3d]
Seat 1: MrPufies folded before Flop (didn't bet)
Seat 2: zetorrao showed [Ac 4c] and won (2800) with three of a kind, Queens
Seat 3: mrhom1 folded before Flop (didn't bet)
Seat 4: LordAzils002 (button) folded before Flop (didn't bet)
Seat 5: Kevin12345Mc (small blind) folded before Flop
Seat 6: SannyMielly (big blind) showed [8h 4s] and lost with three of a kind, Queens
Seat 7: D0MAGE folded before Flop (didn't bet)
Seat 8: Evux001 folded before Flop (didn't bet)



PokerStars Hand #255215521504: Tournament #3863783058, $9.80+$1.20 USD Hold'em No Limit - Level XV (500/1000) - 2025/03/09 20:35:50 WET [2025/03/09 16:35:50 ET]
Table '3863783058 225' 8-max Seat #5 is the button
Seat 1: MrPufies (44632 in chips) 
Seat 2: zetorrao (18456 in chips) 
Seat 3: mrhom1 (22112 in chips) 
Seat 4: LordAzils002 (29634 in chips) 
Seat 5: Kevin12345Mc (26755 in chips) 
Seat 6: SannyMielly (82408 in chips) 
Seat 7: D0MAGE (35297 in chips) 
Seat 8: Evux001 (8100 in chips) 
MrPufies: posts the ante 120
zetorrao: posts the ante 120
mrhom1: posts the ante 120
LordAzils002: posts the ante 120
Kevin12345Mc: posts the ante 120
SannyMielly: posts the ante 120
D0MAGE: posts the ante 120
Evux001: posts the ante 120
SannyMielly: posts small blind 500
D0MAGE: posts big blind 1000
*** HOLE CARDS ***
Dealt to Kevin12345Mc [5d 8s]
Evux001: calls 1000
MrPufies: folds 
zetorrao: calls 1000
mrhom1: folds 
LordAzils002: folds 
Kevin12345Mc: folds 
SannyMielly: calls 500
D0MAGE: checks 
*** FLOP *** [Jd 3c Qd]
SannyMielly: checks 
D0MAGE: checks 
Evux001: checks 
zetorrao: bets 1000
SannyMielly: calls 1000
D0MAGE: folds 
Evux001: folds 
*** TURN *** [Jd 3c Qd] [Th]
SannyMielly: checks 
zetorrao: bets 1000
SannyMielly: calls 1000
*** RIVER *** [Jd 3c Qd Th] [2h]
SannyMielly: checks 
zetorrao: bets 1000
SannyMielly: calls 1000
*** SHOW DOWN ***
zetorrao: shows [Qc Kd] (a pair of Queens)
SannyMielly: mucks hand 
zetorrao collected 10960 from pot
*** SUMMARY ***
Total pot 10960 | Rake 0 
Board [Jd 3c Qd Th 2h]
Seat 1: MrPufies folded before Flop (didn't bet)
Seat 2: zetorrao showed [Qc Kd] and won (10960) with a pair of Queens
Seat 3: mrhom1 folded before Flop (didn't bet)
Seat 4: LordAzils002 folded before Flop (didn't bet)
Seat 5: Kevin12345Mc (button) folded before Flop (didn't bet)
Seat 6: SannyMielly (small blind) mucked [Js 8c]
Seat 7: D0MAGE (big blind) folded on the Flop
Seat 8: Evux001 folded on the Flop



PokerStars Hand #255215556969: Tournament #3863783058, $9.80+$1.20 USD Hold'em No Limit - Level XV (500/1000) - 2025/03/09 20:37:28 WET [2025/03/09 16:37:28 ET]
Table '3863783058 225' 8-max Seat #6 is the button
Seat 1: MrPufies (44512 in chips) 
Seat 2: zetorrao (25296 in chips) 
Seat 3: mrhom1 (21992 in chips) 
Seat 4: LordAzils002 (29514 in chips) 
Seat 5: Kevin12345Mc (26635 in chips) 
Seat 6: SannyMielly (78288 in chips) 
Seat 7: D0MAGE (34177 in chips) 
Seat 8: Evux001 (6980 in chips) 
MrPufies: posts the ante 120
zetorrao: posts the ante 120
mrhom1: posts the ante 120
LordAzils002: posts the ante 120
Kevin12345Mc: posts the ante 120
SannyMielly: posts the ante 120
D0MAGE: posts the ante 120
Evux001: posts the ante 120
D0MAGE: posts small blind 500
Evux001: posts big blind 1000
*** HOLE CARDS ***
Dealt to Kevin12345Mc [Td 5c]
MrPufies: folds 
zetorrao: folds 
mrhom1: folds 
LordAzils002: folds 
Kevin12345Mc: folds 
SannyMielly: folds 
D0MAGE: calls 500
Evux001: checks 
*** FLOP *** [Jc 5d Qc]
D0MAGE: bets 1000
Evux001: folds 
Uncalled bet (1000) returned to D0MAGE
D0MAGE collected 2960 from pot
D0MAGE: doesn't show hand 
*** SUMMARY ***
Total pot 2960 | Rake 0 
Board [Jc 5d Qc]
Seat 1: MrPufies folded before Flop (didn't bet)
Seat 2: zetorrao folded before Flop (didn't bet)
Seat 3: mrhom1 folded before Flop (didn't bet)
Seat 4: LordAzils002 folded before Flop (didn't bet)
Seat 5: Kevin12345Mc folded before Flop (didn't bet)
Seat 6: SannyMielly (button) folded before Flop (didn't bet)
Seat 7: D0MAGE (small blind) collected (2960)
Seat 8: Evux001 (big blind) folded on the Flop



PokerStars Hand #255215578781: Tournament #3863783058, $9.80+$1.20 USD Hold'em No Limit - Level XV (500/1000) - 2025/03/09 20:38:29 WET [2025/03/09 16:38:29 ET]
Table '3863783058 225' 8-max Seat #7 is the button
Seat 1: MrPufies (44392 in chips) 
Seat 2: zetorrao (25176 in chips) 
Seat 3: mrhom1 (21872 in chips) 
Seat 4: LordAzils002 (29394 in chips) 
Seat 5: Kevin12345Mc (26515 in chips) 
Seat 6: SannyMielly (78168 in chips) 
Seat 7: D0MAGE (36017 in chips) 
Seat 8: Evux001 (5860 in chips) 
MrPufies: posts the ante 120
zetorrao: posts the ante 120
mrhom1: posts the ante 120
LordAzils002: posts the ante 120
Kevin12345Mc: posts the ante 120
SannyMielly: posts the ante 120
D0MAGE: posts the ante 120
Evux001: posts the ante 120
Evux001: posts small blind 500
MrPufies: posts big blind 1000
*** HOLE CARDS ***
Dealt to Kevin12345Mc [6c Ks]
zetorrao: calls 1000
mrhom1: calls 1000
LordAzils002: folds 
Kevin12345Mc: folds 
SannyMielly: folds 
D0MAGE: folds 
Evux001: calls 500
MrPufies: checks 
*** FLOP *** [8h 6h Tc]
Evux001: checks 
MrPufies: checks 
zetorrao: checks 
mrhom1: bets 1480
Evux001: folds 
MrPufies: folds 
zetorrao: folds 
Uncalled bet (1480) returned to mrhom1
mrhom1 collected 4960 from pot
*** SUMMARY ***
Total pot 4960 | Rake 0 
Board [8h 6h Tc]
Seat 1: MrPufies (big blind) folded on the Flop
Seat 2: zetorrao folded on the Flop
Seat 3: mrhom1 collected (4960)
Seat 4: LordAzils002 folded before Flop (didn't bet)
Seat 5: Kevin12345Mc folded before Flop (didn't bet)
Seat 6: SannyMielly folded before Flop (didn't bet)
Seat 7: D0MAGE (button) folded before Flop (didn't bet)
Seat 8: Evux001 (small blind) folded on the Flop



PokerStars Hand #255215603017: Tournament #3863783058, $9.80+$1.20 USD Hold'em No Limit - Level XV (500/1000) - 2025/03/09 20:39:35 WET [2025/03/09 16:39:35 ET]
Table '3863783058 225' 8-max Seat #8 is the button
Seat 1: MrPufies (43272 in chips) 
Seat 3: mrhom1 (25712 in chips) 
Seat 4: LordAzils002 (29274 in chips) 
Seat 5: Kevin12345Mc (26395 in chips) 
Seat 6: SannyMielly (78048 in chips) 
Seat 7: D0MAGE (35897 in chips) 
Seat 8: Evux001 (4740 in chips) 
MrPufies: posts the ante 120
mrhom1: posts the ante 120
LordAzils002: posts the ante 120
Kevin12345Mc: posts the ante 120
SannyMielly: posts the ante 120
D0MAGE: posts the ante 120
Evux001: posts the ante 120
MrPufies: posts small blind 500
mrhom1: posts big blind 1000
*** HOLE CARDS ***
Dealt to Kevin12345Mc [8h 3h]
whittersman is disconnected 
LordAzils002: folds 
Kevin12345Mc: folds 
SannyMielly: folds 
D0MAGE: folds 
Evux001: raises 3620 to 4620 and is all-in
MrPufies: calls 4120
mrhom1: folds 
*** FLOP *** [5d Jd 2c]
*** TURN *** [5d Jd 2c] [Tc]
*** RIVER *** [5d Jd 2c Tc] [Ks]
*** SHOW DOWN ***
MrPufies: shows [Jh Qs] (a pair of Jacks)
Evux001: shows [Js Qc] (a pair of Jacks)
MrPufies collected 5540 from pot
Evux001 collected 5540 from pot
*** SUMMARY ***
Total pot 11080 | Rake 0 
Board [5d Jd 2c Tc Ks]
Seat 1: MrPufies (small blind) showed [Jh Qs] and won (5540) with a pair of Jacks
Seat 3: mrhom1 (big blind) folded before Flop
Seat 4: LordAzils002 folded before Flop (didn't bet)
Seat 5: Kevin12345Mc folded before Flop (didn't bet)
Seat 6: SannyMielly folded before Flop (didn't bet)
Seat 7: D0MAGE folded before Flop (didn't bet)
Seat 8: Evux001 (button) showed [Js Qc] and won (5540) with a pair of Jacks



PokerStars Hand #255215619697: Tournament #3863783058, $9.80+$1.20 USD Hold'em No Limit - Level XV (500/1000) - 2025/03/09 20:40:21 WET [2025/03/09 16:40:21 ET]
Table '3863783058 225' 8-max Seat #1 is the button
Seat 1: MrPufies (44072 in chips) 
Seat 2: whittersman (23862 in chips) out of hand (moved from another table into small blind)
Seat 3: mrhom1 (24592 in chips) 
Seat 4: LordAzils002 (29154 in chips) 
Seat 5: Kevin12345Mc (26275 in chips) 
Seat 6: SannyMielly (77928 in chips) 
Seat 7: D0MAGE (35777 in chips) 
Seat 8: Evux001 (5540 in chips) 
whittersman will be allowed to play after the button
MrPufies: posts the ante 120
mrhom1: posts the ante 120
LordAzils002: posts the ante 120
Kevin12345Mc: posts the ante 120
SannyMielly: posts the ante 120
D0MAGE: posts the ante 120
Evux001: posts the ante 120
mrhom1: posts small blind 500
LordAzils002: posts big blind 1000
*** HOLE CARDS ***
Dealt to Kevin12345Mc [Ac 8h]
Kevin12345Mc: folds 
SannyMielly: raises 1000 to 2000
D0MAGE: folds 
Evux001: raises 3420 to 5420 and is all-in
MrPufies: folds 
mrhom1: folds 
LordAzils002: folds 
SannyMielly: calls 3420
*** FLOP *** [Qd Qh 3d]
*** TURN *** [Qd Qh 3d] [2c]
*** RIVER *** [Qd Qh 3d 2c] [6s]
*** SHOW DOWN ***
SannyMielly: shows [6h 6c] (a full house, Sixes full of Queens)
Evux001: shows [Jd Qc] (three of a kind, Queens)
SannyMielly collected 13180 from pot
Evux001 finished the tournament in 2189th place
*** SUMMARY ***
Total pot 13180 | Rake 0 
Board [Qd Qh 3d 2c 6s]
Seat 1: MrPufies (button) folded before Flop (didn't bet)
Seat 3: mrhom1 (small blind) folded before Flop
Seat 4: LordAzils002 (big blind) folded before Flop
Seat 5: Kevin12345Mc folded before Flop (didn't bet)
Seat 6: SannyMielly showed [6h 6c] and won (13180) with a full house, Sixes full of Queens
Seat 7: D0MAGE folded before Flop (didn't bet)
Seat 8: Evux001 showed [Jd Qc] and lost with three of a kind, Queens



PokerStars Hand #255215630811: Tournament #3863783058, $9.80+$1.20 USD Hold'em No Limit - Level XV (500/1000) - 2025/03/09 20:40:51 WET [2025/03/09 16:40:51 ET]
Table '3863783058 225' 8-max Seat #3 is the button
Seat 1: MrPufies (43952 in chips) 
Seat 2: whittersman (23862 in chips) 
Seat 3: mrhom1 (23972 in chips) 
Seat 4: LordAzils002 (28034 in chips) 
Seat 5: Kevin12345Mc (26155 in chips) 
Seat 6: SannyMielly (85568 in chips) 
Seat 7: D0MAGE (35657 in chips) 
MrPufies: posts the ante 120
whittersman: posts the ante 120
mrhom1: posts the ante 120
LordAzils002: posts the ante 120
Kevin12345Mc: posts the ante 120
SannyMielly: posts the ante 120
D0MAGE: posts the ante 120
LordAzils002: posts small blind 500
Kevin12345Mc: posts big blind 1000
*** HOLE CARDS ***
Dealt to Kevin12345Mc [9s Qs]
sharb777 is disconnected 
SannyMielly: raises 1000 to 2000
D0MAGE: folds 
MrPufies: folds 
whittersman: raises 21742 to 23742 and is all-in
mrhom1: folds 
LordAzils002: folds 
Kevin12345Mc: folds 
SannyMielly: folds 
Uncalled bet (21742) returned to whittersman
whittersman collected 6340 from pot
whittersman: doesn't show hand 
*** SUMMARY ***
Total pot 6340 | Rake 0 
Seat 1: MrPufies folded before Flop (didn't bet)
Seat 2: whittersman collected (6340)
Seat 3: mrhom1 (button) folded before Flop (didn't bet)
Seat 4: LordAzils002 (small blind) folded before Flop
Seat 5: Kevin12345Mc (big blind) folded before Flop
Seat 6: SannyMielly folded before Flop
Seat 7: D0MAGE folded before Flop (didn't bet)



PokerStars Hand #255215645481: Tournament #3863783058, $9.80+$1.20 USD Hold'em No Limit - Level XV (500/1000) - 2025/03/09 20:41:31 WET [2025/03/09 16:41:31 ET]
Table '3863783058 225' 8-max Seat #4 is the button
Seat 1: MrPufies (43832 in chips) 
Seat 2: whittersman (28082 in chips) 
Seat 3: mrhom1 (23852 in chips) 
Seat 4: LordAzils002 (27414 in chips) 
Seat 5: Kevin12345Mc (25035 in chips) 
Seat 6: SannyMielly (83448 in chips) 
Seat 7: D0MAGE (35537 in chips) 
Seat 8: sharb777 (18780 in chips) 
MrPufies: posts the ante 120
whittersman: posts the ante 120
mrhom1: posts the ante 120
LordAzils002: posts the ante 120
Kevin12345Mc: posts the ante 120
SannyMielly: posts the ante 120
D0MAGE: posts the ante 120
sharb777: posts the ante 120
Kevin12345Mc: posts small blind 500
SannyMielly: posts big blind 1000
*** HOLE CARDS ***
Dealt to Kevin12345Mc [Tc 8d]
D0MAGE: folds 
sharb777: folds 
MrPufies: folds 
whittersman: folds 
mrhom1: folds 
LordAzils002: raises 1100 to 2100
Kevin12345Mc: folds 
SannyMielly: raises 5400 to 7500
LordAzils002: raises 19794 to 27294 and is all-in
SannyMielly: folds 
Uncalled bet (19794) returned to LordAzils002
LordAzils002 collected 16460 from pot
LordAzils002: doesn't show hand 
*** SUMMARY ***
Total pot 16460 | Rake 0 
Seat 1: MrPufies folded before Flop (didn't bet)
Seat 2: whittersman folded before Flop (didn't bet)
Seat 3: mrhom1 folded before Flop (didn't bet)
Seat 4: LordAzils002 (button) collected (16460)
Seat 5: Kevin12345Mc (small blind) folded before Flop
Seat 6: SannyMielly (big blind) folded before Flop
Seat 7: D0MAGE folded before Flop (didn't bet)
Seat 8: sharb777 folded before Flop (didn't bet)



PokerStars Hand #255215677906: Tournament #3863783058, $9.80+$1.20 USD Hold'em No Limit - Level XV (500/1000) - 2025/03/09 20:43:01 WET [2025/03/09 16:43:01 ET]
Table '3863783058 225' 8-max Seat #5 is the button
Seat 1: MrPufies (43712 in chips) 
Seat 2: whittersman (27962 in chips) 
Seat 3: mrhom1 (23732 in chips) 
Seat 4: LordAzils002 (36254 in chips) 
Seat 5: Kevin12345Mc (24415 in chips) 
Seat 6: SannyMielly (75828 in chips) 
Seat 7: D0MAGE (35417 in chips) 
Seat 8: sharb777 (18660 in chips) 
MrPufies: posts the ante 120
whittersman: posts the ante 120
mrhom1: posts the ante 120
LordAzils002: posts the ante 120
Kevin12345Mc: posts the ante 120
SannyMielly: posts the ante 120
D0MAGE: posts the ante 120
sharb777: posts the ante 120
SannyMielly: posts small blind 500
D0MAGE: posts big blind 1000
*** HOLE CARDS ***
Dealt to Kevin12345Mc [3s 7c]
sharb777: raises 1000 to 2000
MrPufies: folds 
whittersman: folds 
mrhom1: folds 
LordAzils002: folds 
Kevin12345Mc: folds 
SannyMielly: folds 
D0MAGE: folds 
Uncalled bet (1000) returned to sharb777
sharb777 collected 3460 from pot
*** SUMMARY ***
Total pot 3460 | Rake 0 
Seat 1: MrPufies folded before Flop (didn't bet)
Seat 2: whittersman folded before Flop (didn't bet)
Seat 3: mrhom1 folded before Flop (didn't bet)
Seat 4: LordAzils002 folded before Flop (didn't bet)
Seat 5: Kevin12345Mc (button) folded before Flop (didn't bet)
Seat 6: SannyMielly (small blind) folded before Flop
Seat 7: D0MAGE (big blind) folded before Flop
Seat 8: sharb777 collected (3460)



PokerStars Hand #255215686489: Tournament #3863783058, $9.80+$1.20 USD Hold'em No Limit - Level XV (500/1000) - 2025/03/09 20:43:25 WET [2025/03/09 16:43:25 ET]
Table '3863783058 225' 8-max Seat #6 is the button
Seat 1: MrPufies (43592 in chips) 
Seat 2: whittersman (27842 in chips) 
Seat 3: mrhom1 (23612 in chips) 
Seat 4: LordAzils002 (36134 in chips) 
Seat 5: Kevin12345Mc (24295 in chips) 
Seat 6: SannyMielly (75208 in chips) 
Seat 7: D0MAGE (34297 in chips) 
Seat 8: sharb777 (21000 in chips) 
MrPufies: posts the ante 120
whittersman: posts the ante 120
mrhom1: posts the ante 120
LordAzils002: posts the ante 120
Kevin12345Mc: posts the ante 120
SannyMielly: posts the ante 120
D0MAGE: posts the ante 120
sharb777: posts the ante 120
D0MAGE: posts small blind 500
sharb777: posts big blind 1000
*** HOLE CARDS ***
Dealt to Kevin12345Mc [9s 6c]
MrPufies: calls 1000
whittersman: folds 
mrhom1: folds 
LordAzils002: folds 
Kevin12345Mc: folds 
SannyMielly: folds 
D0MAGE: calls 500
sharb777: checks 
*** FLOP *** [Qh Tc 5h]
D0MAGE: checks 
sharb777: checks 
MrPufies: bets 1584
D0MAGE: folds 
sharb777: folds 
Uncalled bet (1584) returned to MrPufies
MrPufies collected 3960 from pot
MrPufies: doesn't show hand 
*** SUMMARY ***
Total pot 3960 | Rake 0 
Board [Qh Tc 5h]
Seat 1: MrPufies collected (3960)
Seat 2: whittersman folded before Flop (didn't bet)
Seat 3: mrhom1 folded before Flop (didn't bet)
Seat 4: LordAzils002 folded before Flop (didn't bet)
Seat 5: Kevin12345Mc folded before Flop (didn't bet)
Seat 6: SannyMielly (button) folded before Flop (didn't bet)
Seat 7: D0MAGE (small blind) folded on the Flop
Seat 8: sharb777 (big blind) folded on the Flop



PokerStars Hand #255215714714: Tournament #3863783058, $9.80+$1.20 USD Hold'em No Limit - Level XVI (600/1200) - 2025/03/09 20:44:43 WET [2025/03/09 16:44:43 ET]
Table '3863783058 225' 8-max Seat #7 is the button
Seat 1: MrPufies (46432 in chips) 
Seat 2: whittersman (27722 in chips) 
Seat 3: mrhom1 (23492 in chips) 
Seat 4: LordAzils002 (36014 in chips) 
Seat 5: Kevin12345Mc (24175 in chips) 
Seat 6: SannyMielly (75088 in chips) 
Seat 7: D0MAGE (33177 in chips) 
Seat 8: sharb777 (19880 in chips) 
MrPufies: posts the ante 160
whittersman: posts the ante 160
mrhom1: posts the ante 160
LordAzils002: posts the ante 160
Kevin12345Mc: posts the ante 160
SannyMielly: posts the ante 160
D0MAGE: posts the ante 160
sharb777: posts the ante 160
sharb777: posts small blind 600
MrPufies: posts big blind 1200
*** HOLE CARDS ***
Dealt to Kevin12345Mc [8s 7d]
whittersman: folds 
mrhom1: folds 
LordAzils002: raises 1320 to 2520
Kevin12345Mc: folds 
SannyMielly: folds 
D0MAGE: folds 
sharb777: folds 
MrPufies: folds 
Uncalled bet (1320) returned to LordAzils002
LordAzils002 collected 4280 from pot
LordAzils002: doesn't show hand 
*** SUMMARY ***
Total pot 4280 | Rake 0 
Seat 1: MrPufies (big blind) folded before Flop
Seat 2: whittersman folded before Flop (didn't bet)
Seat 3: mrhom1 folded before Flop (didn't bet)
Seat 4: LordAzils002 collected (4280)
Seat 5: Kevin12345Mc folded before Flop (didn't bet)
Seat 6: SannyMielly folded before Flop (didn't bet)
Seat 7: D0MAGE (button) folded before Flop (didn't bet)
Seat 8: sharb777 (small blind) folded before Flop



PokerStars Hand #255215724565: Tournament #3863783058, $9.80+$1.20 USD Hold'em No Limit - Level XVI (600/1200) - 2025/03/09 20:45:10 WET [2025/03/09 16:45:10 ET]
Table '3863783058 225' 8-max Seat #8 is the button
Seat 1: MrPufies (45072 in chips) 
Seat 2: whittersman (27562 in chips) 
Seat 3: mrhom1 (23332 in chips) 
Seat 4: LordAzils002 (38934 in chips) 
Seat 5: Kevin12345Mc (24015 in chips) 
Seat 6: SannyMielly (74928 in chips) 
Seat 7: D0MAGE (33017 in chips) 
Seat 8: sharb777 (19120 in chips) 
MrPufies: posts the ante 160
whittersman: posts the ante 160
mrhom1: posts the ante 160
LordAzils002: posts the ante 160
Kevin12345Mc: posts the ante 160
SannyMielly: posts the ante 160
D0MAGE: posts the ante 160
sharb777: posts the ante 160
MrPufies: posts small blind 600
whittersman: posts big blind 1200
*** HOLE CARDS ***
Dealt to Kevin12345Mc [6c 6h]
mrhom1: folds 
LordAzils002: folds 
Kevin12345Mc: raises 1200 to 2400
SannyMielly: folds 
D0MAGE: folds 
sharb777: folds 
MrPufies: folds 
whittersman: calls 1200
*** FLOP *** [7d Js Th]
whittersman: checks 
Kevin12345Mc: bets 2204
whittersman: raises 6196 to 8400
Kevin12345Mc: folds 
Uncalled bet (6196) returned to whittersman
whittersman collected 11088 from pot
whittersman: doesn't show hand 
*** SUMMARY ***
Total pot 11088 | Rake 0 
Board [7d Js Th]
Seat 1: MrPufies (small blind) folded before Flop
Seat 2: whittersman (big blind) collected (11088)
Seat 3: mrhom1 folded before Flop (didn't bet)
Seat 4: LordAzils002 folded before Flop (didn't bet)
Seat 5: Kevin12345Mc folded on the Flop
Seat 6: SannyMielly folded before Flop (didn't bet)
Seat 7: D0MAGE folded before Flop (didn't bet)
Seat 8: sharb777 (button) folded before Flop (didn't bet)



PokerStars Hand #255215743708: Tournament #3863783058, $9.80+$1.20 USD Hold'em No Limit - Level XVI (600/1200) - 2025/03/09 20:46:02 WET [2025/03/09 16:46:02 ET]
Table '3863783058 225' 8-max Seat #1 is the button
Seat 1: MrPufies (44312 in chips) 
Seat 2: whittersman (33886 in chips) 
Seat 3: mrhom1 (23172 in chips) 
Seat 4: LordAzils002 (38774 in chips) 
Seat 5: Kevin12345Mc (19251 in chips) 
Seat 6: SannyMielly (74768 in chips) 
Seat 7: D0MAGE (32857 in chips) 
Seat 8: sharb777 (18960 in chips) 
MrPufies: posts the ante 160
whittersman: posts the ante 160
mrhom1: posts the ante 160
LordAzils002: posts the ante 160
Kevin12345Mc: posts the ante 160
SannyMielly: posts the ante 160
D0MAGE: posts the ante 160
sharb777: posts the ante 160
whittersman: posts small blind 600
mrhom1: posts big blind 1200
*** HOLE CARDS ***
Dealt to Kevin12345Mc [5c Ad]
LordAzils002: folds 
Kevin12345Mc: folds 
SannyMielly: folds 
D0MAGE: folds 
sharb777: folds 
MrPufies: folds 
whittersman: raises 3000 to 4200
mrhom1: folds 
Uncalled bet (3000) returned to whittersman
whittersman collected 3680 from pot
whittersman: doesn't show hand 
*** SUMMARY ***
Total pot 3680 | Rake 0 
Seat 1: MrPufies (button) folded before Flop (didn't bet)
Seat 2: whittersman (small blind) collected (3680)
Seat 3: mrhom1 (big blind) folded before Flop
Seat 4: LordAzils002 folded before Flop (didn't bet)
Seat 5: Kevin12345Mc folded before Flop (didn't bet)
Seat 6: SannyMielly folded before Flop (didn't bet)
Seat 7: D0MAGE folded before Flop (didn't bet)
Seat 8: sharb777 folded before Flop (didn't bet)



PokerStars Hand #255215755016: Tournament #3863783058, $9.80+$1.20 USD Hold'em No Limit - Level XVI (600/1200) - 2025/03/09 20:46:33 WET [2025/03/09 16:46:33 ET]
Table '3863783058 225' 8-max Seat #2 is the button
Seat 1: MrPufies (44152 in chips) 
Seat 2: whittersman (36206 in chips) 
Seat 3: mrhom1 (21812 in chips) 
Seat 4: LordAzils002 (38614 in chips) 
Seat 5: Kevin12345Mc (19091 in chips) 
Seat 6: SannyMielly (74608 in chips) 
Seat 7: D0MAGE (32697 in chips) 
Seat 8: sharb777 (18800 in chips) 
MrPufies: posts the ante 160
whittersman: posts the ante 160
mrhom1: posts the ante 160
LordAzils002: posts the ante 160
Kevin12345Mc: posts the ante 160
SannyMielly: posts the ante 160
D0MAGE: posts the ante 160
sharb777: posts the ante 160
mrhom1: posts small blind 600
LordAzils002: posts big blind 1200
*** HOLE CARDS ***
Dealt to Kevin12345Mc [8h 9c]
Kevin12345Mc: folds 
SannyMielly: folds 
D0MAGE: raises 1308 to 2508
sharb777: folds 
MrPufies: folds 
whittersman: folds 
mrhom1: folds 
LordAzils002: calls 1308
*** FLOP *** [Qs 8c 9h]
LordAzils002: checks 
D0MAGE: bets 3448
LordAzils002: calls 3448
*** TURN *** [Qs 8c 9h] [Js]
LordAzils002: checks 
D0MAGE: checks 
*** RIVER *** [Qs 8c 9h Js] [5s]
LordAzils002: bets 9103
D0MAGE: folds 
Uncalled bet (9103) returned to LordAzils002
LordAzils002 collected 13792 from pot
LordAzils002: doesn't show hand 
*** SUMMARY ***
Total pot 13792 | Rake 0 
Board [Qs 8c 9h Js 5s]
Seat 1: MrPufies folded before Flop (didn't bet)
Seat 2: whittersman (button) folded before Flop (didn't bet)
Seat 3: mrhom1 (small blind) folded before Flop
Seat 4: LordAzils002 (big blind) collected (13792)
Seat 5: Kevin12345Mc folded before Flop (didn't bet)
Seat 6: SannyMielly folded before Flop (didn't bet)
Seat 7: D0MAGE folded on the River
Seat 8: sharb777 folded before Flop (didn't bet)



PokerStars Hand #255215788775: Tournament #3863783058, $9.80+$1.20 USD Hold'em No Limit - Level XVI (600/1200) - 2025/03/09 20:48:05 WET [2025/03/09 16:48:05 ET]
Table '3863783058 225' 8-max Seat #3 is the button
Seat 1: MrPufies (43992 in chips) 
Seat 2: whittersman (36046 in chips) 
Seat 3: mrhom1 (21052 in chips) 
Seat 4: LordAzils002 (46290 in chips) 
Seat 5: Kevin12345Mc (18931 in chips) 
Seat 6: SannyMielly (74448 in chips) 
Seat 7: D0MAGE (26581 in chips) 
Seat 8: sharb777 (18640 in chips) 
MrPufies: posts the ante 160
whittersman: posts the ante 160
mrhom1: posts the ante 160
LordAzils002: posts the ante 160
Kevin12345Mc: posts the ante 160
SannyMielly: posts the ante 160
D0MAGE: posts the ante 160
sharb777: posts the ante 160
LordAzils002: posts small blind 600
Kevin12345Mc: posts big blind 1200
*** HOLE CARDS ***
Dealt to Kevin12345Mc [3s 8c]
SannyMielly: folds 
D0MAGE: folds 
sharb777: folds 
MrPufies: folds 
whittersman: raises 1200 to 2400
mrhom1: folds 
LordAzils002: folds 
Kevin12345Mc: folds 
Uncalled bet (1200) returned to whittersman
whittersman collected 4280 from pot
whittersman: doesn't show hand 
*** SUMMARY ***
Total pot 4280 | Rake 0 
Seat 1: MrPufies folded before Flop (didn't bet)
Seat 2: whittersman collected (4280)
Seat 3: mrhom1 (button) folded before Flop (didn't bet)
Seat 4: LordAzils002 (small blind) folded before Flop
Seat 5: Kevin12345Mc (big blind) folded before Flop
Seat 6: SannyMielly folded before Flop (didn't bet)
Seat 7: D0MAGE folded before Flop (didn't bet)
Seat 8: sharb777 folded before Flop (didn't bet)



PokerStars Hand #255215799857: Tournament #3863783058, $9.80+$1.20 USD Hold'em No Limit - Level XVI (600/1200) - 2025/03/09 20:48:36 WET [2025/03/09 16:48:36 ET]
Table '3863783058 225' 8-max Seat #4 is the button
Seat 1: MrPufies (43832 in chips) 
Seat 2: whittersman (38966 in chips) 
Seat 3: mrhom1 (20892 in chips) 
Seat 4: LordAzils002 (45530 in chips) 
Seat 5: Kevin12345Mc (17571 in chips) 
Seat 6: SannyMielly (74288 in chips) 
Seat 7: D0MAGE (26421 in chips) 
Seat 8: sharb777 (18480 in chips) 
MrPufies: posts the ante 160
whittersman: posts the ante 160
mrhom1: posts the ante 160
LordAzils002: posts the ante 160
Kevin12345Mc: posts the ante 160
SannyMielly: posts the ante 160
D0MAGE: posts the ante 160
sharb777: posts the ante 160
Kevin12345Mc: posts small blind 600
SannyMielly: posts big blind 1200
*** HOLE CARDS ***
Dealt to Kevin12345Mc [7h 3h]
D0MAGE: folds 
sharb777: raises 1200 to 2400
MrPufies: folds 
whittersman: calls 2400
mrhom1: folds 
LordAzils002: folds 
Kevin12345Mc: folds 
SannyMielly: folds 
*** FLOP *** [9c 4c 7s]
sharb777: bets 2400
whittersman: folds 
Uncalled bet (2400) returned to sharb777
sharb777 collected 7880 from pot
*** SUMMARY ***
Total pot 7880 | Rake 0 
Board [9c 4c 7s]
Seat 1: MrPufies folded before Flop (didn't bet)
Seat 2: whittersman folded on the Flop
Seat 3: mrhom1 folded before Flop (didn't bet)
Seat 4: LordAzils002 (button) folded before Flop (didn't bet)
Seat 5: Kevin12345Mc (small blind) folded before Flop
Seat 6: SannyMielly (big blind) folded before Flop
Seat 7: D0MAGE folded before Flop (didn't bet)
Seat 8: sharb777 collected (7880)



PokerStars Hand #255215819098: Tournament #3863783058, $9.80+$1.20 USD Hold'em No Limit - Level XVI (600/1200) - 2025/03/09 20:49:29 WET [2025/03/09 16:49:29 ET]
Table '3863783058 225' 8-max Seat #5 is the button
Seat 1: MrPufies (43672 in chips) 
Seat 2: whittersman (36406 in chips) 
Seat 3: mrhom1 (20732 in chips) 
Seat 4: LordAzils002 (45370 in chips) 
Seat 5: Kevin12345Mc (16811 in chips) 
Seat 6: SannyMielly (72928 in chips) 
Seat 7: D0MAGE (26261 in chips) 
Seat 8: sharb777 (23800 in chips) 
MrPufies: posts the ante 160
whittersman: posts the ante 160
mrhom1: posts the ante 160
LordAzils002: posts the ante 160
Kevin12345Mc: posts the ante 160
SannyMielly: posts the ante 160
D0MAGE: posts the ante 160
sharb777: posts the ante 160
SannyMielly: posts small blind 600
D0MAGE: posts big blind 1200
*** HOLE CARDS ***
Dealt to Kevin12345Mc [Th 3d]
sharb777: folds 
MrPufies: folds 
whittersman: folds 
mrhom1: folds 
LordAzils002: folds 
Kevin12345Mc: folds 
SannyMielly: raises 2400 to 3600
D0MAGE: calls 2400
*** FLOP *** [Kh 9d 2s]
SannyMielly: bets 2798
D0MAGE: calls 2798
*** TURN *** [Kh 9d 2s] [2h]
SannyMielly: checks 
D0MAGE: bets 3519
SannyMielly: folds 
Uncalled bet (3519) returned to D0MAGE
D0MAGE collected 14076 from pot
D0MAGE: doesn't show hand 
*** SUMMARY ***
Total pot 14076 | Rake 0 
Board [Kh 9d 2s 2h]
Seat 1: MrPufies folded before Flop (didn't bet)
Seat 2: whittersman folded before Flop (didn't bet)
Seat 3: mrhom1 folded before Flop (didn't bet)
Seat 4: LordAzils002 folded before Flop (didn't bet)
Seat 5: Kevin12345Mc (button) folded before Flop (didn't bet)
Seat 6: SannyMielly (small blind) folded on the Turn
Seat 7: D0MAGE (big blind) collected (14076)
Seat 8: sharb777 folded before Flop (didn't bet)



PokerStars Hand #255215845278: Tournament #3863783058, $9.80+$1.20 USD Hold'em No Limit - Level XVI (600/1200) - 2025/03/09 20:50:42 WET [2025/03/09 16:50:42 ET]
Table '3863783058 225' 8-max Seat #6 is the button
Seat 1: MrPufies (43512 in chips) 
Seat 2: whittersman (36246 in chips) 
Seat 3: mrhom1 (20572 in chips) 
Seat 4: LordAzils002 (45210 in chips) 
Seat 5: Kevin12345Mc (16651 in chips) 
Seat 6: SannyMielly (66370 in chips) 
Seat 7: D0MAGE (33779 in chips) 
Seat 8: sharb777 (23640 in chips) 
MrPufies: posts the ante 160
whittersman: posts the ante 160
mrhom1: posts the ante 160
LordAzils002: posts the ante 160
Kevin12345Mc: posts the ante 160
SannyMielly: posts the ante 160
D0MAGE: posts the ante 160
sharb777: posts the ante 160
D0MAGE: posts small blind 600
sharb777: posts big blind 1200
*** HOLE CARDS ***
Dealt to Kevin12345Mc [Qs Th]
MrPufies: folds 
whittersman: folds 
mrhom1: folds 
LordAzils002: folds 
Kevin12345Mc: calls 1200
SannyMielly: folds 
D0MAGE: raises 32419 to 33619 and is all-in
sharb777: folds 
Kevin12345Mc: folds 
Uncalled bet (32419) returned to D0MAGE
D0MAGE collected 4880 from pot
D0MAGE: doesn't show hand 
*** SUMMARY ***
Total pot 4880 | Rake 0 
Seat 1: MrPufies folded before Flop (didn't bet)
Seat 2: whittersman folded before Flop (didn't bet)
Seat 3: mrhom1 folded before Flop (didn't bet)
Seat 4: LordAzils002 folded before Flop (didn't bet)
Seat 5: Kevin12345Mc folded before Flop
Seat 6: SannyMielly (button) folded before Flop (didn't bet)
Seat 7: D0MAGE (small blind) collected (4880)
Seat 8: sharb777 (big blind) folded before Flop



PokerStars Hand #255215859472: Tournament #3863783058, $9.80+$1.20 USD Hold'em No Limit - Level XVI (600/1200) - 2025/03/09 20:51:22 WET [2025/03/09 16:51:22 ET]
Table '3863783058 225' 8-max Seat #7 is the button
Seat 1: MrPufies (43352 in chips) 
Seat 2: whittersman (36086 in chips) 
Seat 3: mrhom1 (20412 in chips) 
Seat 4: LordAzils002 (45050 in chips) 
Seat 5: Kevin12345Mc (15291 in chips) 
Seat 6: SannyMielly (66210 in chips) 
Seat 7: D0MAGE (37299 in chips) 
Seat 8: sharb777 (22280 in chips) 
MrPufies: posts the ante 160
whittersman: posts the ante 160
mrhom1: posts the ante 160
LordAzils002: posts the ante 160
Kevin12345Mc: posts the ante 160
SannyMielly: posts the ante 160
D0MAGE: posts the ante 160
sharb777: posts the ante 160
sharb777: posts small blind 600
MrPufies: posts big blind 1200
*** HOLE CARDS ***
Dealt to Kevin12345Mc [Ad 6d]
whittersman: folds 
mrhom1: folds 
LordAzils002: folds 
Kevin12345Mc: raises 13931 to 15131 and is all-in
SannyMielly: folds 
D0MAGE: folds 
sharb777: folds 
MrPufies: calls 13931
*** FLOP *** [Jc 5c 7s]
*** TURN *** [Jc 5c 7s] [3s]
*** RIVER *** [Jc 5c 7s 3s] [9c]
*** SHOW DOWN ***
MrPufies: shows [Td Th] (a pair of Tens)
Kevin12345Mc: shows [Ad 6d] (high card Ace)
MrPufies collected 32142 from pot
Kevin12345Mc finished the tournament in 1774th place
*** SUMMARY ***
Total pot 32142 | Rake 0 
Board [Jc 5c 7s 3s 9c]
Seat 1: MrPufies (big blind) showed [Td Th] and won (32142) with a pair of Tens
Seat 2: whittersman folded before Flop (didn't bet)
Seat 3: mrhom1 folded before Flop (didn't bet)
Seat 4: LordAzils002 folded before Flop (didn't bet)
Seat 5: Kevin12345Mc showed [Ad 6d] and lost with high card Ace
Seat 6: SannyMielly folded before Flop (didn't bet)
Seat 7: D0MAGE (button) folded before Flop (didn't bet)
Seat 8: sharb777 (small blind) folded before Flop



