PokerStars Hand #254671117315: Tournament #3852792524, $4.80+$5.00+$1.20 USD Hold'em No Limit - Level I (75/150) - 2025/02/02 16:29:53 WET [2025/02/02 11:29:53 ET]
Table '3852792524 145' 8-max Seat #1 is the button
Seat 1: Nata1608 (25000 in chips, $5 bounty) 
Seat 2: gustavomrp491 (25000 in chips, $5 bounty) 
Seat 3: Hremia (25000 in chips, $5 bounty) 
Seat 4: Kevin12345Mc (25000 in chips, $5 bounty) 
Seat 5: Nilo.Muzamba (25000 in chips, $5 bounty) 
Seat 6: EESTINOKIA (25000 in chips, $5 bounty) 
Seat 7: Mr.KamiKazeK (25000 in chips, $5 bounty) 
Seat 8: xMarker7x (25000 in chips, $5 bounty) 
Nata1608: posts the ante 20
gustavomrp491: posts the ante 20
Hremia: posts the ante 20
Kevin12345Mc: posts the ante 20
Nilo.Muzamba: posts the ante 20
EESTINOKIA: posts the ante 20
Mr.KamiKazeK: posts the ante 20
xMarker7x: posts the ante 20
gustavomrp491: posts small blind 75
Hremia: posts big blind 150
*** HOLE CARDS ***
Dealt to Kevin12345Mc [2c Td]
Kevin12345Mc: folds 
Nilo.Muzamba: folds 
EESTINOKIA: folds 
Mr.KamiKazeK: raises 300 to 450
xMarker7x: folds 
Nata1608: folds 
gustavomrp491: calls 375
Hremia: folds 
*** FLOP *** [Jh Js 6c]
gustavomrp491: checks 
Mr.KamiKazeK: bets 303
gustavomrp491: raises 897 to 1200
Mr.KamiKazeK: calls 897
*** TURN *** [Jh Js 6c] [Tc]
gustavomrp491: bets 3610
Mr.KamiKazeK: calls 3610
*** RIVER *** [Jh Js 6c Tc] [5d]
gustavomrp491: bets 19720 and is all-in
Mr.KamiKazeK: folds 
Uncalled bet (19720) returned to gustavomrp491
gustavomrp491 collected 10830 from pot
gustavomrp491: doesn't show hand 
*** SUMMARY ***
Total pot 10830 | Rake 0 
Board [Jh Js 6c Tc 5d]
Seat 1: Nata1608 (button) folded before Flop (didn't bet)
Seat 2: gustavomrp491 (small blind) collected (10830)
Seat 3: Hremia (big blind) folded before Flop
Seat 4: Kevin12345Mc folded before Flop (didn't bet)
Seat 5: Nilo.Muzamba folded before Flop (didn't bet)
Seat 6: EESTINOKIA folded before Flop (didn't bet)
Seat 7: Mr.KamiKazeK folded on the River
Seat 8: xMarker7x folded before Flop (didn't bet)



PokerStars Hand #254671146016: Tournament #3852792524, $4.80+$5.00+$1.20 USD Hold'em No Limit - Level I (75/150) - 2025/02/02 16:31:32 WET [2025/02/02 11:31:32 ET]
Table '3852792524 145' 8-max Seat #2 is the button
Seat 1: Nata1608 (24980 in chips, $5 bounty) 
Seat 2: gustavomrp491 (30550 in chips, $5 bounty) 
Seat 3: Hremia (24830 in chips, $5 bounty) 
Seat 4: Kevin12345Mc (24980 in chips, $5 bounty) 
Seat 5: Nilo.Muzamba (24980 in chips, $5 bounty) 
Seat 6: EESTINOKIA (24980 in chips, $5 bounty) 
Seat 7: Mr.KamiKazeK (19720 in chips, $5 bounty) 
Seat 8: xMarker7x (24980 in chips, $5 bounty) 
Nata1608: posts the ante 20
gustavomrp491: posts the ante 20
Hremia: posts the ante 20
Kevin12345Mc: posts the ante 20
Nilo.Muzamba: posts the ante 20
EESTINOKIA: posts the ante 20
Mr.KamiKazeK: posts the ante 20
xMarker7x: posts the ante 20
Hremia: posts small blind 75
Kevin12345Mc: posts big blind 150
*** HOLE CARDS ***
Dealt to Kevin12345Mc [Kh Ah]
Nilo.Muzamba: folds 
EESTINOKIA: folds 
Mr.KamiKazeK: raises 150 to 300
xMarker7x: folds 
Nata1608: folds 
gustavomrp491: folds 
Hremia: raises 1050 to 1350
Kevin12345Mc: raises 2250 to 3600
Mr.KamiKazeK: folds 
Hremia: raises 21210 to 24810 and is all-in
Kevin12345Mc: calls 21210
*** FLOP *** [Qd Kd 5c]
*** TURN *** [Qd Kd 5c] [Jh]
*** RIVER *** [Qd Kd 5c Jh] [3d]
*** SHOW DOWN ***
Hremia: shows [Ad Ks] (a pair of Kings)
Kevin12345Mc: shows [Kh Ah] (a pair of Kings)
Hremia collected 25040 from pot
Kevin12345Mc collected 25040 from pot
*** SUMMARY ***
Total pot 50080 | Rake 0 
Board [Qd Kd 5c Jh 3d]
Seat 1: Nata1608 folded before Flop (didn't bet)
Seat 2: gustavomrp491 (button) folded before Flop (didn't bet)
Seat 3: Hremia (small blind) showed [Ad Ks] and won (25040) with a pair of Kings
Seat 4: Kevin12345Mc (big blind) showed [Kh Ah] and won (25040) with a pair of Kings
Seat 5: Nilo.Muzamba folded before Flop (didn't bet)
Seat 6: EESTINOKIA folded before Flop (didn't bet)
Seat 7: Mr.KamiKazeK folded before Flop
Seat 8: xMarker7x folded before Flop (didn't bet)



PokerStars Hand #254671164675: Tournament #3852792524, $4.80+$5.00+$1.20 USD Hold'em No Limit - Level I (75/150) - 2025/02/02 16:32:36 WET [2025/02/02 11:32:36 ET]
Table '3852792524 145' 8-max Seat #3 is the button
Seat 1: Nata1608 (24960 in chips, $5 bounty) 
Seat 2: gustavomrp491 (30530 in chips, $5 bounty) 
Seat 3: Hremia (25040 in chips, $5 bounty) 
Seat 4: Kevin12345Mc (25190 in chips, $5 bounty) 
Seat 5: Nilo.Muzamba (24960 in chips, $5 bounty) 
Seat 6: EESTINOKIA (24960 in chips, $5 bounty) 
Seat 7: Mr.KamiKazeK (19400 in chips, $5 bounty) 
Seat 8: xMarker7x (24960 in chips, $5 bounty) 
Nata1608: posts the ante 20
gustavomrp491: posts the ante 20
Hremia: posts the ante 20
Kevin12345Mc: posts the ante 20
Nilo.Muzamba: posts the ante 20
EESTINOKIA: posts the ante 20
Mr.KamiKazeK: posts the ante 20
xMarker7x: posts the ante 20
Kevin12345Mc: posts small blind 75
Nilo.Muzamba: posts big blind 150
*** HOLE CARDS ***
Dealt to Kevin12345Mc [Qd 3d]
EESTINOKIA: calls 150
Mr.KamiKazeK: folds 
xMarker7x: folds 
Nata1608: folds 
gustavomrp491: folds 
Hremia: folds 
Kevin12345Mc: calls 75
Nilo.Muzamba: checks 
*** FLOP *** [6s 6h Qs]
Kevin12345Mc: checks 
Nilo.Muzamba: checks 
EESTINOKIA: checks 
*** TURN *** [6s 6h Qs] [Kd]
Kevin12345Mc: checks 
Nilo.Muzamba: checks 
EESTINOKIA: checks 
*** RIVER *** [6s 6h Qs Kd] [4s]
Kevin12345Mc: checks 
Nilo.Muzamba: checks 
EESTINOKIA: checks 
*** SHOW DOWN ***
Kevin12345Mc: shows [Qd 3d] (two pair, Queens and Sixes)
Nilo.Muzamba: mucks hand 
EESTINOKIA: mucks hand 
Kevin12345Mc collected 610 from pot
*** SUMMARY ***
Total pot 610 | Rake 0 
Board [6s 6h Qs Kd 4s]
Seat 1: Nata1608 folded before Flop (didn't bet)
Seat 2: gustavomrp491 folded before Flop (didn't bet)
Seat 3: Hremia (button) folded before Flop (didn't bet)
Seat 4: Kevin12345Mc (small blind) showed [Qd 3d] and won (610) with two pair, Queens and Sixes
Seat 5: Nilo.Muzamba (big blind) mucked [2s 4h]
Seat 6: EESTINOKIA mucked [Td 8s]
Seat 7: Mr.KamiKazeK folded before Flop (didn't bet)
Seat 8: xMarker7x folded before Flop (didn't bet)



PokerStars Hand #254671184288: Tournament #3852792524, $4.80+$5.00+$1.20 USD Hold'em No Limit - Level I (75/150) - 2025/02/02 16:33:44 WET [2025/02/02 11:33:44 ET]
Table '3852792524 145' 8-max Seat #4 is the button
Seat 1: Nata1608 (24940 in chips, $5 bounty) 
Seat 2: gustavomrp491 (30510 in chips, $5 bounty) 
Seat 3: Hremia (25020 in chips, $5 bounty) 
Seat 4: Kevin12345Mc (25630 in chips, $5 bounty) 
Seat 5: Nilo.Muzamba (24790 in chips, $5 bounty) 
Seat 6: EESTINOKIA (24790 in chips, $5 bounty) 
Seat 7: Mr.KamiKazeK (19380 in chips, $5 bounty) 
Seat 8: xMarker7x (24940 in chips, $5 bounty) 
Nata1608: posts the ante 20
gustavomrp491: posts the ante 20
Hremia: posts the ante 20
Kevin12345Mc: posts the ante 20
Nilo.Muzamba: posts the ante 20
EESTINOKIA: posts the ante 20
Mr.KamiKazeK: posts the ante 20
xMarker7x: posts the ante 20
Nilo.Muzamba: posts small blind 75
EESTINOKIA: posts big blind 150
*** HOLE CARDS ***
Dealt to Kevin12345Mc [8s 9h]
Mr.KamiKazeK: folds 
xMarker7x: folds 
Nata1608: raises 180 to 330
gustavomrp491: folds 
Hremia: calls 330
Kevin12345Mc: folds 
Nilo.Muzamba: raises 1470 to 1800
EESTINOKIA: calls 1650
Nata1608: calls 1470
Hremia: calls 1470
*** FLOP *** [7d 7s 8c]
Nilo.Muzamba: bets 1840
EESTINOKIA: calls 1840
Nata1608: calls 1840
Hremia: folds 
*** TURN *** [7d 7s 8c] [3h]
Nilo.Muzamba: checks 
EESTINOKIA: checks 
Nata1608: checks 
*** RIVER *** [7d 7s 8c 3h] [Kc]
Nilo.Muzamba: bets 3220
EESTINOKIA: raises 17910 to 21130 and is all-in
Nata1608: folds 
Nilo.Muzamba: calls 17910 and is all-in
*** SHOW DOWN ***
EESTINOKIA: shows [2h 7h] (three of a kind, Sevens)
Nilo.Muzamba: shows [Ks Ah] (two pair, Kings and Sevens)
EESTINOKIA collected 55140 from pot
EESTINOKIA wins $2.50 for eliminating Nilo.Muzamba and their own bounty increases by $2.50 to $7.50
Nilo.Muzamba finished the tournament
Axeliolavi is disconnected 
*** SUMMARY ***
Total pot 55140 | Rake 0 
Board [7d 7s 8c 3h Kc]
Seat 1: Nata1608 folded on the River
Seat 2: gustavomrp491 folded before Flop (didn't bet)
Seat 3: Hremia folded on the Flop
Seat 4: Kevin12345Mc (button) folded before Flop (didn't bet)
Seat 5: Nilo.Muzamba (small blind) showed [Ks Ah] and lost with two pair, Kings and Sevens
Seat 6: EESTINOKIA (big blind) showed [2h 7h] and won (55140) with three of a kind, Sevens
Seat 7: Mr.KamiKazeK folded before Flop (didn't bet)
Seat 8: xMarker7x folded before Flop (didn't bet)



PokerStars Hand #254671209164: Tournament #3852792524, $4.80+$5.00+$1.20 USD Hold'em No Limit - Level I (75/150) - 2025/02/02 16:35:09 WET [2025/02/02 11:35:09 ET]
Table '3852792524 145' 8-max Seat #6 is the button
Seat 1: Nata1608 (21280 in chips, $5 bounty) 
Seat 2: gustavomrp491 (30490 in chips, $5 bounty) 
Seat 3: Hremia (23200 in chips, $5 bounty) 
Seat 4: Kevin12345Mc (25610 in chips, $5 bounty) 
Seat 5: Axeliolavi (25000 in chips, $5 bounty) 
Seat 6: EESTINOKIA (55140 in chips, $7.50 bounty) 
Seat 7: Mr.KamiKazeK (19360 in chips, $5 bounty) 
Seat 8: xMarker7x (24920 in chips, $5 bounty) 
Nata1608: posts the ante 20
gustavomrp491: posts the ante 20
Hremia: posts the ante 20
Kevin12345Mc: posts the ante 20
Axeliolavi: posts the ante 20
EESTINOKIA: posts the ante 20
Mr.KamiKazeK: posts the ante 20
xMarker7x: posts the ante 20
Mr.KamiKazeK: posts small blind 75
xMarker7x: posts big blind 150
*** HOLE CARDS ***
Dealt to Kevin12345Mc [8s 9s]
Nata1608: folds 
gustavomrp491: folds 
Hremia: raises 225 to 375
Kevin12345Mc: folds 
Axeliolavi: calls 375
EESTINOKIA: calls 375
Mr.KamiKazeK: calls 300
xMarker7x: folds 
*** FLOP *** [2d Kh 9d]
Mr.KamiKazeK: checks 
Hremia: bets 1358
Axeliolavi: calls 1358
EESTINOKIA: calls 1358
Mr.KamiKazeK: folds 
*** TURN *** [2d Kh 9d] [7d]
Hremia: checks 
Axeliolavi: bets 2942
EESTINOKIA: folds 
Hremia: calls 2942
*** RIVER *** [2d Kh 9d 7d] [Ah]
Hremia: checks 
Axeliolavi: bets 11768
Hremia: folds 
Uncalled bet (11768) returned to Axeliolavi
Axeliolavi collected 11768 from pot
Axeliolavi: doesn't show hand 
*** SUMMARY ***
Total pot 11768 | Rake 0 
Board [2d Kh 9d 7d Ah]
Seat 1: Nata1608 folded before Flop (didn't bet)
Seat 2: gustavomrp491 folded before Flop (didn't bet)
Seat 3: Hremia folded on the River
Seat 4: Kevin12345Mc folded before Flop (didn't bet)
Seat 5: Axeliolavi collected (11768)
Seat 6: EESTINOKIA (button) folded on the Turn
Seat 7: Mr.KamiKazeK (small blind) folded on the Flop
Seat 8: xMarker7x (big blind) folded before Flop



PokerStars Hand #254671245344: Tournament #3852792524, $4.80+$5.00+$1.20 USD Hold'em No Limit - Level I (75/150) - 2025/02/02 16:37:13 WET [2025/02/02 11:37:13 ET]
Table '3852792524 145' 8-max Seat #7 is the button
Seat 1: Nata1608 (21260 in chips, $5 bounty) 
Seat 2: gustavomrp491 (30470 in chips, $5 bounty) 
Seat 3: Hremia (18505 in chips, $5 bounty) 
Seat 4: Kevin12345Mc (25590 in chips, $5 bounty) 
Seat 5: Axeliolavi (32073 in chips, $5 bounty) 
Seat 6: EESTINOKIA (53387 in chips, $7.50 bounty) 
Seat 7: Mr.KamiKazeK (18965 in chips, $5 bounty) 
Seat 8: xMarker7x (24750 in chips, $5 bounty) 
Nata1608: posts the ante 20
gustavomrp491: posts the ante 20
Hremia: posts the ante 20
Kevin12345Mc: posts the ante 20
Axeliolavi: posts the ante 20
EESTINOKIA: posts the ante 20
Mr.KamiKazeK: posts the ante 20
xMarker7x: posts the ante 20
xMarker7x: posts small blind 75
Nata1608: posts big blind 150
*** HOLE CARDS ***
Dealt to Kevin12345Mc [6h Kc]
gustavomrp491: folds 
Hremia: folds 
Kevin12345Mc: folds 
Axeliolavi: folds 
EESTINOKIA: calls 150
Mr.KamiKazeK: calls 150
xMarker7x: folds 
Nata1608: raises 600 to 750
EESTINOKIA: calls 600
Mr.KamiKazeK: calls 600
*** FLOP *** [4s 6c 2s]
Nata1608: bets 994
EESTINOKIA: folds 
Mr.KamiKazeK: calls 994
*** TURN *** [4s 6c 2s] [2c]
Nata1608: bets 3131
Mr.KamiKazeK: folds 
Uncalled bet (3131) returned to Nata1608
Nata1608 collected 4473 from pot
Nata1608: doesn't show hand 
*** SUMMARY ***
Total pot 4473 | Rake 0 
Board [4s 6c 2s 2c]
Seat 1: Nata1608 (big blind) collected (4473)
Seat 2: gustavomrp491 folded before Flop (didn't bet)
Seat 3: Hremia folded before Flop (didn't bet)
Seat 4: Kevin12345Mc folded before Flop (didn't bet)
Seat 5: Axeliolavi folded before Flop (didn't bet)
Seat 6: EESTINOKIA folded on the Flop
Seat 7: Mr.KamiKazeK (button) folded on the Turn
Seat 8: xMarker7x (small blind) folded before Flop



PokerStars Hand #254671262542: Tournament #3852792524, $4.80+$5.00+$1.20 USD Hold'em No Limit - Level II (100/200) - 2025/02/02 16:38:12 WET [2025/02/02 11:38:12 ET]
Table '3852792524 145' 8-max Seat #8 is the button
Seat 1: Nata1608 (23969 in chips, $5 bounty) 
Seat 2: gustavomrp491 (30450 in chips, $5 bounty) 
Seat 3: Hremia (18485 in chips, $5 bounty) 
Seat 4: Kevin12345Mc (25570 in chips, $5 bounty) 
Seat 5: Axeliolavi (32053 in chips, $5 bounty) 
Seat 6: EESTINOKIA (52617 in chips, $7.50 bounty) 
Seat 7: Mr.KamiKazeK (17201 in chips, $5 bounty) 
Seat 8: xMarker7x (24655 in chips, $5 bounty) 
Nata1608: posts the ante 25
gustavomrp491: posts the ante 25
Hremia: posts the ante 25
Kevin12345Mc: posts the ante 25
Axeliolavi: posts the ante 25
EESTINOKIA: posts the ante 25
Mr.KamiKazeK: posts the ante 25
xMarker7x: posts the ante 25
Nata1608: posts small blind 100
gustavomrp491: posts big blind 200
*** HOLE CARDS ***
Dealt to Kevin12345Mc [9d Th]
Hremia: folds 
Kevin12345Mc: folds 
Axeliolavi: folds 
EESTINOKIA: folds 
Mr.KamiKazeK: folds 
xMarker7x: raises 240 to 440
Nata1608: raises 1160 to 1600
gustavomrp491: folds 
xMarker7x: folds 
Uncalled bet (1160) returned to Nata1608
Nata1608 collected 1280 from pot
Nata1608: doesn't show hand 
*** SUMMARY ***
Total pot 1280 | Rake 0 
Seat 1: Nata1608 (small blind) collected (1280)
Seat 2: gustavomrp491 (big blind) folded before Flop
Seat 3: Hremia folded before Flop (didn't bet)
Seat 4: Kevin12345Mc folded before Flop (didn't bet)
Seat 5: Axeliolavi folded before Flop (didn't bet)
Seat 6: EESTINOKIA folded before Flop (didn't bet)
Seat 7: Mr.KamiKazeK folded before Flop (didn't bet)
Seat 8: xMarker7x (button) folded before Flop



PokerStars Hand #254671270848: Tournament #3852792524, $4.80+$5.00+$1.20 USD Hold'em No Limit - Level II (100/200) - 2025/02/02 16:38:40 WET [2025/02/02 11:38:40 ET]
Table '3852792524 145' 8-max Seat #1 is the button
Seat 1: Nata1608 (24784 in chips, $5 bounty) 
Seat 2: gustavomrp491 (30225 in chips, $5 bounty) 
Seat 3: Hremia (18460 in chips, $5 bounty) 
Seat 4: Kevin12345Mc (25545 in chips, $5 bounty) 
Seat 5: Axeliolavi (32028 in chips, $5 bounty) 
Seat 6: EESTINOKIA (52592 in chips, $7.50 bounty) 
Seat 7: Mr.KamiKazeK (17176 in chips, $5 bounty) 
Seat 8: xMarker7x (24190 in chips, $5 bounty) 
Nata1608: posts the ante 25
gustavomrp491: posts the ante 25
Hremia: posts the ante 25
Kevin12345Mc: posts the ante 25
Axeliolavi: posts the ante 25
EESTINOKIA: posts the ante 25
Mr.KamiKazeK: posts the ante 25
xMarker7x: posts the ante 25
gustavomrp491: posts small blind 100
Hremia: posts big blind 200
*** HOLE CARDS ***
Dealt to Kevin12345Mc [6s Jh]
Kevin12345Mc: folds 
Axeliolavi: raises 400 to 600
EESTINOKIA: folds 
Mr.KamiKazeK: raises 1600 to 2200
xMarker7x: folds 
Nata1608: folds 
gustavomrp491: folds 
Hremia: raises 16235 to 18435 and is all-in
Axeliolavi: folds 
Mr.KamiKazeK: calls 14951 and is all-in
Uncalled bet (1284) returned to Hremia
*** FLOP *** [6c 4c 9h]
*** TURN *** [6c 4c 9h] [Qs]
*** RIVER *** [6c 4c 9h Qs] [As]
*** SHOW DOWN ***
Hremia: shows [Kc Ks] (a pair of Kings)
Mr.KamiKazeK: shows [Ah Ac] (three of a kind, Aces)
Mr.KamiKazeK collected 35202 from pot
*** SUMMARY ***
Total pot 35202 | Rake 0 
Board [6c 4c 9h Qs As]
Seat 1: Nata1608 (button) folded before Flop (didn't bet)
Seat 2: gustavomrp491 (small blind) folded before Flop
Seat 3: Hremia (big blind) showed [Kc Ks] and lost with a pair of Kings
Seat 4: Kevin12345Mc folded before Flop (didn't bet)
Seat 5: Axeliolavi folded before Flop
Seat 6: EESTINOKIA folded before Flop (didn't bet)
Seat 7: Mr.KamiKazeK showed [Ah Ac] and won (35202) with three of a kind, Aces
Seat 8: xMarker7x folded before Flop (didn't bet)



PokerStars Hand #254671283439: Tournament #3852792524, $4.80+$5.00+$1.20 USD Hold'em No Limit - Level II (100/200) - 2025/02/02 16:39:24 WET [2025/02/02 11:39:24 ET]
Table '3852792524 145' 8-max Seat #2 is the button
Seat 1: Nata1608 (24759 in chips, $5 bounty) 
Seat 2: gustavomrp491 (30100 in chips, $5 bounty) 
Seat 3: Hremia (1284 in chips, $5 bounty) 
Seat 4: Kevin12345Mc (25520 in chips, $5 bounty) 
Seat 5: Axeliolavi (31403 in chips, $5 bounty) 
Seat 6: EESTINOKIA (52567 in chips, $7.50 bounty) 
Seat 7: Mr.KamiKazeK (35202 in chips, $5 bounty) 
Seat 8: xMarker7x (24165 in chips, $5 bounty) 
Nata1608: posts the ante 25
gustavomrp491: posts the ante 25
Hremia: posts the ante 25
Kevin12345Mc: posts the ante 25
Axeliolavi: posts the ante 25
EESTINOKIA: posts the ante 25
Mr.KamiKazeK: posts the ante 25
xMarker7x: posts the ante 25
Hremia: posts small blind 100
Kevin12345Mc: posts big blind 200
*** HOLE CARDS ***
Dealt to Kevin12345Mc [Ad Td]
Axeliolavi: folds 
EESTINOKIA: calls 200
Mr.KamiKazeK: folds 
xMarker7x: calls 200
Nata1608: raises 600 to 800
gustavomrp491: calls 800
Hremia: calls 700
Kevin12345Mc: raises 1600 to 2400
EESTINOKIA: calls 2200
xMarker7x: folds 
Nata1608: calls 1600
gustavomrp491: calls 1600
Hremia: calls 459 and is all-in
*** FLOP *** [9s 5c 2h]
Kevin12345Mc: bets 3115
EESTINOKIA: calls 3115
Nata1608: calls 3115
gustavomrp491: folds 
*** TURN *** [9s 5c 2h] [8h]
Kevin12345Mc: checks 
EESTINOKIA: checks 
Nata1608: bets 14423
Kevin12345Mc: folds 
EESTINOKIA: folds 
Uncalled bet (14423) returned to Nata1608
*** RIVER *** [9s 5c 2h 8h] [Ks]
*** SHOW DOWN ***
Nata1608: shows [7d 7s] (a pair of Sevens)
Nata1608 collected 13909 from side pot
Hremia: shows [Kd Th] (a pair of Kings)
Hremia collected 6695 from main pot
*** SUMMARY ***
Total pot 20604 Main pot 6695. Side pot 13909. | Rake 0 
Board [9s 5c 2h 8h Ks]
Seat 1: Nata1608 showed [7d 7s] and won (13909) with a pair of Sevens
Seat 2: gustavomrp491 (button) folded on the Flop
Seat 3: Hremia (small blind) showed [Kd Th] and won (6695) with a pair of Kings
Seat 4: Kevin12345Mc (big blind) folded on the Turn
Seat 5: Axeliolavi folded before Flop (didn't bet)
Seat 6: EESTINOKIA folded on the Turn
Seat 7: Mr.KamiKazeK folded before Flop (didn't bet)
Seat 8: xMarker7x folded before Flop



PokerStars Hand #254671312761: Tournament #3852792524, $4.80+$5.00+$1.20 USD Hold'em No Limit - Level II (100/200) - 2025/02/02 16:41:04 WET [2025/02/02 11:41:04 ET]
Table '3852792524 145' 8-max Seat #3 is the button
Seat 1: Nata1608 (33128 in chips, $5 bounty) 
Seat 2: gustavomrp491 (27675 in chips, $5 bounty) 
Seat 3: Hremia (6695 in chips, $5 bounty) 
Seat 4: Kevin12345Mc (19980 in chips, $5 bounty) 
Seat 5: neymaciel.nm (25000 in chips, $5 bounty) 
Seat 6: EESTINOKIA (47027 in chips, $7.50 bounty) 
Seat 7: Mr.KamiKazeK (35177 in chips, $5 bounty) 
Seat 8: xMarker7x (23940 in chips, $5 bounty) 
Nata1608: posts the ante 25
gustavomrp491: posts the ante 25
Hremia: posts the ante 25
Kevin12345Mc: posts the ante 25
neymaciel.nm: posts the ante 25
EESTINOKIA: posts the ante 25
Mr.KamiKazeK: posts the ante 25
xMarker7x: posts the ante 25
Kevin12345Mc: posts small blind 100
neymaciel.nm: posts big blind 200
*** HOLE CARDS ***
Dealt to Kevin12345Mc [3h 5c]
EESTINOKIA: folds 
Mr.KamiKazeK: raises 200 to 400
xMarker7x: folds 
Nata1608: calls 400
gustavomrp491: calls 400
Hremia: calls 400
Kevin12345Mc: folds 
neymaciel.nm: folds 
neymaciel.nm is sitting out
*** FLOP *** [Ac Kc 4h]
Mr.KamiKazeK: checks 
Nata1608: checks 
gustavomrp491: checks 
Hremia: bets 6270 and is all-in
Mr.KamiKazeK: calls 6270
Nata1608: calls 6270
gustavomrp491: folds 
*** TURN *** [Ac Kc 4h] [Td]
Mr.KamiKazeK: checks 
Nata1608: checks 
*** RIVER *** [Ac Kc 4h Td] [5s]
Mr.KamiKazeK: checks 
Nata1608: checks 
*** SHOW DOWN ***
Mr.KamiKazeK: shows [Jh As] (a pair of Aces)
Nata1608: mucks hand 
Hremia: mucks hand 
Mr.KamiKazeK collected 20910 from pot
Mr.KamiKazeK wins $2.50 for eliminating Hremia and their own bounty increases by $2.50 to $7.50
Hremia finished the tournament
*** SUMMARY ***
Total pot 20910 | Rake 0 
Board [Ac Kc 4h Td 5s]
Seat 1: Nata1608 mucked [2c Qc]
Seat 2: gustavomrp491 folded on the Flop
Seat 3: Hremia (button) mucked [Kh Js]
Seat 4: Kevin12345Mc (small blind) folded before Flop
Seat 5: neymaciel.nm (big blind) folded before Flop
Seat 6: EESTINOKIA folded before Flop (didn't bet)
Seat 7: Mr.KamiKazeK showed [Jh As] and won (20910) with a pair of Aces
Seat 8: xMarker7x folded before Flop (didn't bet)



PokerStars Hand #254671329886: Tournament #3852792524, $4.80+$5.00+$1.20 USD Hold'em No Limit - Level II (100/200) - 2025/02/02 16:42:03 WET [2025/02/02 11:42:03 ET]
Table '3852792524 145' 8-max Seat #4 is the button
Seat 1: Nata1608 (26433 in chips, $5 bounty) 
Seat 2: gustavomrp491 (27250 in chips, $5 bounty) 
Seat 3: lukbigorna (25000 in chips, $5 bounty) 
Seat 4: Kevin12345Mc (19855 in chips, $5 bounty) 
Seat 5: neymaciel.nm (24775 in chips, $5 bounty) is sitting out
Seat 6: EESTINOKIA (47002 in chips, $7.50 bounty) 
Seat 7: Mr.KamiKazeK (49392 in chips, $7.50 bounty) 
Seat 8: xMarker7x (23915 in chips, $5 bounty) 
Nata1608: posts the ante 25
gustavomrp491: posts the ante 25
lukbigorna: posts the ante 25
Kevin12345Mc: posts the ante 25
neymaciel.nm: posts the ante 25
EESTINOKIA: posts the ante 25
Mr.KamiKazeK: posts the ante 25
xMarker7x: posts the ante 25
neymaciel.nm: posts small blind 100
EESTINOKIA: posts big blind 200
*** HOLE CARDS ***
Dealt to Kevin12345Mc [8c 2h]
Mr.KamiKazeK: folds 
xMarker7x: folds 
Nata1608: raises 240 to 440
gustavomrp491: folds 
lukbigorna: folds 
Kevin12345Mc: folds 
neymaciel.nm: folds 
neymaciel.nm has returned
neymaciel.nm is sitting out
EESTINOKIA: calls 240
*** FLOP *** [9s 7h 3h]
EESTINOKIA: checks 
Nata1608: checks 
*** TURN *** [9s 7h 3h] [4c]
EESTINOKIA: bets 1180
Nata1608: calls 1180
*** RIVER *** [9s 7h 3h 4c] [Qc]
EESTINOKIA: bets 45357 and is all-in
Nata1608: folds 
Uncalled bet (45357) returned to EESTINOKIA
EESTINOKIA collected 3540 from pot
EESTINOKIA: doesn't show hand 
#27JETS is disconnected 
*** SUMMARY ***
Total pot 3540 | Rake 0 
Board [9s 7h 3h 4c Qc]
Seat 1: Nata1608 folded on the River
Seat 2: gustavomrp491 folded before Flop (didn't bet)
Seat 3: lukbigorna folded before Flop (didn't bet)
Seat 4: Kevin12345Mc (button) folded before Flop (didn't bet)
Seat 5: neymaciel.nm (small blind) folded before Flop
Seat 6: EESTINOKIA (big blind) collected (3540)
Seat 7: Mr.KamiKazeK folded before Flop (didn't bet)
Seat 8: xMarker7x folded before Flop (didn't bet)



PokerStars Hand #254671348478: Tournament #3852792524, $4.80+$5.00+$1.20 USD Hold'em No Limit - Level II (100/200) - 2025/02/02 16:43:06 WET [2025/02/02 11:43:06 ET]
Table '3852792524 145' 8-max Seat #5 is the button
Seat 1: Nata1608 (24788 in chips, $5 bounty) 
Seat 2: gustavomrp491 (27225 in chips, $5 bounty) 
Seat 3: lukbigorna (24975 in chips, $5 bounty) 
Seat 4: Kevin12345Mc (19830 in chips, $5 bounty) 
Seat 5: neymaciel.nm (24650 in chips, $5 bounty) is sitting out
Seat 6: EESTINOKIA (48897 in chips, $7.50 bounty) 
Seat 7: #27JETS (25000 in chips, $5 bounty) 
Seat 8: xMarker7x (23890 in chips, $5 bounty) 
Nata1608: posts the ante 25
gustavomrp491: posts the ante 25
lukbigorna: posts the ante 25
Kevin12345Mc: posts the ante 25
neymaciel.nm: posts the ante 25
EESTINOKIA: posts the ante 25
#27JETS: posts the ante 25
xMarker7x: posts the ante 25
EESTINOKIA: posts small blind 100
#27JETS: posts big blind 200
*** HOLE CARDS ***
Dealt to Kevin12345Mc [6s Ks]
xMarker7x: folds 
Nata1608: folds 
gustavomrp491: folds 
lukbigorna: raises 200 to 400
Kevin12345Mc: calls 400
neymaciel.nm: folds 
EESTINOKIA: calls 300
#27JETS: raises 1800 to 2200
lukbigorna: calls 1800
Kevin12345Mc: folds 
EESTINOKIA: folds 
*** FLOP *** [9s 4s 9h]
#27JETS: bets 5400
lukbigorna: calls 5400
*** TURN *** [9s 4s 9h] [Qh]
#27JETS: bets 16200
lukbigorna: folds 
Uncalled bet (16200) returned to #27JETS
#27JETS collected 16200 from pot
#27JETS: doesn't show hand 
neymaciel.nm has returned
*** SUMMARY ***
Total pot 16200 | Rake 0 
Board [9s 4s 9h Qh]
Seat 1: Nata1608 folded before Flop (didn't bet)
Seat 2: gustavomrp491 folded before Flop (didn't bet)
Seat 3: lukbigorna folded on the Turn
Seat 4: Kevin12345Mc folded before Flop
Seat 5: neymaciel.nm (button) folded before Flop (didn't bet)
Seat 6: EESTINOKIA (small blind) folded before Flop
Seat 7: #27JETS (big blind) collected (16200)
Seat 8: xMarker7x folded before Flop (didn't bet)



PokerStars Hand #254671364031: Tournament #3852792524, $4.80+$5.00+$1.20 USD Hold'em No Limit - Level II (100/200) - 2025/02/02 16:44:00 WET [2025/02/02 11:44:00 ET]
Table '3852792524 145' 8-max Seat #6 is the button
Seat 1: Nata1608 (24763 in chips, $5 bounty) 
Seat 2: gustavomrp491 (27200 in chips, $5 bounty) 
Seat 3: lukbigorna (17350 in chips, $5 bounty) 
Seat 4: Kevin12345Mc (19405 in chips, $5 bounty) 
Seat 5: neymaciel.nm (24625 in chips, $5 bounty) 
Seat 6: EESTINOKIA (48472 in chips, $7.50 bounty) 
Seat 7: #27JETS (33575 in chips, $5 bounty) 
Nata1608: posts the ante 25
gustavomrp491: posts the ante 25
lukbigorna: posts the ante 25
Kevin12345Mc: posts the ante 25
neymaciel.nm: posts the ante 25
EESTINOKIA: posts the ante 25
#27JETS: posts the ante 25
#27JETS: posts small blind 100
Nata1608: posts big blind 200
*** HOLE CARDS ***
Dealt to Kevin12345Mc [6d Qd]
EveDunHiLL is disconnected 
gustavomrp491: folds 
lukbigorna: raises 200 to 400
Kevin12345Mc: folds 
neymaciel.nm: folds 
EESTINOKIA: calls 400
#27JETS: folds 
Nata1608: calls 200
*** FLOP *** [Ah 9c 2c]
Nata1608: checks 
lukbigorna: bets 400
EESTINOKIA: folds 
Nata1608: calls 400
*** TURN *** [Ah 9c 2c] [2s]
Nata1608: checks 
lukbigorna: checks 
*** RIVER *** [Ah 9c 2c 2s] [3s]
Nata1608: checks 
lukbigorna: bets 1738
Nata1608: folds 
Uncalled bet (1738) returned to lukbigorna
lukbigorna collected 2275 from pot
lukbigorna: doesn't show hand 
*** SUMMARY ***
Total pot 2275 | Rake 0 
Board [Ah 9c 2c 2s 3s]
Seat 1: Nata1608 (big blind) folded on the River
Seat 2: gustavomrp491 folded before Flop (didn't bet)
Seat 3: lukbigorna collected (2275)
Seat 4: Kevin12345Mc folded before Flop (didn't bet)
Seat 5: neymaciel.nm folded before Flop (didn't bet)
Seat 6: EESTINOKIA (button) folded on the Flop
Seat 7: #27JETS (small blind) folded before Flop



PokerStars Hand #254671376312: Tournament #3852792524, $4.80+$5.00+$1.20 USD Hold'em No Limit - Level II (100/200) - 2025/02/02 16:44:42 WET [2025/02/02 11:44:42 ET]
Table '3852792524 145' 8-max Seat #7 is the button
Seat 1: Nata1608 (23938 in chips, $5 bounty) 
Seat 2: gustavomrp491 (27175 in chips, $5 bounty) 
Seat 3: lukbigorna (18800 in chips, $5 bounty) 
Seat 4: Kevin12345Mc (19380 in chips, $5 bounty) 
Seat 5: neymaciel.nm (24600 in chips, $5 bounty) 
Seat 6: EESTINOKIA (48047 in chips, $7.50 bounty) 
Seat 7: #27JETS (33450 in chips, $5 bounty) 
Seat 8: EveDunHiLL (25000 in chips) out of hand (moved from another table into small blind)
EveDunHiLL will be allowed to play after the button
Nata1608: posts the ante 25
gustavomrp491: posts the ante 25
lukbigorna: posts the ante 25
Kevin12345Mc: posts the ante 25
neymaciel.nm: posts the ante 25
EESTINOKIA: posts the ante 25
#27JETS: posts the ante 25
Nata1608: posts small blind 100
gustavomrp491: posts big blind 200
*** HOLE CARDS ***
Dealt to Kevin12345Mc [9s Qd]
lukbigorna: raises 200 to 400
Kevin12345Mc: folds 
neymaciel.nm is disconnected 
neymaciel.nm is connected 
neymaciel.nm is disconnected 
neymaciel.nm is connected 
neymaciel.nm: folds 
EESTINOKIA: calls 400
#27JETS: calls 400
Nata1608: folds 
gustavomrp491: raises 2400 to 2800
lukbigorna: calls 2400
EESTINOKIA: folds 
#27JETS: calls 2400
*** FLOP *** [Tc 9c 3h]
gustavomrp491: bets 4538
lukbigorna: calls 4538
#27JETS: raises 26087 to 30625 and is all-in
gustavomrp491: calls 19812 and is all-in
lukbigorna: calls 11437 and is all-in
Uncalled bet (6275) returned to #27JETS
*** TURN *** [Tc 9c 3h] [4s]
*** RIVER *** [Tc 9c 3h 4s] [5h]
*** SHOW DOWN ***
gustavomrp491: shows [Ts Ac] (a pair of Tens)
#27JETS: shows [Th Ad] (a pair of Tens)
gustavomrp491 collected 8375 from side pot
#27JETS collected 8375 from side pot
lukbigorna: shows [Js Qc] (high card Queen)
gustavomrp491 collected 28500 from main pot
#27JETS collected 28500 from main pot
gustavomrp491 wins $1.25 for splitting the elimination of lukbigorna and their own bounty increases by $1.25 to $6.25
#27JETS wins $1.25 for splitting the elimination of lukbigorna and their own bounty increases by $1.25 to $6.25
lukbigorna finished the tournament
pelelek is disconnected 
*** SUMMARY ***
Total pot 73750 Main pot 57000. Side pot 16750. | Rake 0 
Board [Tc 9c 3h 4s 5h]
Seat 1: Nata1608 (small blind) folded before Flop
Seat 2: gustavomrp491 (big blind) showed [Ts Ac] and won (36875) with a pair of Tens
Seat 3: lukbigorna showed [Js Qc] and lost with high card Queen
Seat 4: Kevin12345Mc folded before Flop (didn't bet)
Seat 5: neymaciel.nm folded before Flop (didn't bet)
Seat 6: EESTINOKIA folded before Flop
Seat 7: #27JETS (button) showed [Th Ad] and won (36875) with a pair of Tens



PokerStars Hand #254671403833: Tournament #3852792524, $4.80+$5.00+$1.20 USD Hold'em No Limit - Level III (125/250) - 2025/02/02 16:46:16 WET [2025/02/02 11:46:16 ET]
Table '3852792524 145' 8-max Seat #1 is the button
Seat 1: Nata1608 (23813 in chips, $5 bounty) 
Seat 2: gustavomrp491 (36875 in chips, $6.25 bounty) 
Seat 3: pelelek (25000 in chips, $5 bounty) 
Seat 4: Kevin12345Mc (19355 in chips, $5 bounty) 
Seat 5: neymaciel.nm (24575 in chips, $5 bounty) 
Seat 6: EESTINOKIA (47622 in chips, $7.50 bounty) 
Seat 7: #27JETS (43150 in chips, $6.25 bounty) 
Seat 8: EveDunHiLL (25000 in chips, $5 bounty) 
Nata1608: posts the ante 30
gustavomrp491: posts the ante 30
pelelek: posts the ante 30
Kevin12345Mc: posts the ante 30
neymaciel.nm: posts the ante 30
EESTINOKIA: posts the ante 30
#27JETS: posts the ante 30
EveDunHiLL: posts the ante 30
gustavomrp491: posts small blind 125
pelelek: posts big blind 250
*** HOLE CARDS ***
Dealt to Kevin12345Mc [8s Kh]
Kevin12345Mc: folds 
neymaciel.nm: folds 
EESTINOKIA: folds 
#27JETS: folds 
EveDunHiLL: raises 500 to 750
Nata1608: folds 
gustavomrp491: folds 
pelelek: folds 
Uncalled bet (500) returned to EveDunHiLL
EveDunHiLL collected 865 from pot
EveDunHiLL: doesn't show hand 
*** SUMMARY ***
Total pot 865 | Rake 0 
Seat 1: Nata1608 (button) folded before Flop (didn't bet)
Seat 2: gustavomrp491 (small blind) folded before Flop
Seat 3: pelelek (big blind) folded before Flop
Seat 4: Kevin12345Mc folded before Flop (didn't bet)
Seat 5: neymaciel.nm folded before Flop (didn't bet)
Seat 6: EESTINOKIA folded before Flop (didn't bet)
Seat 7: #27JETS folded before Flop (didn't bet)
Seat 8: EveDunHiLL collected (865)



PokerStars Hand #254671412940: Tournament #3852792524, $4.80+$5.00+$1.20 USD Hold'em No Limit - Level III (125/250) - 2025/02/02 16:46:46 WET [2025/02/02 11:46:46 ET]
Table '3852792524 145' 8-max Seat #2 is the button
Seat 1: Nata1608 (23783 in chips, $5 bounty) 
Seat 2: gustavomrp491 (36720 in chips, $6.25 bounty) 
Seat 3: pelelek (24720 in chips, $5 bounty) 
Seat 4: Kevin12345Mc (19325 in chips, $5 bounty) 
Seat 5: neymaciel.nm (24545 in chips, $5 bounty) 
Seat 6: EESTINOKIA (47592 in chips, $7.50 bounty) 
Seat 7: #27JETS (43120 in chips, $6.25 bounty) 
Seat 8: EveDunHiLL (25585 in chips, $5 bounty) 
Nata1608: posts the ante 30
gustavomrp491: posts the ante 30
pelelek: posts the ante 30
Kevin12345Mc: posts the ante 30
neymaciel.nm: posts the ante 30
EESTINOKIA: posts the ante 30
#27JETS: posts the ante 30
EveDunHiLL: posts the ante 30
pelelek: posts small blind 125
Kevin12345Mc: posts big blind 250
*** HOLE CARDS ***
Dealt to Kevin12345Mc [3h 6c]
neymaciel.nm: raises 250 to 500
EESTINOKIA: folds 
#27JETS: calls 500
EveDunHiLL: folds 
Nata1608: calls 500
gustavomrp491: folds 
pelelek: folds 
Kevin12345Mc: folds 
*** FLOP *** [2d 6s 6h]
neymaciel.nm: bets 1058
#27JETS: calls 1058
Nata1608: folds 
*** TURN *** [2d 6s 6h] [4h]
neymaciel.nm: bets 1866
#27JETS: calls 1866
*** RIVER *** [2d 6s 6h 4h] [8h]
neymaciel.nm: bets 7463
#27JETS: folds 
Uncalled bet (7463) returned to neymaciel.nm
neymaciel.nm collected 7963 from pot
neymaciel.nm: doesn't show hand 
*** SUMMARY ***
Total pot 7963 | Rake 0 
Board [2d 6s 6h 4h 8h]
Seat 1: Nata1608 folded on the Flop
Seat 2: gustavomrp491 (button) folded before Flop (didn't bet)
Seat 3: pelelek (small blind) folded before Flop
Seat 4: Kevin12345Mc (big blind) folded before Flop
Seat 5: neymaciel.nm collected (7963)
Seat 6: EESTINOKIA folded before Flop (didn't bet)
Seat 7: #27JETS folded on the River
Seat 8: EveDunHiLL folded before Flop (didn't bet)



PokerStars Hand #254671429927: Tournament #3852792524, $4.80+$5.00+$1.20 USD Hold'em No Limit - Level III (125/250) - 2025/02/02 16:47:44 WET [2025/02/02 11:47:44 ET]
Table '3852792524 145' 8-max Seat #3 is the button
Seat 1: Nata1608 (23253 in chips, $5 bounty) 
Seat 2: gustavomrp491 (36690 in chips, $6.25 bounty) 
Seat 3: pelelek (24565 in chips, $5 bounty) 
Seat 4: Kevin12345Mc (19045 in chips, $5 bounty) 
Seat 5: neymaciel.nm (29054 in chips, $5 bounty) 
Seat 6: EESTINOKIA (47562 in chips, $7.50 bounty) 
Seat 7: #27JETS (39666 in chips, $6.25 bounty) 
Seat 8: EveDunHiLL (25555 in chips, $5 bounty) 
Nata1608: posts the ante 30
gustavomrp491: posts the ante 30
pelelek: posts the ante 30
Kevin12345Mc: posts the ante 30
neymaciel.nm: posts the ante 30
EESTINOKIA: posts the ante 30
#27JETS: posts the ante 30
EveDunHiLL: posts the ante 30
Kevin12345Mc: posts small blind 125
neymaciel.nm: posts big blind 250
*** HOLE CARDS ***
Dealt to Kevin12345Mc [8s 5d]
EESTINOKIA: calls 250
#27JETS: calls 250
EveDunHiLL: folds 
Nata1608: folds 
gustavomrp491: folds 
pelelek: folds 
Kevin12345Mc: folds 
neymaciel.nm: checks 
*** FLOP *** [5c Jd 4d]
neymaciel.nm: checks 
EESTINOKIA: checks 
#27JETS: bets 558
neymaciel.nm: folds 
EESTINOKIA: folds 
Uncalled bet (558) returned to #27JETS
#27JETS collected 1115 from pot
#27JETS: doesn't show hand 
*** SUMMARY ***
Total pot 1115 | Rake 0 
Board [5c Jd 4d]
Seat 1: Nata1608 folded before Flop (didn't bet)
Seat 2: gustavomrp491 folded before Flop (didn't bet)
Seat 3: pelelek (button) folded before Flop (didn't bet)
Seat 4: Kevin12345Mc (small blind) folded before Flop
Seat 5: neymaciel.nm (big blind) folded on the Flop
Seat 6: EESTINOKIA folded on the Flop
Seat 7: #27JETS collected (1115)
Seat 8: EveDunHiLL folded before Flop (didn't bet)



PokerStars Hand #254671447131: Tournament #3852792524, $4.80+$5.00+$1.20 USD Hold'em No Limit - Level III (125/250) - 2025/02/02 16:48:43 WET [2025/02/02 11:48:43 ET]
Table '3852792524 145' 8-max Seat #4 is the button
Seat 1: Nata1608 (23223 in chips, $5 bounty) 
Seat 2: gustavomrp491 (36660 in chips, $6.25 bounty) 
Seat 3: pelelek (24535 in chips, $5 bounty) 
Seat 4: Kevin12345Mc (18890 in chips, $5 bounty) 
Seat 5: neymaciel.nm (28774 in chips, $5 bounty) 
Seat 6: EESTINOKIA (47282 in chips, $7.50 bounty) 
Seat 7: #27JETS (40501 in chips, $6.25 bounty) 
Seat 8: EveDunHiLL (25525 in chips, $5 bounty) 
Nata1608: posts the ante 30
gustavomrp491: posts the ante 30
pelelek: posts the ante 30
Kevin12345Mc: posts the ante 30
neymaciel.nm: posts the ante 30
EESTINOKIA: posts the ante 30
#27JETS: posts the ante 30
EveDunHiLL: posts the ante 30
neymaciel.nm: posts small blind 125
EESTINOKIA: posts big blind 250
*** HOLE CARDS ***
Dealt to Kevin12345Mc [5h Jh]
#27JETS: folds 
EveDunHiLL: raises 500 to 750
Nata1608: calls 750
gustavomrp491: folds 
pelelek: folds 
Kevin12345Mc: folds 
neymaciel.nm: folds 
EESTINOKIA: calls 500
*** FLOP *** [Tc 2s 4s]
EESTINOKIA: bets 1308
EveDunHiLL: folds 
Nata1608: calls 1308
*** TURN *** [Tc 2s 4s] [Jd]
EESTINOKIA: checks 
Nata1608: checks 
*** RIVER *** [Tc 2s 4s Jd] [9h]
EESTINOKIA: checks 
Nata1608: checks 
*** SHOW DOWN ***
EESTINOKIA: shows [7c Td] (a pair of Tens)
Nata1608: mucks hand 
EESTINOKIA collected 5231 from pot
*** SUMMARY ***
Total pot 5231 | Rake 0 
Board [Tc 2s 4s Jd 9h]
Seat 1: Nata1608 mucked [5d 4c]
Seat 2: gustavomrp491 folded before Flop (didn't bet)
Seat 3: pelelek folded before Flop (didn't bet)
Seat 4: Kevin12345Mc (button) folded before Flop (didn't bet)
Seat 5: neymaciel.nm (small blind) folded before Flop
Seat 6: EESTINOKIA (big blind) showed [7c Td] and won (5231) with a pair of Tens
Seat 7: #27JETS folded before Flop (didn't bet)
Seat 8: EveDunHiLL folded on the Flop



PokerStars Hand #254671464673: Tournament #3852792524, $4.80+$5.00+$1.20 USD Hold'em No Limit - Level III (125/250) - 2025/02/02 16:49:43 WET [2025/02/02 11:49:43 ET]
Table '3852792524 145' 8-max Seat #5 is the button
Seat 1: Nata1608 (21135 in chips, $5 bounty) 
Seat 2: gustavomrp491 (36630 in chips, $6.25 bounty) 
Seat 3: pelelek (24505 in chips, $5 bounty) 
Seat 4: Kevin12345Mc (18860 in chips, $5 bounty) 
Seat 5: neymaciel.nm (28619 in chips, $5 bounty) 
Seat 6: EESTINOKIA (50425 in chips, $7.50 bounty) 
Seat 7: #27JETS (40471 in chips, $6.25 bounty) 
Seat 8: EveDunHiLL (24745 in chips, $5 bounty) 
Nata1608: posts the ante 30
gustavomrp491: posts the ante 30
pelelek: posts the ante 30
Kevin12345Mc: posts the ante 30
neymaciel.nm: posts the ante 30
EESTINOKIA: posts the ante 30
#27JETS: posts the ante 30
EveDunHiLL: posts the ante 30
EESTINOKIA: posts small blind 125
#27JETS: posts big blind 250
*** HOLE CARDS ***
Dealt to Kevin12345Mc [5c Jd]
EveDunHiLL: folds 
Nata1608: raises 300 to 550
gustavomrp491: folds 
pelelek: folds 
Kevin12345Mc: folds 
neymaciel.nm: folds 
EESTINOKIA: folds 
#27JETS: calls 300
*** FLOP *** [4c 8d Qd]
#27JETS: checks 
Nata1608: bets 733
#27JETS: calls 733
*** TURN *** [4c 8d Qd] [8c]
#27JETS: bets 1250
Nata1608: folds 
Uncalled bet (1250) returned to #27JETS
#27JETS collected 2931 from pot
#27JETS: doesn't show hand 
*** SUMMARY ***
Total pot 2931 | Rake 0 
Board [4c 8d Qd 8c]
Seat 1: Nata1608 folded on the Turn
Seat 2: gustavomrp491 folded before Flop (didn't bet)
Seat 3: pelelek folded before Flop (didn't bet)
Seat 4: Kevin12345Mc folded before Flop (didn't bet)
Seat 5: neymaciel.nm (button) folded before Flop (didn't bet)
Seat 6: EESTINOKIA (small blind) folded before Flop
Seat 7: #27JETS (big blind) collected (2931)
Seat 8: EveDunHiLL folded before Flop (didn't bet)



PokerStars Hand #254671482483: Tournament #3852792524, $4.80+$5.00+$1.20 USD Hold'em No Limit - Level III (125/250) - 2025/02/02 16:50:43 WET [2025/02/02 11:50:43 ET]
Table '3852792524 145' 8-max Seat #6 is the button
Seat 1: Nata1608 (19822 in chips, $5 bounty) 
Seat 2: gustavomrp491 (36600 in chips, $6.25 bounty) 
Seat 3: pelelek (24475 in chips, $5 bounty) 
Seat 4: Kevin12345Mc (18830 in chips, $5 bounty) 
Seat 5: neymaciel.nm (28589 in chips, $5 bounty) 
Seat 6: EESTINOKIA (50270 in chips, $7.50 bounty) 
Seat 7: #27JETS (42089 in chips, $6.25 bounty) 
Seat 8: EveDunHiLL (24715 in chips, $5 bounty) 
Nata1608: posts the ante 30
gustavomrp491: posts the ante 30
pelelek: posts the ante 30
Kevin12345Mc: posts the ante 30
neymaciel.nm: posts the ante 30
EESTINOKIA: posts the ante 30
#27JETS: posts the ante 30
EveDunHiLL: posts the ante 30
#27JETS: posts small blind 125
EveDunHiLL: posts big blind 250
*** HOLE CARDS ***
Dealt to Kevin12345Mc [Qc 8h]
Nata1608: folds 
gustavomrp491: folds 
pelelek: folds 
Kevin12345Mc: folds 
neymaciel.nm: raises 301 to 551
EESTINOKIA: folds 
#27JETS: calls 426
EveDunHiLL: folds 
*** FLOP *** [Js Ac 6h]
#27JETS: checks 
gustavomrp491 is sitting out
neymaciel.nm: bets 750
#27JETS: folds 
Uncalled bet (750) returned to neymaciel.nm
neymaciel.nm collected 1592 from pot
neymaciel.nm: doesn't show hand 
*** SUMMARY ***
Total pot 1592 | Rake 0 
Board [Js Ac 6h]
Seat 1: Nata1608 folded before Flop (didn't bet)
Seat 2: gustavomrp491 folded before Flop (didn't bet)
Seat 3: pelelek folded before Flop (didn't bet)
Seat 4: Kevin12345Mc folded before Flop (didn't bet)
Seat 5: neymaciel.nm collected (1592)
Seat 6: EESTINOKIA (button) folded before Flop (didn't bet)
Seat 7: #27JETS (small blind) folded on the Flop
Seat 8: EveDunHiLL (big blind) folded before Flop



PokerStars Hand #254671502056: Tournament #3852792524, $4.80+$5.00+$1.20 USD Hold'em No Limit - Level III (125/250) - 2025/02/02 16:51:50 WET [2025/02/02 11:51:50 ET]
Table '3852792524 145' 8-max Seat #7 is the button
Seat 1: sebimace (25000 in chips, $5 bounty) 
Seat 2: gustavomrp491 (36570 in chips, $6.25 bounty) is sitting out
Seat 3: pelelek (24445 in chips, $5 bounty) 
Seat 4: Kevin12345Mc (18800 in chips, $5 bounty) 
Seat 5: neymaciel.nm (29600 in chips, $5 bounty) 
Seat 6: EESTINOKIA (50240 in chips, $7.50 bounty) 
Seat 7: #27JETS (41508 in chips, $6.25 bounty) 
Seat 8: EveDunHiLL (24435 in chips, $5 bounty) 
sebimace: posts the ante 30
gustavomrp491: posts the ante 30
pelelek: posts the ante 30
Kevin12345Mc: posts the ante 30
neymaciel.nm: posts the ante 30
EESTINOKIA: posts the ante 30
#27JETS: posts the ante 30
EveDunHiLL: posts the ante 30
EveDunHiLL: posts small blind 125
sebimace: posts big blind 250
*** HOLE CARDS ***
Dealt to Kevin12345Mc [8s 5h]
gustavomrp491: folds 
sebimace is disconnected 
pelelek: folds 
Kevin12345Mc: folds 
neymaciel.nm: folds 
EESTINOKIA: calls 250
#27JETS: folds 
EveDunHiLL: folds 
sebimace: raises 1250 to 1500
EESTINOKIA: calls 1250
*** FLOP *** [4d 7s 6c]
sebimace: bets 3365
EESTINOKIA: calls 3365
*** TURN *** [4d 7s 6c] [Jc]
sebimace: bets 5048
EESTINOKIA: calls 5048
*** RIVER *** [4d 7s 6c Jc] [Ac]
sebimace: checks 
EESTINOKIA: checks 
*** SHOW DOWN ***
sebimace: shows [9s 9d] (a pair of Nines)
EESTINOKIA: shows [2c 5c] (a flush, Ace high)
EESTINOKIA collected 20191 from pot
*** SUMMARY ***
Total pot 20191 | Rake 0 
Board [4d 7s 6c Jc Ac]
Seat 1: sebimace (big blind) showed [9s 9d] and lost with a pair of Nines
Seat 2: gustavomrp491 folded before Flop (didn't bet)
Seat 3: pelelek folded before Flop (didn't bet)
Seat 4: Kevin12345Mc folded before Flop (didn't bet)
Seat 5: neymaciel.nm folded before Flop (didn't bet)
Seat 6: EESTINOKIA showed [2c 5c] and won (20191) with a flush, Ace high
Seat 7: #27JETS (button) folded before Flop (didn't bet)
Seat 8: EveDunHiLL (small blind) folded before Flop



PokerStars Hand #254671516388: Tournament #3852792524, $4.80+$5.00+$1.20 USD Hold'em No Limit - Level III (125/250) - 2025/02/02 16:52:39 WET [2025/02/02 11:52:39 ET]
Table '3852792524 145' 8-max Seat #8 is the button
Seat 1: sebimace (15057 in chips, $5 bounty) 
Seat 2: gustavomrp491 (36540 in chips, $6.25 bounty) is sitting out
Seat 3: pelelek (24415 in chips, $5 bounty) 
Seat 4: Kevin12345Mc (18770 in chips, $5 bounty) 
Seat 5: neymaciel.nm (29570 in chips, $5 bounty) 
Seat 6: EESTINOKIA (60488 in chips, $7.50 bounty) 
Seat 7: #27JETS (41478 in chips, $6.25 bounty) 
Seat 8: EveDunHiLL (24280 in chips, $5 bounty) 
sebimace: posts the ante 30
gustavomrp491: posts the ante 30
pelelek: posts the ante 30
Kevin12345Mc: posts the ante 30
neymaciel.nm: posts the ante 30
EESTINOKIA: posts the ante 30
#27JETS: posts the ante 30
EveDunHiLL: posts the ante 30
sebimace: posts small blind 125
gustavomrp491: posts big blind 250
*** HOLE CARDS ***
Dealt to Kevin12345Mc [4h 2c]
pelelek: folds 
Kevin12345Mc: folds 
neymaciel.nm: folds 
EESTINOKIA: calls 250
#27JETS: folds 
EveDunHiLL: raises 1000 to 1250
sebimace: raises 13777 to 15027 and is all-in
gustavomrp491: folds 
EESTINOKIA: folds 
EveDunHiLL: folds 
Uncalled bet (13777) returned to sebimace
sebimace collected 3240 from pot
sebimace: doesn't show hand 
*** SUMMARY ***
Total pot 3240 | Rake 0 
Seat 1: sebimace (small blind) collected (3240)
Seat 2: gustavomrp491 (big blind) folded before Flop
Seat 3: pelelek folded before Flop (didn't bet)
Seat 4: Kevin12345Mc folded before Flop (didn't bet)
Seat 5: neymaciel.nm folded before Flop (didn't bet)
Seat 6: EESTINOKIA folded before Flop
Seat 7: #27JETS folded before Flop (didn't bet)
Seat 8: EveDunHiLL (button) folded before Flop



PokerStars Hand #254671531422: Tournament #3852792524, $4.80+$5.00+$1.20 USD Hold'em No Limit - Level III (125/250) - 2025/02/02 16:53:31 WET [2025/02/02 11:53:31 ET]
Table '3852792524 145' 8-max Seat #1 is the button
Seat 1: sebimace (17017 in chips, $5 bounty) 
Seat 2: gustavomrp491 (36260 in chips, $6.25 bounty) is sitting out
Seat 3: pelelek (24385 in chips, $5 bounty) 
Seat 4: Kevin12345Mc (18740 in chips, $5 bounty) 
Seat 5: neymaciel.nm (29540 in chips, $5 bounty) 
Seat 6: EESTINOKIA (60208 in chips, $7.50 bounty) 
Seat 7: #27JETS (41448 in chips, $6.25 bounty) 
Seat 8: EveDunHiLL (23000 in chips, $5 bounty) 
sebimace: posts the ante 30
gustavomrp491: posts the ante 30
pelelek: posts the ante 30
Kevin12345Mc: posts the ante 30
neymaciel.nm: posts the ante 30
EESTINOKIA: posts the ante 30
#27JETS: posts the ante 30
EveDunHiLL: posts the ante 30
gustavomrp491: posts small blind 125
pelelek: posts big blind 250
*** HOLE CARDS ***
Dealt to Kevin12345Mc [Js 6s]
Kevin12345Mc: folds 
neymaciel.nm: folds 
EESTINOKIA: folds 
gustavomrp491 has returned
#27JETS: folds 
EveDunHiLL: raises 500 to 750
sebimace: folds 
gustavomrp491: calls 625
pelelek: calls 500
*** FLOP *** [9d Ah Ts]
gustavomrp491: checks 
pelelek: checks 
EveDunHiLL: bets 822
gustavomrp491: calls 822
pelelek: calls 822
*** TURN *** [9d Ah Ts] [9s]
gustavomrp491: checks 
pelelek: checks 
EveDunHiLL: bets 3965
gustavomrp491: calls 3965
pelelek: calls 3965
*** RIVER *** [9d Ah Ts 9s] [Qc]
gustavomrp491: checks 
pelelek: checks 
EveDunHiLL: bets 13250
gustavomrp491: folds 
pelelek: raises 5568 to 18818 and is all-in
EveDunHiLL: calls 4183 and is all-in
Uncalled bet (1385) returned to pelelek
*** SHOW DOWN ***
pelelek: shows [As Qs] (two pair, Aces and Queens)
EveDunHiLL: shows [9h Qh] (a full house, Nines full of Queens)
EveDunHiLL collected 51717 from pot
*** SUMMARY ***
Total pot 51717 | Rake 0 
Board [9d Ah Ts 9s Qc]
Seat 1: sebimace (button) folded before Flop (didn't bet)
Seat 2: gustavomrp491 (small blind) folded on the River
Seat 3: pelelek (big blind) showed [As Qs] and lost with two pair, Aces and Queens
Seat 4: Kevin12345Mc folded before Flop (didn't bet)
Seat 5: neymaciel.nm folded before Flop (didn't bet)
Seat 6: EESTINOKIA folded before Flop (didn't bet)
Seat 7: #27JETS folded before Flop (didn't bet)
Seat 8: EveDunHiLL showed [9h Qh] and won (51717) with a full house, Nines full of Queens



PokerStars Hand #254671661121: Tournament #3852792524, $4.80+$5.00+$1.20 USD Hold'em No Limit - Level IV (150/300) - 2025/02/02 17:03:04 WET [2025/02/02 12:03:04 ET]
Table '3852792524 145' 8-max Seat #2 is the button
Seat 1: sebimace (16987 in chips, $5 bounty) 
Seat 2: gustavomrp491 (30693 in chips, $6.25 bounty) 
Seat 3: pelelek (1385 in chips, $5 bounty) 
Seat 4: Kevin12345Mc (18710 in chips, $5 bounty) 
Seat 5: neymaciel.nm (29510 in chips, $5 bounty) 
Seat 6: EESTINOKIA (60178 in chips, $7.50 bounty) 
Seat 7: #27JETS (41418 in chips, $6.25 bounty) 
Seat 8: omutst (25000 in chips, $5 bounty) 
sebimace: posts the ante 40
gustavomrp491: posts the ante 40
pelelek: posts the ante 40
Kevin12345Mc: posts the ante 40
neymaciel.nm: posts the ante 40
EESTINOKIA: posts the ante 40
#27JETS: posts the ante 40
omutst: posts the ante 40
pelelek: posts small blind 150
Kevin12345Mc: posts big blind 300
*** HOLE CARDS ***
Dealt to Kevin12345Mc [3s 9c]
neymaciel.nm: folds 
EESTINOKIA: folds 
#27JETS: raises 300 to 600
omutst: folds 
sebimace: folds 
gustavomrp491: folds 
pelelek: folds 
Kevin12345Mc: folds 
Uncalled bet (300) returned to #27JETS
#27JETS collected 1070 from pot
#27JETS: doesn't show hand 
*** SUMMARY ***
Total pot 1070 | Rake 0 
Seat 1: sebimace folded before Flop (didn't bet)
Seat 2: gustavomrp491 (button) folded before Flop (didn't bet)
Seat 3: pelelek (small blind) folded before Flop
Seat 4: Kevin12345Mc (big blind) folded before Flop
Seat 5: neymaciel.nm folded before Flop (didn't bet)
Seat 6: EESTINOKIA folded before Flop (didn't bet)
Seat 7: #27JETS collected (1070)
Seat 8: omutst folded before Flop (didn't bet)



PokerStars Hand #254671669753: Tournament #3852792524, $4.80+$5.00+$1.20 USD Hold'em No Limit - Level IV (150/300) - 2025/02/02 17:03:35 WET [2025/02/02 12:03:35 ET]
Table '3852792524 145' 8-max Seat #3 is the button
Seat 1: sebimace (16947 in chips, $5 bounty) 
Seat 2: gustavomrp491 (30653 in chips, $6.25 bounty) 
Seat 3: pelelek (1195 in chips, $5 bounty) 
Seat 4: Kevin12345Mc (18370 in chips, $5 bounty) 
Seat 5: neymaciel.nm (29470 in chips, $5 bounty) 
Seat 6: EESTINOKIA (60138 in chips, $7.50 bounty) 
Seat 7: #27JETS (42148 in chips, $6.25 bounty) 
Seat 8: omutst (24960 in chips, $5 bounty) 
sebimace: posts the ante 40
gustavomrp491: posts the ante 40
pelelek: posts the ante 40
Kevin12345Mc: posts the ante 40
neymaciel.nm: posts the ante 40
EESTINOKIA: posts the ante 40
#27JETS: posts the ante 40
omutst: posts the ante 40
Kevin12345Mc: posts small blind 150
neymaciel.nm: posts big blind 300
*** HOLE CARDS ***
Dealt to Kevin12345Mc [6c Tc]
EESTINOKIA: calls 300
#27JETS: folds 
omutst: raises 300 to 600
sebimace: folds 
gustavomrp491: folds 
pelelek: folds 
Kevin12345Mc: folds 
neymaciel.nm: folds 
EESTINOKIA: calls 300
*** FLOP *** [4s Jh 4h]
EESTINOKIA: checks 
omutst: bets 571
EESTINOKIA: folds 
Uncalled bet (571) returned to omutst
omutst collected 1970 from pot
omutst: doesn't show hand 
*** SUMMARY ***
Total pot 1970 | Rake 0 
Board [4s Jh 4h]
Seat 1: sebimace folded before Flop (didn't bet)
Seat 2: gustavomrp491 folded before Flop (didn't bet)
Seat 3: pelelek (button) folded before Flop (didn't bet)
Seat 4: Kevin12345Mc (small blind) folded before Flop
Seat 5: neymaciel.nm (big blind) folded before Flop
Seat 6: EESTINOKIA folded on the Flop
Seat 7: #27JETS folded before Flop (didn't bet)
Seat 8: omutst collected (1970)



PokerStars Hand #254671682062: Tournament #3852792524, $4.80+$5.00+$1.20 USD Hold'em No Limit - Level IV (150/300) - 2025/02/02 17:04:17 WET [2025/02/02 12:04:17 ET]
Table '3852792524 145' 8-max Seat #4 is the button
Seat 1: sebimace (16907 in chips, $5 bounty) 
Seat 2: gustavomrp491 (30613 in chips, $6.25 bounty) 
Seat 3: pelelek (1155 in chips, $5 bounty) 
Seat 4: Kevin12345Mc (18180 in chips, $5 bounty) 
Seat 5: neymaciel.nm (29130 in chips, $5 bounty) 
Seat 6: EESTINOKIA (59498 in chips, $7.50 bounty) 
Seat 7: #27JETS (42108 in chips, $6.25 bounty) 
Seat 8: omutst (26290 in chips, $5 bounty) 
sebimace: posts the ante 40
gustavomrp491: posts the ante 40
pelelek: posts the ante 40
Kevin12345Mc: posts the ante 40
neymaciel.nm: posts the ante 40
EESTINOKIA: posts the ante 40
#27JETS: posts the ante 40
omutst: posts the ante 40
neymaciel.nm: posts small blind 150
EESTINOKIA: posts big blind 300
*** HOLE CARDS ***
Dealt to Kevin12345Mc [As Jd]
#27JETS: raises 300 to 600
omutst: folds 
sebimace: calls 600
gustavomrp491: folds 
pelelek: folds 
Kevin12345Mc: calls 600
neymaciel.nm: calls 450
EESTINOKIA: calls 300
*** FLOP *** [5s Kh 4c]
neymaciel.nm: checks 
EESTINOKIA: bets 3320
#27JETS: calls 3320
sebimace: folds 
Kevin12345Mc: folds 
neymaciel.nm: folds 
*** TURN *** [5s Kh 4c] [8h]
EESTINOKIA: bets 4980
#27JETS: calls 4980
*** RIVER *** [5s Kh 4c 8h] [2s]
EESTINOKIA: checks 
#27JETS: checks 
*** SHOW DOWN ***
EESTINOKIA: shows [Jc Kc] (a pair of Kings)
#27JETS: mucks hand 
EESTINOKIA collected 19920 from pot
*** SUMMARY ***
Total pot 19920 | Rake 0 
Board [5s Kh 4c 8h 2s]
Seat 1: sebimace folded on the Flop
Seat 2: gustavomrp491 folded before Flop (didn't bet)
Seat 3: pelelek folded before Flop (didn't bet)
Seat 4: Kevin12345Mc (button) folded on the Flop
Seat 5: neymaciel.nm (small blind) folded on the Flop
Seat 6: EESTINOKIA (big blind) showed [Jc Kc] and won (19920) with a pair of Kings
Seat 7: #27JETS mucked [Kd 9d]
Seat 8: omutst folded before Flop (didn't bet)



PokerStars Hand #254671698224: Tournament #3852792524, $4.80+$5.00+$1.20 USD Hold'em No Limit - Level IV (150/300) - 2025/02/02 17:05:10 WET [2025/02/02 12:05:10 ET]
Table '3852792524 145' 8-max Seat #5 is the button
Seat 1: sebimace (16267 in chips, $5 bounty) 
Seat 2: gustavomrp491 (30573 in chips, $6.25 bounty) 
Seat 3: pelelek (1115 in chips, $5 bounty) 
Seat 4: Kevin12345Mc (17540 in chips, $5 bounty) 
Seat 5: neymaciel.nm (28490 in chips, $5 bounty) 
Seat 6: EESTINOKIA (70478 in chips, $7.50 bounty) 
Seat 7: #27JETS (33168 in chips, $6.25 bounty) 
Seat 8: omutst (26250 in chips, $5 bounty) 
sebimace: posts the ante 40
gustavomrp491: posts the ante 40
pelelek: posts the ante 40
Kevin12345Mc: posts the ante 40
neymaciel.nm: posts the ante 40
EESTINOKIA: posts the ante 40
#27JETS: posts the ante 40
omutst: posts the ante 40
EESTINOKIA: posts small blind 150
#27JETS: posts big blind 300
*** HOLE CARDS ***
Dealt to Kevin12345Mc [Ad 7h]
omutst: raises 300 to 600
sebimace: folds 
gustavomrp491: calls 600
pelelek: folds 
Kevin12345Mc: folds 
neymaciel.nm: folds 
EESTINOKIA: calls 450
#27JETS: folds 
*** FLOP *** [Ts Qd 7c]
EESTINOKIA: checks 
omutst: bets 702
gustavomrp491: raises 1398 to 2100
EESTINOKIA: folds 
omutst: calls 1398
*** TURN *** [Ts Qd 7c] [9s]
omutst: checks 
gustavomrp491: checks 
*** RIVER *** [Ts Qd 7c 9s] [Td]
omutst: bets 2780
gustavomrp491: calls 2780
*** SHOW DOWN ***
omutst: shows [Jc Kc] (a straight, Nine to King)
gustavomrp491: mucks hand 
omutst collected 12180 from pot
*** SUMMARY ***
Total pot 12180 | Rake 0 
Board [Ts Qd 7c 9s Td]
Seat 1: sebimace folded before Flop (didn't bet)
Seat 2: gustavomrp491 mucked [Kh Qh]
Seat 3: pelelek folded before Flop (didn't bet)
Seat 4: Kevin12345Mc folded before Flop (didn't bet)
Seat 5: neymaciel.nm (button) folded before Flop (didn't bet)
Seat 6: EESTINOKIA (small blind) folded on the Flop
Seat 7: #27JETS (big blind) folded before Flop
Seat 8: omutst showed [Jc Kc] and won (12180) with a straight, Nine to King



PokerStars Hand #254671729038: Tournament #3852792524, $4.80+$5.00+$1.20 USD Hold'em No Limit - Level IV (150/300) - 2025/02/02 17:06:52 WET [2025/02/02 12:06:52 ET]
Table '3852792524 145' 8-max Seat #6 is the button
Seat 1: sebimace (16227 in chips, $5 bounty) 
Seat 2: gustavomrp491 (25053 in chips, $6.25 bounty) 
Seat 3: pelelek (1075 in chips, $5 bounty) 
Seat 4: Kevin12345Mc (17500 in chips, $5 bounty) 
Seat 5: neymaciel.nm (28450 in chips, $5 bounty) 
Seat 6: EESTINOKIA (69838 in chips, $7.50 bounty) 
Seat 7: #27JETS (32828 in chips, $6.25 bounty) 
Seat 8: omutst (32910 in chips, $5 bounty) 
sebimace: posts the ante 40
gustavomrp491: posts the ante 40
pelelek: posts the ante 40
Kevin12345Mc: posts the ante 40
neymaciel.nm: posts the ante 40
EESTINOKIA: posts the ante 40
#27JETS: posts the ante 40
omutst: posts the ante 40
#27JETS: posts small blind 150
omutst: posts big blind 300
*** HOLE CARDS ***
Dealt to Kevin12345Mc [3h 2c]
sebimace: folds 
gustavomrp491: raises 300 to 600
pelelek: raises 435 to 1035 and is all-in
Kevin12345Mc: folds 
neymaciel.nm: folds 
EESTINOKIA: folds 
#27JETS: folds 
omutst: folds 
gustavomrp491: calls 435
*** FLOP *** [Jh 9h 8d]
*** TURN *** [Jh 9h 8d] [Qh]
*** RIVER *** [Jh 9h 8d Qh] [6h]
*** SHOW DOWN ***
gustavomrp491: shows [4c Ac] (high card Ace)
pelelek: shows [4d 9d] (a pair of Nines)
pelelek collected 2840 from pot
*** SUMMARY ***
Total pot 2840 | Rake 0 
Board [Jh 9h 8d Qh 6h]
Seat 1: sebimace folded before Flop (didn't bet)
Seat 2: gustavomrp491 showed [4c Ac] and lost with high card Ace
Seat 3: pelelek showed [4d 9d] and won (2840) with a pair of Nines
Seat 4: Kevin12345Mc folded before Flop (didn't bet)
Seat 5: neymaciel.nm folded before Flop (didn't bet)
Seat 6: EESTINOKIA (button) folded before Flop (didn't bet)
Seat 7: #27JETS (small blind) folded before Flop
Seat 8: omutst (big blind) folded before Flop



PokerStars Hand #254671743551: Tournament #3852792524, $4.80+$5.00+$1.20 USD Hold'em No Limit - Level IV (150/300) - 2025/02/02 17:07:40 WET [2025/02/02 12:07:40 ET]
Table '3852792524 145' 8-max Seat #7 is the button
Seat 1: sebimace (16187 in chips, $5 bounty) 
Seat 2: gustavomrp491 (23978 in chips, $6.25 bounty) 
Seat 3: pelelek (2840 in chips, $5 bounty) 
Seat 4: Kevin12345Mc (17460 in chips, $5 bounty) 
Seat 5: neymaciel.nm (28410 in chips, $5 bounty) 
Seat 6: EESTINOKIA (69798 in chips, $7.50 bounty) 
Seat 7: #27JETS (32638 in chips, $6.25 bounty) 
Seat 8: omutst (32570 in chips, $5 bounty) 
sebimace: posts the ante 40
gustavomrp491: posts the ante 40
pelelek: posts the ante 40
Kevin12345Mc: posts the ante 40
neymaciel.nm: posts the ante 40
EESTINOKIA: posts the ante 40
#27JETS: posts the ante 40
omutst: posts the ante 40
omutst: posts small blind 150
sebimace: posts big blind 300
*** HOLE CARDS ***
Dealt to Kevin12345Mc [9h 7h]
gustavomrp491: folds 
pelelek: folds 
Kevin12345Mc: folds 
neymaciel.nm: folds 
EESTINOKIA: folds 
#27JETS: folds 
omutst: calls 150
sebimace: checks 
*** FLOP *** [Ah 4s 4h]
omutst: bets 300
sebimace: folds 
Uncalled bet (300) returned to omutst
omutst collected 920 from pot
omutst: doesn't show hand 
*** SUMMARY ***
Total pot 920 | Rake 0 
Board [Ah 4s 4h]
Seat 1: sebimace (big blind) folded on the Flop
Seat 2: gustavomrp491 folded before Flop (didn't bet)
Seat 3: pelelek folded before Flop (didn't bet)
Seat 4: Kevin12345Mc folded before Flop (didn't bet)
Seat 5: neymaciel.nm folded before Flop (didn't bet)
Seat 6: EESTINOKIA folded before Flop (didn't bet)
Seat 7: #27JETS (button) folded before Flop (didn't bet)
Seat 8: omutst (small blind) collected (920)



PokerStars Hand #254671750967: Tournament #3852792524, $4.80+$5.00+$1.20 USD Hold'em No Limit - Level IV (150/300) - 2025/02/02 17:08:04 WET [2025/02/02 12:08:04 ET]
Table '3852792524 145' 8-max Seat #8 is the button
Seat 1: sebimace (15847 in chips, $5 bounty) 
Seat 2: gustavomrp491 (23938 in chips, $6.25 bounty) 
Seat 3: pelelek (2800 in chips, $5 bounty) 
Seat 4: Kevin12345Mc (17420 in chips, $5 bounty) 
Seat 5: neymaciel.nm (28370 in chips, $5 bounty) 
Seat 6: EESTINOKIA (69758 in chips, $7.50 bounty) 
Seat 7: #27JETS (32598 in chips, $6.25 bounty) 
Seat 8: omutst (33150 in chips, $5 bounty) 
sebimace: posts the ante 40
gustavomrp491: posts the ante 40
pelelek: posts the ante 40
Kevin12345Mc: posts the ante 40
neymaciel.nm: posts the ante 40
EESTINOKIA: posts the ante 40
#27JETS: posts the ante 40
omutst: posts the ante 40
sebimace: posts small blind 150
gustavomrp491: posts big blind 300
*** HOLE CARDS ***
Dealt to Kevin12345Mc [Qc Qh]
pelelek: folds 
Kevin12345Mc: raises 390 to 690
neymaciel.nm: raises 454 to 1144
EESTINOKIA: folds 
#27JETS: folds 
omutst: calls 1144
sebimace: folds 
gustavomrp491: folds 
Kevin12345Mc: raises 16236 to 17380 and is all-in
neymaciel.nm: folds 
omutst: folds 
Uncalled bet (16236) returned to Kevin12345Mc
Kevin12345Mc collected 4202 from pot
Kevin12345Mc: doesn't show hand 
*** SUMMARY ***
Total pot 4202 | Rake 0 
Seat 1: sebimace (small blind) folded before Flop
Seat 2: gustavomrp491 (big blind) folded before Flop
Seat 3: pelelek folded before Flop (didn't bet)
Seat 4: Kevin12345Mc collected (4202)
Seat 5: neymaciel.nm folded before Flop
Seat 6: EESTINOKIA folded before Flop (didn't bet)
Seat 7: #27JETS folded before Flop (didn't bet)
Seat 8: omutst (button) folded before Flop



PokerStars Hand #254671769880: Tournament #3852792524, $4.80+$5.00+$1.20 USD Hold'em No Limit - Level IV (150/300) - 2025/02/02 17:09:06 WET [2025/02/02 12:09:06 ET]
Table '3852792524 145' 8-max Seat #1 is the button
Seat 1: sebimace (15657 in chips, $5 bounty) 
Seat 2: gustavomrp491 (23598 in chips, $6.25 bounty) 
Seat 3: pelelek (2760 in chips, $5 bounty) 
Seat 4: Kevin12345Mc (20438 in chips, $5 bounty) 
Seat 5: neymaciel.nm (27186 in chips, $5 bounty) 
Seat 6: EESTINOKIA (69718 in chips, $7.50 bounty) 
Seat 7: #27JETS (32558 in chips, $6.25 bounty) 
Seat 8: omutst (31966 in chips, $5 bounty) 
sebimace: posts the ante 40
gustavomrp491: posts the ante 40
pelelek: posts the ante 40
Kevin12345Mc: posts the ante 40
neymaciel.nm: posts the ante 40
EESTINOKIA: posts the ante 40
#27JETS: posts the ante 40
omutst: posts the ante 40
gustavomrp491: posts small blind 150
pelelek: posts big blind 300
*** HOLE CARDS ***
Dealt to Kevin12345Mc [Ah 8s]
Kevin12345Mc: folds 
neymaciel.nm: calls 300
EESTINOKIA: folds 
#27JETS: folds 
omutst: raises 900 to 1200
sebimace: calls 1200
gustavomrp491: folds 
pelelek: folds 
neymaciel.nm: calls 900
*** FLOP *** [9d 9c 6c]
neymaciel.nm: checks 
omutst: bets 1267
sebimace: calls 1267
neymaciel.nm: folds 
*** TURN *** [9d 9c 6c] [7h]
omutst: bets 2900
sebimace: calls 2900
*** RIVER *** [9d 9c 6c 7h] [Jd]
omutst: bets 26559 and is all-in
sebimace: folds 
Uncalled bet (26559) returned to omutst
omutst collected 12704 from pot
omutst: doesn't show hand 
*** SUMMARY ***
Total pot 12704 | Rake 0 
Board [9d 9c 6c 7h Jd]
Seat 1: sebimace (button) folded on the River
Seat 2: gustavomrp491 (small blind) folded before Flop
Seat 3: pelelek (big blind) folded before Flop
Seat 4: Kevin12345Mc folded before Flop (didn't bet)
Seat 5: neymaciel.nm folded on the Flop
Seat 6: EESTINOKIA folded before Flop (didn't bet)
Seat 7: #27JETS folded before Flop (didn't bet)
Seat 8: omutst collected (12704)



PokerStars Hand #254671794952: Tournament #3852792524, $4.80+$5.00+$1.20 USD Hold'em No Limit - Level V (200/400) - 2025/02/02 17:10:28 WET [2025/02/02 12:10:28 ET]
Table '3852792524 145' 8-max Seat #2 is the button
Seat 1: sebimace (10250 in chips, $5 bounty) 
Seat 2: gustavomrp491 (23408 in chips, $6.25 bounty) 
Seat 3: pelelek (2420 in chips, $5 bounty) 
Seat 4: Kevin12345Mc (20398 in chips, $5 bounty) 
Seat 5: neymaciel.nm (25946 in chips, $5 bounty) 
Seat 6: EESTINOKIA (69678 in chips, $7.50 bounty) 
Seat 7: #27JETS (32518 in chips, $6.25 bounty) 
Seat 8: omutst (39263 in chips, $5 bounty) 
sebimace: posts the ante 50
gustavomrp491: posts the ante 50
pelelek: posts the ante 50
Kevin12345Mc: posts the ante 50
neymaciel.nm: posts the ante 50
EESTINOKIA: posts the ante 50
#27JETS: posts the ante 50
omutst: posts the ante 50
pelelek: posts small blind 200
Kevin12345Mc: posts big blind 400
*** HOLE CARDS ***
Dealt to Kevin12345Mc [Js Jc]
neymaciel.nm: folds 
EESTINOKIA: folds 
#27JETS: folds 
omutst: folds 
sebimace: calls 400
gustavomrp491: folds 
pelelek: raises 1970 to 2370 and is all-in
Kevin12345Mc: raises 16430 to 18800
sebimace: calls 9800 and is all-in
Uncalled bet (8600) returned to Kevin12345Mc
*** FLOP *** [7h As Ks]
*** TURN *** [7h As Ks] [5h]
*** RIVER *** [7h As Ks 5h] [5c]
*** SHOW DOWN ***
Kevin12345Mc: shows [Js Jc] (two pair, Jacks and Fives)
sebimace: shows [Ts 8d] (a pair of Fives)
Kevin12345Mc collected 15660 from side pot
pelelek: shows [Ad 8h] (two pair, Aces and Fives)
pelelek collected 7510 from main pot
Kevin12345Mc wins $2.50 for eliminating sebimace and their own bounty increases by $2.50 to $7.50
sebimace finished the tournament
official_dapic is disconnected 
*** SUMMARY ***
Total pot 23170 Main pot 7510. Side pot 15660. | Rake 0 
Board [7h As Ks 5h 5c]
Seat 1: sebimace showed [Ts 8d] and lost with a pair of Fives
Seat 2: gustavomrp491 (button) folded before Flop (didn't bet)
Seat 3: pelelek (small blind) showed [Ad 8h] and won (7510) with two pair, Aces and Fives
Seat 4: Kevin12345Mc (big blind) showed [Js Jc] and won (15660) with two pair, Jacks and Fives
Seat 5: neymaciel.nm folded before Flop (didn't bet)
Seat 6: EESTINOKIA folded before Flop (didn't bet)
Seat 7: #27JETS folded before Flop (didn't bet)
Seat 8: omutst folded before Flop (didn't bet)



PokerStars Hand #254671809401: Tournament #3852792524, $4.80+$5.00+$1.20 USD Hold'em No Limit - Level V (200/400) - 2025/02/02 17:11:15 WET [2025/02/02 12:11:15 ET]
Table '3852792524 145' 8-max Seat #3 is the button
Seat 1: official_dapic (25000 in chips, $5 bounty) 
Seat 2: gustavomrp491 (23358 in chips, $6.25 bounty) 
Seat 3: pelelek (7510 in chips, $5 bounty) 
Seat 4: Kevin12345Mc (25808 in chips, $7.50 bounty) 
Seat 5: stacho10 (44920 in chips, $7.50 bounty) 
Seat 6: EESTINOKIA (69628 in chips, $7.50 bounty) 
Seat 7: #27JETS (32468 in chips, $6.25 bounty) 
Seat 8: omutst (39213 in chips, $5 bounty) 
official_dapic: posts the ante 50
gustavomrp491: posts the ante 50
pelelek: posts the ante 50
Kevin12345Mc: posts the ante 50
stacho10: posts the ante 50
EESTINOKIA: posts the ante 50
#27JETS: posts the ante 50
omutst: posts the ante 50
Kevin12345Mc: posts small blind 200
stacho10: posts big blind 400
*** HOLE CARDS ***
Dealt to Kevin12345Mc [Ad 4s]
EESTINOKIA: calls 400
#27JETS: calls 400
omutst: folds 
official_dapic: raises 1200 to 1600
gustavomrp491: folds 
pelelek: folds 
Kevin12345Mc: folds 
stacho10: calls 1200
EESTINOKIA: calls 1200
#27JETS: calls 1200
*** FLOP *** [7s 3s Qd]
stacho10: checks 
EESTINOKIA: bets 7000
#27JETS: folds 
official_dapic: calls 7000
stacho10: folds 
*** TURN *** [7s 3s Qd] [Jh]
EESTINOKIA: bets 21000
official_dapic: calls 16350 and is all-in
Uncalled bet (4650) returned to EESTINOKIA
*** RIVER *** [7s 3s Qd Jh] [5h]
*** SHOW DOWN ***
EESTINOKIA: shows [Qs Ac] (a pair of Queens)
official_dapic: shows [Ks Kd] (a pair of Kings)
official_dapic collected 53700 from pot
*** SUMMARY ***
Total pot 53700 | Rake 0 
Board [7s 3s Qd Jh 5h]
Seat 1: official_dapic showed [Ks Kd] and won (53700) with a pair of Kings
Seat 2: gustavomrp491 folded before Flop (didn't bet)
Seat 3: pelelek (button) folded before Flop (didn't bet)
Seat 4: Kevin12345Mc (small blind) folded before Flop
Seat 5: stacho10 (big blind) folded on the Flop
Seat 6: EESTINOKIA showed [Qs Ac] and lost with a pair of Queens
Seat 7: #27JETS folded on the Flop
Seat 8: omutst folded before Flop (didn't bet)



PokerStars Hand #254671835509: Tournament #3852792524, $4.80+$5.00+$1.20 USD Hold'em No Limit - Level V (200/400) - 2025/02/02 17:12:38 WET [2025/02/02 12:12:38 ET]
Table '3852792524 145' 8-max Seat #4 is the button
Seat 1: official_dapic (53700 in chips, $5 bounty) 
Seat 2: gustavomrp491 (23308 in chips, $6.25 bounty) 
Seat 3: pelelek (7460 in chips, $5 bounty) 
Seat 4: Kevin12345Mc (25558 in chips, $7.50 bounty) 
Seat 5: stacho10 (43270 in chips, $7.50 bounty) 
Seat 6: EESTINOKIA (44628 in chips, $7.50 bounty) 
Seat 7: #27JETS (30818 in chips, $6.25 bounty) 
Seat 8: omutst (39163 in chips, $5 bounty) 
official_dapic: posts the ante 50
gustavomrp491: posts the ante 50
pelelek: posts the ante 50
Kevin12345Mc: posts the ante 50
stacho10: posts the ante 50
EESTINOKIA: posts the ante 50
#27JETS: posts the ante 50
omutst: posts the ante 50
stacho10: posts small blind 200
EESTINOKIA: posts big blind 400
*** HOLE CARDS ***
Dealt to Kevin12345Mc [8c Jh]
#27JETS: folds 
omutst: folds 
official_dapic: folds 
gustavomrp491: folds 
pelelek: folds 
Kevin12345Mc: folds 
stacho10: folds 
Uncalled bet (200) returned to EESTINOKIA
EESTINOKIA collected 800 from pot
EESTINOKIA: doesn't show hand 
*** SUMMARY ***
Total pot 800 | Rake 0 
Seat 1: official_dapic folded before Flop (didn't bet)
Seat 2: gustavomrp491 folded before Flop (didn't bet)
Seat 3: pelelek folded before Flop (didn't bet)
Seat 4: Kevin12345Mc (button) folded before Flop (didn't bet)
Seat 5: stacho10 (small blind) folded before Flop
Seat 6: EESTINOKIA (big blind) collected (800)
Seat 7: #27JETS folded before Flop (didn't bet)
Seat 8: omutst folded before Flop (didn't bet)



PokerStars Hand #254671842127: Tournament #3852792524, $4.80+$5.00+$1.20 USD Hold'em No Limit - Level V (200/400) - 2025/02/02 17:12:59 WET [2025/02/02 12:12:59 ET]
Table '3852792524 145' 8-max Seat #5 is the button
Seat 1: official_dapic (53650 in chips, $5 bounty) 
Seat 2: gustavomrp491 (23258 in chips, $6.25 bounty) 
Seat 3: pelelek (7410 in chips, $5 bounty) 
Seat 4: Kevin12345Mc (25508 in chips, $7.50 bounty) 
Seat 5: stacho10 (43020 in chips, $7.50 bounty) 
Seat 6: EESTINOKIA (45178 in chips, $7.50 bounty) 
Seat 7: #27JETS (30768 in chips, $6.25 bounty) 
Seat 8: omutst (39113 in chips, $5 bounty) 
official_dapic: posts the ante 50
gustavomrp491: posts the ante 50
pelelek: posts the ante 50
Kevin12345Mc: posts the ante 50
stacho10: posts the ante 50
EESTINOKIA: posts the ante 50
#27JETS: posts the ante 50
omutst: posts the ante 50
EESTINOKIA: posts small blind 200
#27JETS: posts big blind 400
*** HOLE CARDS ***
Dealt to Kevin12345Mc [5c Kc]
omutst: raises 400 to 800
official_dapic: folds 
gustavomrp491: folds 
pelelek: calls 800
Kevin12345Mc: folds 
stacho10: folds 
EESTINOKIA: raises 3200 to 4000
#27JETS: folds 
omutst: folds 
pelelek: calls 3200
*** FLOP *** [7d 3s 4c]
EESTINOKIA: bets 4800
pelelek: calls 3360 and is all-in
Uncalled bet (1440) returned to EESTINOKIA
*** TURN *** [7d 3s 4c] [3h]
*** RIVER *** [7d 3s 4c 3h] [Kd]
*** SHOW DOWN ***
EESTINOKIA: shows [Jc Qd] (a pair of Threes)
pelelek: shows [8h 8s] (two pair, Eights and Threes)
pelelek collected 16320 from pot
*** SUMMARY ***
Total pot 16320 | Rake 0 
Board [7d 3s 4c 3h Kd]
Seat 1: official_dapic folded before Flop (didn't bet)
Seat 2: gustavomrp491 folded before Flop (didn't bet)
Seat 3: pelelek showed [8h 8s] and won (16320) with two pair, Eights and Threes
Seat 4: Kevin12345Mc folded before Flop (didn't bet)
Seat 5: stacho10 (button) folded before Flop (didn't bet)
Seat 6: EESTINOKIA (small blind) showed [Jc Qd] and lost with a pair of Threes
Seat 7: #27JETS (big blind) folded before Flop
Seat 8: omutst folded before Flop



PokerStars Hand #254671860049: Tournament #3852792524, $4.80+$5.00+$1.20 USD Hold'em No Limit - Level V (200/400) - 2025/02/02 17:13:56 WET [2025/02/02 12:13:56 ET]
Table '3852792524 145' 8-max Seat #6 is the button
Seat 1: official_dapic (53600 in chips, $5 bounty) 
Seat 2: gustavomrp491 (23208 in chips, $6.25 bounty) 
Seat 3: pelelek (16320 in chips, $5 bounty) 
Seat 4: Kevin12345Mc (25458 in chips, $7.50 bounty) 
Seat 5: stacho10 (42970 in chips, $7.50 bounty) 
Seat 6: EESTINOKIA (37768 in chips, $7.50 bounty) 
Seat 7: #27JETS (30318 in chips, $6.25 bounty) 
Seat 8: omutst (38263 in chips, $5 bounty) 
official_dapic: posts the ante 50
gustavomrp491: posts the ante 50
pelelek: posts the ante 50
Kevin12345Mc: posts the ante 50
stacho10: posts the ante 50
EESTINOKIA: posts the ante 50
#27JETS: posts the ante 50
omutst: posts the ante 50
#27JETS: posts small blind 200
omutst: posts big blind 400
*** HOLE CARDS ***
Dealt to Kevin12345Mc [Qc 3d]
official_dapic: folds 
gustavomrp491: folds 
pelelek: folds 
Kevin12345Mc: folds 
stacho10: folds 
EESTINOKIA: folds 
#27JETS: calls 200
omutst: raises 1400 to 1800
#27JETS: raises 28468 to 30268 and is all-in
omutst: calls 28468
*** FLOP *** [Kc 8c 7c]
*** TURN *** [Kc 8c 7c] [6s]
*** RIVER *** [Kc 8c 7c 6s] [Tc]
*** SHOW DOWN ***
#27JETS: shows [9c 9s] (a flush, King high)
omutst: shows [Ah Jc] (a flush, King high - Jack higher)
omutst collected 60936 from pot
omutst wins $3.13 for eliminating #27JETS and their own bounty increases by $3.12 to $8.12
#27JETS finished the tournament
*** SUMMARY ***
Total pot 60936 | Rake 0 
Board [Kc 8c 7c 6s Tc]
Seat 1: official_dapic folded before Flop (didn't bet)
Seat 2: gustavomrp491 folded before Flop (didn't bet)
Seat 3: pelelek folded before Flop (didn't bet)
Seat 4: Kevin12345Mc folded before Flop (didn't bet)
Seat 5: stacho10 folded before Flop (didn't bet)
Seat 6: EESTINOKIA (button) folded before Flop (didn't bet)
Seat 7: #27JETS (small blind) showed [9c 9s] and lost with a flush, King high
Seat 8: omutst (big blind) showed [Ah Jc] and won (60936) with a flush, King high



PokerStars Hand #254671874782: Tournament #3852792524, $4.80+$5.00+$1.20 USD Hold'em No Limit - Level V (200/400) - 2025/02/02 17:14:43 WET [2025/02/02 12:14:43 ET]
Table '3852792524 145' 8-max Seat #8 is the button
Seat 1: official_dapic (53550 in chips, $5 bounty) 
Seat 2: gustavomrp491 (23158 in chips, $6.25 bounty) 
Seat 3: pelelek (16270 in chips, $5 bounty) 
Seat 4: Kevin12345Mc (25408 in chips, $7.50 bounty) 
Seat 5: stacho10 (42920 in chips, $7.50 bounty) 
Seat 6: EESTINOKIA (37718 in chips, $7.50 bounty) 
Seat 8: omutst (68881 in chips, $8.12 bounty) 
official_dapic: posts the ante 50
gustavomrp491: posts the ante 50
pelelek: posts the ante 50
Kevin12345Mc: posts the ante 50
stacho10: posts the ante 50
EESTINOKIA: posts the ante 50
omutst: posts the ante 50
official_dapic: posts small blind 200
gustavomrp491: posts big blind 400
*** HOLE CARDS ***
Dealt to Kevin12345Mc [6c 7c]
Boks0 is disconnected 
pelelek: folds 
Kevin12345Mc: folds 
stacho10: calls 400
EESTINOKIA: calls 400
omutst: folds 
official_dapic: calls 200
gustavomrp491: checks 
*** FLOP *** [9c Js Qh]
official_dapic: checks 
gustavomrp491: checks 
stacho10: checks 
EESTINOKIA: checks 
*** TURN *** [9c Js Qh] [8d]
official_dapic: checks 
gustavomrp491: bets 1200
stacho10: calls 1200
EESTINOKIA: calls 1200
official_dapic: folds 
*** RIVER *** [9c Js Qh 8d] [6s]
gustavomrp491: bets 5550
stacho10: folds 
EESTINOKIA: folds 
Uncalled bet (5550) returned to gustavomrp491
gustavomrp491 collected 5550 from pot
gustavomrp491: doesn't show hand 
*** SUMMARY ***
Total pot 5550 | Rake 0 
Board [9c Js Qh 8d 6s]
Seat 1: official_dapic (small blind) folded on the Turn
Seat 2: gustavomrp491 (big blind) collected (5550)
Seat 3: pelelek folded before Flop (didn't bet)
Seat 4: Kevin12345Mc folded before Flop (didn't bet)
Seat 5: stacho10 folded on the River
Seat 6: EESTINOKIA folded on the River
Seat 8: omutst (button) folded before Flop (didn't bet)



PokerStars Hand #254671897716: Tournament #3852792524, $4.80+$5.00+$1.20 USD Hold'em No Limit - Level V (200/400) - 2025/02/02 17:15:56 WET [2025/02/02 12:15:56 ET]
Table '3852792524 145' 8-max Seat #1 is the button
Seat 1: official_dapic (53100 in chips, $5 bounty) 
Seat 2: gustavomrp491 (27058 in chips, $6.25 bounty) 
Seat 3: pelelek (16220 in chips, $5 bounty) 
Seat 4: Kevin12345Mc (25358 in chips, $7.50 bounty) 
Seat 5: stacho10 (41270 in chips, $7.50 bounty) 
Seat 6: EESTINOKIA (36068 in chips, $7.50 bounty) 
Seat 7: Boks0 (25000 in chips, $5 bounty) 
Seat 8: omutst (68831 in chips, $8.12 bounty) 
official_dapic: posts the ante 50
gustavomrp491: posts the ante 50
pelelek: posts the ante 50
Kevin12345Mc: posts the ante 50
stacho10: posts the ante 50
EESTINOKIA: posts the ante 50
Boks0: posts the ante 50
omutst: posts the ante 50
gustavomrp491: posts small blind 200
pelelek: posts big blind 400
*** HOLE CARDS ***
Dealt to Kevin12345Mc [2c 8c]
Kevin12345Mc: folds 
stacho10: folds 
EESTINOKIA: calls 400
Boks0: folds 
omutst: folds 
official_dapic: folds 
gustavomrp491: raises 1600 to 2000
pelelek: folds 
EESTINOKIA: calls 1600
*** FLOP *** [3d Td 5s]
gustavomrp491: bets 1584
EESTINOKIA: calls 1584
*** TURN *** [3d Td 5s] [Tc]
gustavomrp491: checks 
EESTINOKIA: checks 
*** RIVER *** [3d Td 5s Tc] [2s]
gustavomrp491: bets 7968
EESTINOKIA: folds 
Uncalled bet (7968) returned to gustavomrp491
gustavomrp491 collected 7968 from pot
gustavomrp491: doesn't show hand 
*** SUMMARY ***
Total pot 7968 | Rake 0 
Board [3d Td 5s Tc 2s]
Seat 1: official_dapic (button) folded before Flop (didn't bet)
Seat 2: gustavomrp491 (small blind) collected (7968)
Seat 3: pelelek (big blind) folded before Flop
Seat 4: Kevin12345Mc folded before Flop (didn't bet)
Seat 5: stacho10 folded before Flop (didn't bet)
Seat 6: EESTINOKIA folded on the River
Seat 7: Boks0 folded before Flop (didn't bet)
Seat 8: omutst folded before Flop (didn't bet)



PokerStars Hand #254671911416: Tournament #3852792524, $4.80+$5.00+$1.20 USD Hold'em No Limit - Level V (200/400) - 2025/02/02 17:16:39 WET [2025/02/02 12:16:39 ET]
Table '3852792524 145' 8-max Seat #2 is the button
Seat 1: official_dapic (53050 in chips, $5 bounty) 
Seat 2: gustavomrp491 (31392 in chips, $6.25 bounty) 
Seat 3: pelelek (15770 in chips, $5 bounty) 
Seat 4: Kevin12345Mc (25308 in chips, $7.50 bounty) 
Seat 5: stacho10 (41220 in chips, $7.50 bounty) 
Seat 6: EESTINOKIA (32434 in chips, $7.50 bounty) 
Seat 7: Boks0 (24950 in chips, $5 bounty) 
Seat 8: omutst (68781 in chips, $8.12 bounty) 
official_dapic: posts the ante 50
gustavomrp491: posts the ante 50
pelelek: posts the ante 50
Kevin12345Mc: posts the ante 50
stacho10: posts the ante 50
EESTINOKIA: posts the ante 50
Boks0: posts the ante 50
omutst: posts the ante 50
pelelek: posts small blind 200
Kevin12345Mc: posts big blind 400
*** HOLE CARDS ***
Dealt to Kevin12345Mc [7d Kd]
stacho10: folds 
EESTINOKIA: raises 800 to 1200
Boks0: folds 
omutst: raises 2400 to 3600
official_dapic: folds 
gustavomrp491: folds 
pelelek: folds 
Kevin12345Mc: folds 
EESTINOKIA: calls 2400
*** FLOP *** [8c 5h 2c]
EESTINOKIA: checks 
omutst: bets 2378
EESTINOKIA: raises 26406 to 28784 and is all-in
omutst: folds 
Uncalled bet (26406) returned to EESTINOKIA
EESTINOKIA collected 12956 from pot
EESTINOKIA: doesn't show hand 
*** SUMMARY ***
Total pot 12956 | Rake 0 
Board [8c 5h 2c]
Seat 1: official_dapic folded before Flop (didn't bet)
Seat 2: gustavomrp491 (button) folded before Flop (didn't bet)
Seat 3: pelelek (small blind) folded before Flop
Seat 4: Kevin12345Mc (big blind) folded before Flop
Seat 5: stacho10 folded before Flop (didn't bet)
Seat 6: EESTINOKIA collected (12956)
Seat 7: Boks0 folded before Flop (didn't bet)
Seat 8: omutst folded on the Flop



PokerStars Hand #254671930940: Tournament #3852792524, $4.80+$5.00+$1.20 USD Hold'em No Limit - Level V (200/400) - 2025/02/02 17:17:41 WET [2025/02/02 12:17:41 ET]
Table '3852792524 145' 8-max Seat #3 is the button
Seat 1: official_dapic (53000 in chips, $5 bounty) 
Seat 2: gustavomrp491 (31342 in chips, $6.25 bounty) 
Seat 3: pelelek (15520 in chips, $5 bounty) 
Seat 4: Kevin12345Mc (24858 in chips, $7.50 bounty) 
Seat 5: stacho10 (41170 in chips, $7.50 bounty) 
Seat 6: EESTINOKIA (39362 in chips, $7.50 bounty) 
Seat 7: Boks0 (24900 in chips, $5 bounty) 
Seat 8: omutst (62753 in chips, $8.12 bounty) 
official_dapic: posts the ante 50
gustavomrp491: posts the ante 50
pelelek: posts the ante 50
Kevin12345Mc: posts the ante 50
stacho10: posts the ante 50
EESTINOKIA: posts the ante 50
Boks0: posts the ante 50
omutst: posts the ante 50
Kevin12345Mc: posts small blind 200
stacho10: posts big blind 400
*** HOLE CARDS ***
Dealt to Kevin12345Mc [3h Jc]
EESTINOKIA: folds 
Boks0: folds 
omutst: folds 
official_dapic: raises 480 to 880
gustavomrp491: folds 
pelelek: folds 
Kevin12345Mc: folds 
stacho10: calls 480
*** FLOP *** [8d Qd Ad]
stacho10: checks 
official_dapic: bets 904
stacho10: calls 904
*** TURN *** [8d Qd Ad] [9c]
stacho10: checks 
official_dapic: bets 3200
stacho10: calls 3200
*** RIVER *** [8d Qd Ad 9c] [8h]
stacho10: checks 
official_dapic: bets 6600
stacho10: calls 6600
*** SHOW DOWN ***
official_dapic: shows [Ks 3s] (a pair of Eights)
stacho10: shows [2s 2d] (two pair, Eights and Deuces)
stacho10 collected 23768 from pot
*** SUMMARY ***
Total pot 23768 | Rake 0 
Board [8d Qd Ad 9c 8h]
Seat 1: official_dapic showed [Ks 3s] and lost with a pair of Eights
Seat 2: gustavomrp491 folded before Flop (didn't bet)
Seat 3: pelelek (button) folded before Flop (didn't bet)
Seat 4: Kevin12345Mc (small blind) folded before Flop
Seat 5: stacho10 (big blind) showed [2s 2d] and won (23768) with two pair, Eights and Deuces
Seat 6: EESTINOKIA folded before Flop (didn't bet)
Seat 7: Boks0 folded before Flop (didn't bet)
Seat 8: omutst folded before Flop (didn't bet)



PokerStars Hand #254671955312: Tournament #3852792524, $4.80+$5.00+$1.20 USD Hold'em No Limit - Level VI (250/500) - 2025/02/02 17:18:58 WET [2025/02/02 12:18:58 ET]
Table '3852792524 145' 8-max Seat #4 is the button
Seat 1: official_dapic (41366 in chips, $5 bounty) 
Seat 2: gustavomrp491 (31292 in chips, $6.25 bounty) 
Seat 3: pelelek (15470 in chips, $5 bounty) 
Seat 4: Kevin12345Mc (24608 in chips, $7.50 bounty) 
Seat 5: stacho10 (53304 in chips, $7.50 bounty) 
Seat 6: EESTINOKIA (39312 in chips, $7.50 bounty) 
Seat 7: Boks0 (24850 in chips, $5 bounty) 
Seat 8: omutst (62703 in chips, $8.12 bounty) 
official_dapic: posts the ante 60
gustavomrp491: posts the ante 60
pelelek: posts the ante 60
Kevin12345Mc: posts the ante 60
stacho10: posts the ante 60
EESTINOKIA: posts the ante 60
Boks0: posts the ante 60
omutst: posts the ante 60
stacho10: posts small blind 250
EESTINOKIA: posts big blind 500
*** HOLE CARDS ***
Dealt to Kevin12345Mc [3s 8h]
Boks0: folds 
omutst: calls 500
official_dapic: folds 
gustavomrp491: folds 
pelelek: folds 
Kevin12345Mc: folds 
stacho10: folds 
EESTINOKIA: checks 
*** FLOP *** [Qc 5s 7c]
EESTINOKIA: checks 
omutst: bets 500
EESTINOKIA: calls 500
*** TURN *** [Qc 5s 7c] [5d]
EESTINOKIA: checks 
omutst: checks 
*** RIVER *** [Qc 5s 7c 5d] [Tc]
EESTINOKIA: checks 
omutst: checks 
*** SHOW DOWN ***
EESTINOKIA: shows [8c 3h] (a pair of Fives)
omutst: shows [8s 7s] (two pair, Sevens and Fives)
omutst collected 2730 from pot
*** SUMMARY ***
Total pot 2730 | Rake 0 
Board [Qc 5s 7c 5d Tc]
Seat 1: official_dapic folded before Flop (didn't bet)
Seat 2: gustavomrp491 folded before Flop (didn't bet)
Seat 3: pelelek folded before Flop (didn't bet)
Seat 4: Kevin12345Mc (button) folded before Flop (didn't bet)
Seat 5: stacho10 (small blind) folded before Flop
Seat 6: EESTINOKIA (big blind) showed [8c 3h] and lost with a pair of Fives
Seat 7: Boks0 folded before Flop (didn't bet)
Seat 8: omutst showed [8s 7s] and won (2730) with two pair, Sevens and Fives



PokerStars Hand #254671968724: Tournament #3852792524, $4.80+$5.00+$1.20 USD Hold'em No Limit - Level VI (250/500) - 2025/02/02 17:19:40 WET [2025/02/02 12:19:40 ET]
Table '3852792524 145' 8-max Seat #5 is the button
Seat 1: official_dapic (41306 in chips, $5 bounty) 
Seat 2: gustavomrp491 (31232 in chips, $6.25 bounty) 
Seat 3: pelelek (15410 in chips, $5 bounty) 
Seat 4: Kevin12345Mc (24548 in chips, $7.50 bounty) 
Seat 5: stacho10 (52994 in chips, $7.50 bounty) 
Seat 6: EESTINOKIA (38252 in chips, $7.50 bounty) 
Seat 7: Boks0 (24790 in chips, $5 bounty) 
Seat 8: omutst (64373 in chips, $8.12 bounty) 
official_dapic: posts the ante 60
gustavomrp491: posts the ante 60
pelelek: posts the ante 60
Kevin12345Mc: posts the ante 60
stacho10: posts the ante 60
EESTINOKIA: posts the ante 60
Boks0: posts the ante 60
omutst: posts the ante 60
EESTINOKIA: posts small blind 250
Boks0: posts big blind 500
*** HOLE CARDS ***
Dealt to Kevin12345Mc [4d 8h]
omutst: folds 
official_dapic: folds 
gustavomrp491: folds 
pelelek: folds 
Kevin12345Mc: folds 
stacho10: calls 500
EESTINOKIA: raises 1980 to 2480
Boks0: folds 
stacho10: calls 1980
*** FLOP *** [4c Qc 2c]
EESTINOKIA: checks 
stacho10: bets 5940
EESTINOKIA: folds 
Uncalled bet (5940) returned to stacho10
stacho10 collected 5940 from pot
stacho10: doesn't show hand 
*** SUMMARY ***
Total pot 5940 | Rake 0 
Board [4c Qc 2c]
Seat 1: official_dapic folded before Flop (didn't bet)
Seat 2: gustavomrp491 folded before Flop (didn't bet)
Seat 3: pelelek folded before Flop (didn't bet)
Seat 4: Kevin12345Mc folded before Flop (didn't bet)
Seat 5: stacho10 (button) collected (5940)
Seat 6: EESTINOKIA (small blind) folded on the Flop
Seat 7: Boks0 (big blind) folded before Flop
Seat 8: omutst folded before Flop (didn't bet)



PokerStars Hand #254671981232: Tournament #3852792524, $4.80+$5.00+$1.20 USD Hold'em No Limit - Level VI (250/500) - 2025/02/02 17:20:20 WET [2025/02/02 12:20:20 ET]
Table '3852792524 145' 8-max Seat #6 is the button
Seat 1: official_dapic (41246 in chips, $5 bounty) 
Seat 2: gustavomrp491 (31172 in chips, $6.25 bounty) 
Seat 3: pelelek (15350 in chips, $5 bounty) 
Seat 4: Kevin12345Mc (24488 in chips, $7.50 bounty) 
Seat 5: stacho10 (56394 in chips, $7.50 bounty) 
Seat 6: EESTINOKIA (35712 in chips, $7.50 bounty) 
Seat 7: Boks0 (24230 in chips, $5 bounty) 
Seat 8: omutst (64313 in chips, $8.12 bounty) 
official_dapic: posts the ante 60
gustavomrp491: posts the ante 60
pelelek: posts the ante 60
Kevin12345Mc: posts the ante 60
stacho10: posts the ante 60
EESTINOKIA: posts the ante 60
Boks0: posts the ante 60
omutst: posts the ante 60
Boks0: posts small blind 250
omutst: posts big blind 500
*** HOLE CARDS ***
Dealt to Kevin12345Mc [7d Qh]
official_dapic: folds 
gustavomrp491: folds 
pelelek: folds 
Kevin12345Mc: folds 
stacho10: folds 
EESTINOKIA: calls 500
Boks0: calls 250
omutst: checks 
*** FLOP *** [5d 4d Qs]
Boks0: checks 
omutst: checks 
EESTINOKIA: checks 
*** TURN *** [5d 4d Qs] [3d]
Boks0: checks 
omutst: bets 500
EESTINOKIA: calls 500
Boks0: folds 
*** RIVER *** [5d 4d Qs 3d] [9h]
omutst: checks 
EESTINOKIA: checks 
*** SHOW DOWN ***
omutst: shows [5c Jc] (a pair of Fives)
EESTINOKIA: mucks hand 
omutst collected 2980 from pot
*** SUMMARY ***
Total pot 2980 | Rake 0 
Board [5d 4d Qs 3d 9h]
Seat 1: official_dapic folded before Flop (didn't bet)
Seat 2: gustavomrp491 folded before Flop (didn't bet)
Seat 3: pelelek folded before Flop (didn't bet)
Seat 4: Kevin12345Mc folded before Flop (didn't bet)
Seat 5: stacho10 folded before Flop (didn't bet)
Seat 6: EESTINOKIA (button) mucked [Ad 8s]
Seat 7: Boks0 (small blind) folded on the Turn
Seat 8: omutst (big blind) showed [5c Jc] and won (2980) with a pair of Fives



PokerStars Hand #254671997355: Tournament #3852792524, $4.80+$5.00+$1.20 USD Hold'em No Limit - Level VI (250/500) - 2025/02/02 17:21:11 WET [2025/02/02 12:21:11 ET]
Table '3852792524 145' 8-max Seat #7 is the button
Seat 1: official_dapic (41186 in chips, $5 bounty) 
Seat 2: gustavomrp491 (31112 in chips, $6.25 bounty) 
Seat 3: pelelek (15290 in chips, $5 bounty) 
Seat 4: Kevin12345Mc (24428 in chips, $7.50 bounty) 
Seat 5: stacho10 (56334 in chips, $7.50 bounty) 
Seat 6: EESTINOKIA (34652 in chips, $7.50 bounty) 
Seat 7: Boks0 (23670 in chips, $5 bounty) 
Seat 8: omutst (66233 in chips, $8.12 bounty) 
official_dapic: posts the ante 60
gustavomrp491: posts the ante 60
pelelek: posts the ante 60
Kevin12345Mc: posts the ante 60
stacho10: posts the ante 60
EESTINOKIA: posts the ante 60
Boks0: posts the ante 60
omutst: posts the ante 60
omutst: posts small blind 250
official_dapic: posts big blind 500
*** HOLE CARDS ***
Dealt to Kevin12345Mc [7h 6d]
gustavomrp491: folds 
pelelek: raises 600 to 1100
Kevin12345Mc: folds 
stacho10: folds 
EESTINOKIA: folds 
Boks0: calls 1100
omutst: folds 
official_dapic: calls 600
*** FLOP *** [9d 4c 3c]
official_dapic: checks 
pelelek: checks 
Boks0: bets 1330
official_dapic: calls 1330
pelelek: calls 1330
*** TURN *** [9d 4c 3c] [8h]
official_dapic: checks 
pelelek: checks 
Boks0: bets 4000
official_dapic: folds 
pelelek: folds 
Uncalled bet (4000) returned to Boks0
Boks0 collected 8020 from pot
Boks0: doesn't show hand 
*** SUMMARY ***
Total pot 8020 | Rake 0 
Board [9d 4c 3c 8h]
Seat 1: official_dapic (big blind) folded on the Turn
Seat 2: gustavomrp491 folded before Flop (didn't bet)
Seat 3: pelelek folded on the Turn
Seat 4: Kevin12345Mc folded before Flop (didn't bet)
Seat 5: stacho10 folded before Flop (didn't bet)
Seat 6: EESTINOKIA folded before Flop (didn't bet)
Seat 7: Boks0 (button) collected (8020)
Seat 8: omutst (small blind) folded before Flop



PokerStars Hand #254672019051: Tournament #3852792524, $4.80+$5.00+$1.20 USD Hold'em No Limit - Level VI (250/500) - 2025/02/02 17:22:21 WET [2025/02/02 12:22:21 ET]
Table '3852792524 145' 8-max Seat #8 is the button
Seat 1: official_dapic (38696 in chips, $5 bounty) 
Seat 2: gustavomrp491 (31052 in chips, $6.25 bounty) 
Seat 3: pelelek (12800 in chips, $5 bounty) 
Seat 4: Kevin12345Mc (24368 in chips, $7.50 bounty) 
Seat 5: stacho10 (56274 in chips, $7.50 bounty) 
Seat 6: EESTINOKIA (34592 in chips, $7.50 bounty) 
Seat 7: Boks0 (29200 in chips, $5 bounty) 
Seat 8: omutst (65923 in chips, $8.12 bounty) 
official_dapic: posts the ante 60
gustavomrp491: posts the ante 60
pelelek: posts the ante 60
Kevin12345Mc: posts the ante 60
stacho10: posts the ante 60
EESTINOKIA: posts the ante 60
Boks0: posts the ante 60
omutst: posts the ante 60
official_dapic: posts small blind 250
gustavomrp491: posts big blind 500
*** HOLE CARDS ***
Dealt to Kevin12345Mc [As Ts]
pelelek: folds 
Kevin12345Mc: raises 650 to 1150
stacho10: folds 
EESTINOKIA: folds 
Boks0: folds 
omutst: folds 
official_dapic: calls 900
gustavomrp491: calls 650
*** FLOP *** [Qh Jh 5d]
official_dapic: checks 
gustavomrp491: checks 
Kevin12345Mc: bets 1297
official_dapic: calls 1297
gustavomrp491: folds 
*** TURN *** [Qh Jh 5d] [3d]
official_dapic: checks 
Kevin12345Mc: checks 
*** RIVER *** [Qh Jh 5d 3d] [7h]
official_dapic: bets 5550
Kevin12345Mc: folds 
Uncalled bet (5550) returned to official_dapic
official_dapic collected 6524 from pot
official_dapic: doesn't show hand 
*** SUMMARY ***
Total pot 6524 | Rake 0 
Board [Qh Jh 5d 3d 7h]
Seat 1: official_dapic (small blind) collected (6524)
Seat 2: gustavomrp491 (big blind) folded on the Flop
Seat 3: pelelek folded before Flop (didn't bet)
Seat 4: Kevin12345Mc folded on the River
Seat 5: stacho10 folded before Flop (didn't bet)
Seat 6: EESTINOKIA folded before Flop (didn't bet)
Seat 7: Boks0 folded before Flop (didn't bet)
Seat 8: omutst (button) folded before Flop (didn't bet)



PokerStars Hand #254672044356: Tournament #3852792524, $4.80+$5.00+$1.20 USD Hold'em No Limit - Level VI (250/500) - 2025/02/02 17:23:40 WET [2025/02/02 12:23:40 ET]
Table '3852792524 145' 8-max Seat #1 is the button
Seat 1: official_dapic (42713 in chips, $5 bounty) 
Seat 2: gustavomrp491 (29842 in chips, $6.25 bounty) 
Seat 3: pelelek (12740 in chips, $5 bounty) 
Seat 4: Kevin12345Mc (21861 in chips, $7.50 bounty) 
Seat 5: stacho10 (56214 in chips, $7.50 bounty) 
Seat 6: EESTINOKIA (34532 in chips, $7.50 bounty) 
Seat 7: Boks0 (29140 in chips, $5 bounty) 
Seat 8: omutst (65863 in chips, $8.12 bounty) 
official_dapic: posts the ante 60
gustavomrp491: posts the ante 60
pelelek: posts the ante 60
Kevin12345Mc: posts the ante 60
stacho10: posts the ante 60
EESTINOKIA: posts the ante 60
Boks0: posts the ante 60
omutst: posts the ante 60
gustavomrp491: posts small blind 250
pelelek: posts big blind 500
*** HOLE CARDS ***
Dealt to Kevin12345Mc [Kd 6d]
Kevin12345Mc: folds 
stacho10: folds 
EESTINOKIA: folds 
Boks0: folds 
omutst: raises 500 to 1000
official_dapic: folds 
gustavomrp491: folds 
pelelek: calls 500
*** FLOP *** [Ts 2d 3c]
pelelek: checks 
omutst: bets 1147
pelelek: calls 1147
*** TURN *** [Ts 2d 3c] [6c]
pelelek: bets 3000
omutst: raises 60656 to 63656 and is all-in
pelelek: calls 7533 and is all-in
Uncalled bet (53123) returned to omutst
*** RIVER *** [Ts 2d 3c 6c] [Jc]
*** SHOW DOWN ***
pelelek: shows [Qc 2c] (a flush, Queen high)
omutst: shows [4s 4d] (a pair of Fours)
pelelek collected 26090 from pot
*** SUMMARY ***
Total pot 26090 | Rake 0 
Board [Ts 2d 3c 6c Jc]
Seat 1: official_dapic (button) folded before Flop (didn't bet)
Seat 2: gustavomrp491 (small blind) folded before Flop
Seat 3: pelelek (big blind) showed [Qc 2c] and won (26090) with a flush, Queen high
Seat 4: Kevin12345Mc folded before Flop (didn't bet)
Seat 5: stacho10 folded before Flop (didn't bet)
Seat 6: EESTINOKIA folded before Flop (didn't bet)
Seat 7: Boks0 folded before Flop (didn't bet)
Seat 8: omutst showed [4s 4d] and lost with a pair of Fours



PokerStars Hand #254672067358: Tournament #3852792524, $4.80+$5.00+$1.20 USD Hold'em No Limit - Level VI (250/500) - 2025/02/02 17:24:53 WET [2025/02/02 12:24:53 ET]
Table '3852792524 145' 8-max Seat #2 is the button
Seat 1: official_dapic (42653 in chips, $5 bounty) 
Seat 2: gustavomrp491 (29532 in chips, $6.25 bounty) 
Seat 3: pelelek (26090 in chips, $5 bounty) 
Seat 4: Kevin12345Mc (21801 in chips, $7.50 bounty) 
Seat 5: stacho10 (56154 in chips, $7.50 bounty) 
Seat 6: EESTINOKIA (34472 in chips, $7.50 bounty) 
Seat 7: Boks0 (29080 in chips, $5 bounty) 
Seat 8: omutst (53123 in chips, $8.12 bounty) 
official_dapic: posts the ante 60
gustavomrp491: posts the ante 60
pelelek: posts the ante 60
Kevin12345Mc: posts the ante 60
stacho10: posts the ante 60
EESTINOKIA: posts the ante 60
Boks0: posts the ante 60
omutst: posts the ante 60
pelelek: posts small blind 250
Kevin12345Mc: posts big blind 500
*** HOLE CARDS ***
Dealt to Kevin12345Mc [6s Ts]
stacho10: folds 
EESTINOKIA: calls 500
Boks0: folds 
omutst: calls 500
official_dapic: folds 
gustavomrp491: folds 
pelelek: folds 
Kevin12345Mc: checks 
*** FLOP *** [2d As 9s]
Kevin12345Mc: checks 
EESTINOKIA: checks 
omutst: checks 
*** TURN *** [2d As 9s] [3c]
Kevin12345Mc: checks 
EESTINOKIA: checks 
omutst: checks 
*** RIVER *** [2d As 9s 3c] [9h]
Kevin12345Mc: checks 
EESTINOKIA: checks 
omutst: bets 937
Kevin12345Mc: folds 
EESTINOKIA: folds 
Uncalled bet (937) returned to omutst
omutst collected 2230 from pot
omutst: doesn't show hand 
*** SUMMARY ***
Total pot 2230 | Rake 0 
Board [2d As 9s 3c 9h]
Seat 1: official_dapic folded before Flop (didn't bet)
Seat 2: gustavomrp491 (button) folded before Flop (didn't bet)
Seat 3: pelelek (small blind) folded before Flop
Seat 4: Kevin12345Mc (big blind) folded on the River
Seat 5: stacho10 folded before Flop (didn't bet)
Seat 6: EESTINOKIA folded on the River
Seat 7: Boks0 folded before Flop (didn't bet)
Seat 8: omutst collected (2230)



PokerStars Hand #254672091421: Tournament #3852792524, $4.80+$5.00+$1.20 USD Hold'em No Limit - Level VII (300/600) - 2025/02/02 17:26:09 WET [2025/02/02 12:26:09 ET]
Table '3852792524 145' 8-max Seat #3 is the button
Seat 1: official_dapic (42593 in chips, $5 bounty) 
Seat 2: gustavomrp491 (29472 in chips, $6.25 bounty) 
Seat 3: pelelek (25780 in chips, $5 bounty) 
Seat 4: Kevin12345Mc (21241 in chips, $7.50 bounty) 
Seat 5: stacho10 (56094 in chips, $7.50 bounty) 
Seat 6: EESTINOKIA (33912 in chips, $7.50 bounty) 
Seat 7: Boks0 (29020 in chips, $5 bounty) 
Seat 8: omutst (54793 in chips, $8.12 bounty) 
official_dapic: posts the ante 75
gustavomrp491: posts the ante 75
pelelek: posts the ante 75
Kevin12345Mc: posts the ante 75
stacho10: posts the ante 75
EESTINOKIA: posts the ante 75
Boks0: posts the ante 75
omutst: posts the ante 75
Kevin12345Mc: posts small blind 300
stacho10: posts big blind 600
*** HOLE CARDS ***
Dealt to Kevin12345Mc [2d 9c]
EESTINOKIA: raises 2100 to 2700
Boks0: folds 
omutst: folds 
official_dapic: folds 
gustavomrp491: folds 
pelelek: folds 
Kevin12345Mc: folds 
stacho10: calls 2100
*** FLOP *** [4h 8h Qc]
stacho10: checks 
EESTINOKIA: checks 
*** TURN *** [4h 8h Qc] [Qd]
stacho10: checks 
EESTINOKIA: checks 
*** RIVER *** [4h 8h Qc Qd] [Qs]
stacho10: checks 
EESTINOKIA: checks 
*** SHOW DOWN ***
stacho10: shows [Js As] (three of a kind, Queens)
EESTINOKIA: mucks hand 
stacho10 collected 6300 from pot
*** SUMMARY ***
Total pot 6300 | Rake 0 
Board [4h 8h Qc Qd Qs]
Seat 1: official_dapic folded before Flop (didn't bet)
Seat 2: gustavomrp491 folded before Flop (didn't bet)
Seat 3: pelelek (button) folded before Flop (didn't bet)
Seat 4: Kevin12345Mc (small blind) folded before Flop
Seat 5: stacho10 (big blind) showed [Js As] and won (6300) with three of a kind, Queens
Seat 6: EESTINOKIA mucked [Ac Td]
Seat 7: Boks0 folded before Flop (didn't bet)
Seat 8: omutst folded before Flop (didn't bet)



PokerStars Hand #254672103342: Tournament #3852792524, $4.80+$5.00+$1.20 USD Hold'em No Limit - Level VII (300/600) - 2025/02/02 17:26:47 WET [2025/02/02 12:26:47 ET]
Table '3852792524 145' 8-max Seat #4 is the button
Seat 1: official_dapic (42518 in chips, $5 bounty) 
Seat 2: gustavomrp491 (29397 in chips, $6.25 bounty) 
Seat 3: pelelek (25705 in chips, $5 bounty) 
Seat 4: Kevin12345Mc (20866 in chips, $7.50 bounty) 
Seat 5: stacho10 (59619 in chips, $7.50 bounty) 
Seat 6: EESTINOKIA (31137 in chips, $7.50 bounty) 
Seat 7: Boks0 (28945 in chips, $5 bounty) 
Seat 8: omutst (54718 in chips, $8.12 bounty) 
official_dapic: posts the ante 75
gustavomrp491: posts the ante 75
pelelek: posts the ante 75
Kevin12345Mc: posts the ante 75
stacho10: posts the ante 75
EESTINOKIA: posts the ante 75
Boks0: posts the ante 75
omutst: posts the ante 75
stacho10: posts small blind 300
EESTINOKIA: posts big blind 600
*** HOLE CARDS ***
Dealt to Kevin12345Mc [9h Ac]
Boks0: folds 
omutst: folds 
official_dapic: raises 720 to 1320
gustavomrp491: folds 
pelelek: folds 
Kevin12345Mc: folds 
stacho10: folds 
EESTINOKIA: calls 720
*** FLOP *** [7h 2h Js]
EESTINOKIA: checks 
official_dapic: bets 1416
EESTINOKIA: folds 
Uncalled bet (1416) returned to official_dapic
official_dapic collected 3540 from pot
official_dapic: doesn't show hand 
*** SUMMARY ***
Total pot 3540 | Rake 0 
Board [7h 2h Js]
Seat 1: official_dapic collected (3540)
Seat 2: gustavomrp491 folded before Flop (didn't bet)
Seat 3: pelelek folded before Flop (didn't bet)
Seat 4: Kevin12345Mc (button) folded before Flop (didn't bet)
Seat 5: stacho10 (small blind) folded before Flop
Seat 6: EESTINOKIA (big blind) folded on the Flop
Seat 7: Boks0 folded before Flop (didn't bet)
Seat 8: omutst folded before Flop (didn't bet)



PokerStars Hand #254672113653: Tournament #3852792524, $4.80+$5.00+$1.20 USD Hold'em No Limit - Level VII (300/600) - 2025/02/02 17:27:19 WET [2025/02/02 12:27:19 ET]
Table '3852792524 145' 8-max Seat #5 is the button
Seat 1: official_dapic (44663 in chips, $5 bounty) 
Seat 2: gustavomrp491 (29322 in chips, $6.25 bounty) 
Seat 3: pelelek (25630 in chips, $5 bounty) 
Seat 4: Kevin12345Mc (20791 in chips, $7.50 bounty) 
Seat 5: stacho10 (59244 in chips, $7.50 bounty) 
Seat 6: EESTINOKIA (29742 in chips, $7.50 bounty) 
Seat 7: Boks0 (28870 in chips, $5 bounty) 
Seat 8: omutst (54643 in chips, $8.12 bounty) 
official_dapic: posts the ante 75
gustavomrp491: posts the ante 75
pelelek: posts the ante 75
Kevin12345Mc: posts the ante 75
stacho10: posts the ante 75
EESTINOKIA: posts the ante 75
Boks0: posts the ante 75
omutst: posts the ante 75
EESTINOKIA: posts small blind 300
Boks0: posts big blind 600
*** HOLE CARDS ***
Dealt to Kevin12345Mc [Td Kd]
omutst: raises 600 to 1200
official_dapic: folds 
gustavomrp491: folds 
pelelek: calls 1200
Kevin12345Mc: calls 1200
stacho10: folds 
EESTINOKIA: calls 900
Boks0: calls 600
*** FLOP *** [3h Qc Ad]
EESTINOKIA: bets 6600
Boks0: folds 
omutst: folds 
pelelek: folds 
Kevin12345Mc: folds 
Uncalled bet (6600) returned to EESTINOKIA
EESTINOKIA collected 6600 from pot
EESTINOKIA: doesn't show hand 
*** SUMMARY ***
Total pot 6600 | Rake 0 
Board [3h Qc Ad]
Seat 1: official_dapic folded before Flop (didn't bet)
Seat 2: gustavomrp491 folded before Flop (didn't bet)
Seat 3: pelelek folded on the Flop
Seat 4: Kevin12345Mc folded on the Flop
Seat 5: stacho10 (button) folded before Flop (didn't bet)
Seat 6: EESTINOKIA (small blind) collected (6600)
Seat 7: Boks0 (big blind) folded on the Flop
Seat 8: omutst folded on the Flop



PokerStars Hand #254672132607: Tournament #3852792524, $4.80+$5.00+$1.20 USD Hold'em No Limit - Level VII (300/600) - 2025/02/02 17:28:20 WET [2025/02/02 12:28:20 ET]
Table '3852792524 145' 8-max Seat #6 is the button
Seat 1: official_dapic (44588 in chips, $5 bounty) 
Seat 2: gustavomrp491 (29247 in chips, $6.25 bounty) 
Seat 3: pelelek (24355 in chips, $5 bounty) 
Seat 4: Kevin12345Mc (19516 in chips, $7.50 bounty) 
Seat 5: stacho10 (59169 in chips, $7.50 bounty) 
Seat 6: EESTINOKIA (35067 in chips, $7.50 bounty) 
Seat 7: Boks0 (27595 in chips, $5 bounty) 
Seat 8: omutst (53368 in chips, $8.12 bounty) 
official_dapic: posts the ante 75
gustavomrp491: posts the ante 75
pelelek: posts the ante 75
Kevin12345Mc: posts the ante 75
stacho10: posts the ante 75
EESTINOKIA: posts the ante 75
Boks0: posts the ante 75
omutst: posts the ante 75
Boks0: posts small blind 300
omutst: posts big blind 600
*** HOLE CARDS ***
Dealt to Kevin12345Mc [4c Kh]
official_dapic: folds 
gustavomrp491: folds 
pelelek: raises 720 to 1320
Kevin12345Mc: folds 
stacho10: folds 
EESTINOKIA: calls 1320
Boks0: folds 
omutst: folds 
*** FLOP *** [6c 2d Jd]
pelelek: checks 
EESTINOKIA: checks 
*** TURN *** [6c 2d Jd] [9c]
pelelek: bets 3600
EESTINOKIA: folds 
Uncalled bet (3600) returned to pelelek
pelelek collected 4140 from pot
pelelek: doesn't show hand 
*** SUMMARY ***
Total pot 4140 | Rake 0 
Board [6c 2d Jd 9c]
Seat 1: official_dapic folded before Flop (didn't bet)
Seat 2: gustavomrp491 folded before Flop (didn't bet)
Seat 3: pelelek collected (4140)
Seat 4: Kevin12345Mc folded before Flop (didn't bet)
Seat 5: stacho10 folded before Flop (didn't bet)
Seat 6: EESTINOKIA (button) folded on the Turn
Seat 7: Boks0 (small blind) folded before Flop
Seat 8: omutst (big blind) folded before Flop



PokerStars Hand #254672144977: Tournament #3852792524, $4.80+$5.00+$1.20 USD Hold'em No Limit - Level VII (300/600) - 2025/02/02 17:28:59 WET [2025/02/02 12:28:59 ET]
Table '3852792524 145' 8-max Seat #7 is the button
Seat 1: official_dapic (44513 in chips, $5 bounty) 
Seat 2: gustavomrp491 (29172 in chips, $6.25 bounty) 
Seat 3: pelelek (27100 in chips, $5 bounty) 
Seat 4: Kevin12345Mc (19441 in chips, $7.50 bounty) 
Seat 5: stacho10 (59094 in chips, $7.50 bounty) 
Seat 6: EESTINOKIA (33672 in chips, $7.50 bounty) 
Seat 7: Boks0 (27220 in chips, $5 bounty) 
Seat 8: omutst (52693 in chips, $8.12 bounty) 
official_dapic: posts the ante 75
gustavomrp491: posts the ante 75
pelelek: posts the ante 75
Kevin12345Mc: posts the ante 75
stacho10: posts the ante 75
EESTINOKIA: posts the ante 75
Boks0: posts the ante 75
omutst: posts the ante 75
omutst: posts small blind 300
official_dapic: posts big blind 600
*** HOLE CARDS ***
Dealt to Kevin12345Mc [Tc 7h]
gustavomrp491: folds 
pelelek: folds 
Kevin12345Mc: folds 
stacho10: calls 600
EESTINOKIA: folds 
Boks0: raises 1200 to 1800
omutst: calls 1500
official_dapic: folds 
stacho10: calls 1200
*** FLOP *** [3d Jc Ad]
omutst: checks 
stacho10: checks 
Boks0: checks 
*** TURN *** [3d Jc Ad] [9c]
omutst: bets 1914
stacho10: calls 1914
Boks0: calls 1914
*** RIVER *** [3d Jc Ad 9c] [3c]
omutst: checks 
stacho10: checks 
Boks0: checks 
*** SHOW DOWN ***
omutst: shows [8c Ac] (a flush, Ace high)
stacho10: mucks hand 
Boks0: mucks hand 
omutst collected 12342 from pot
*** SUMMARY ***
Total pot 12342 | Rake 0 
Board [3d Jc Ad 9c 3c]
Seat 1: official_dapic (big blind) folded before Flop
Seat 2: gustavomrp491 folded before Flop (didn't bet)
Seat 3: pelelek folded before Flop (didn't bet)
Seat 4: Kevin12345Mc folded before Flop (didn't bet)
Seat 5: stacho10 mucked [Qc Td]
Seat 6: EESTINOKIA folded before Flop (didn't bet)
Seat 7: Boks0 (button) mucked [Qs Qd]
Seat 8: omutst (small blind) showed [8c Ac] and won (12342) with a flush, Ace high



PokerStars Hand #254672679194: Tournament #3852792524, $4.80+$5.00+$1.20 USD Hold'em No Limit - Level VII (300/600) - 2025/02/02 17:30:46 WET [2025/02/02 12:30:46 ET]
Table '3852792524 145' 8-max Seat #8 is the button
Seat 1: official_dapic (43838 in chips, $5 bounty) 
Seat 2: gustavomrp491 (29097 in chips, $6.25 bounty) 
Seat 3: pelelek (27025 in chips, $5 bounty) 
Seat 4: Kevin12345Mc (19366 in chips, $7.50 bounty) 
Seat 5: stacho10 (55305 in chips, $7.50 bounty) 
Seat 6: EESTINOKIA (33597 in chips, $7.50 bounty) 
Seat 7: Boks0 (23431 in chips, $5 bounty) 
Seat 8: omutst (61246 in chips, $8.12 bounty) 
official_dapic: posts the ante 75
gustavomrp491: posts the ante 75
pelelek: posts the ante 75
Kevin12345Mc: posts the ante 75
stacho10: posts the ante 75
EESTINOKIA: posts the ante 75
Boks0: posts the ante 75
omutst: posts the ante 75
official_dapic: posts small blind 300
gustavomrp491: posts big blind 600
*** HOLE CARDS ***
Dealt to Kevin12345Mc [5s 7s]
pelelek: folds 
Kevin12345Mc: folds 
stacho10: folds 
EESTINOKIA: calls 600
Boks0: raises 1200 to 1800
omutst: raises 5700 to 7500
official_dapic: folds 
gustavomrp491: folds 
EESTINOKIA: calls 6900
Boks0: folds 
*** FLOP *** [Ts 6c 9d]
EESTINOKIA: checks 
omutst: bets 53671 and is all-in
EESTINOKIA: calls 26022 and is all-in
Uncalled bet (27649) returned to omutst
*** TURN *** [Ts 6c 9d] [8d]
*** RIVER *** [Ts 6c 9d 8d] [9s]
*** SHOW DOWN ***
EESTINOKIA: shows [6h Kh] (two pair, Nines and Sixes)
omutst: shows [Ac Ks] (a pair of Nines)
EESTINOKIA collected 70344 from pot
*** SUMMARY ***
Total pot 70344 | Rake 0 
Board [Ts 6c 9d 8d 9s]
Seat 1: official_dapic (small blind) folded before Flop
Seat 2: gustavomrp491 (big blind) folded before Flop
Seat 3: pelelek folded before Flop (didn't bet)
Seat 4: Kevin12345Mc folded before Flop (didn't bet)
Seat 5: stacho10 folded before Flop (didn't bet)
Seat 6: EESTINOKIA showed [6h Kh] and won (70344) with two pair, Nines and Sixes
Seat 7: Boks0 folded before Flop
Seat 8: omutst (button) showed [Ac Ks] and lost with a pair of Nines



PokerStars Hand #254672699459: Tournament #3852792524, $4.80+$5.00+$1.20 USD Hold'em No Limit - Level VII (300/600) - 2025/02/02 17:31:50 WET [2025/02/02 12:31:50 ET]
Table '3852792524 145' 8-max Seat #1 is the button
Seat 1: official_dapic (43463 in chips, $5 bounty) 
Seat 2: gustavomrp491 (28422 in chips, $6.25 bounty) 
Seat 3: pelelek (26950 in chips, $5 bounty) 
Seat 4: Kevin12345Mc (19291 in chips, $7.50 bounty) 
Seat 5: stacho10 (55230 in chips, $7.50 bounty) 
Seat 6: EESTINOKIA (70344 in chips, $7.50 bounty) 
Seat 7: Boks0 (21556 in chips, $5 bounty) 
Seat 8: omutst (27649 in chips, $8.12 bounty) 
official_dapic: posts the ante 75
gustavomrp491: posts the ante 75
pelelek: posts the ante 75
Kevin12345Mc: posts the ante 75
stacho10: posts the ante 75
EESTINOKIA: posts the ante 75
Boks0: posts the ante 75
omutst: posts the ante 75
gustavomrp491: posts small blind 300
pelelek: posts big blind 600
*** HOLE CARDS ***
Dealt to Kevin12345Mc [Jh Js]
Kevin12345Mc: raises 720 to 1320
stacho10: folds 
EESTINOKIA: calls 1320
Boks0: folds 
omutst: calls 1320
official_dapic: folds 
gustavomrp491: raises 27027 to 28347 and is all-in
pelelek: folds 
Kevin12345Mc: calls 17896 and is all-in
EESTINOKIA: folds 
omutst: folds 
Uncalled bet (9131) returned to gustavomrp491
*** FLOP *** [3h 4d Tc]
*** TURN *** [3h 4d Tc] [Qd]
*** RIVER *** [3h 4d Tc Qd] [4s]
*** SHOW DOWN ***
gustavomrp491: shows [Ks Ah] (a pair of Fours)
Kevin12345Mc: shows [Jh Js] (two pair, Jacks and Fours)
Kevin12345Mc collected 42272 from pot
*** SUMMARY ***
Total pot 42272 | Rake 0 
Board [3h 4d Tc Qd 4s]
Seat 1: official_dapic (button) folded before Flop (didn't bet)
Seat 2: gustavomrp491 (small blind) showed [Ks Ah] and lost with a pair of Fours
Seat 3: pelelek (big blind) folded before Flop
Seat 4: Kevin12345Mc showed [Jh Js] and won (42272) with two pair, Jacks and Fours
Seat 5: stacho10 folded before Flop (didn't bet)
Seat 6: EESTINOKIA folded before Flop
Seat 7: Boks0 folded before Flop (didn't bet)
Seat 8: omutst folded before Flop



PokerStars Hand #254672718312: Tournament #3852792524, $4.80+$5.00+$1.20 USD Hold'em No Limit - Level VII (300/600) - 2025/02/02 17:32:49 WET [2025/02/02 12:32:49 ET]
Table '3852792524 145' 8-max Seat #2 is the button
Seat 1: official_dapic (43388 in chips, $5 bounty) 
Seat 2: gustavomrp491 (9131 in chips, $6.25 bounty) 
Seat 3: pelelek (26275 in chips, $5 bounty) 
Seat 4: Kevin12345Mc (42272 in chips, $7.50 bounty) 
Seat 5: stacho10 (55155 in chips, $7.50 bounty) 
Seat 6: EESTINOKIA (68949 in chips, $7.50 bounty) 
Seat 7: Boks0 (21481 in chips, $5 bounty) 
Seat 8: omutst (26254 in chips, $8.12 bounty) 
official_dapic: posts the ante 75
gustavomrp491: posts the ante 75
pelelek: posts the ante 75
Kevin12345Mc: posts the ante 75
stacho10: posts the ante 75
EESTINOKIA: posts the ante 75
Boks0: posts the ante 75
omutst: posts the ante 75
pelelek: posts small blind 300
Kevin12345Mc: posts big blind 600
*** HOLE CARDS ***
Dealt to Kevin12345Mc [8h 4h]
stacho10: folds 
EESTINOKIA: calls 600
Boks0: folds 
omutst: folds 
official_dapic: folds 
gustavomrp491: folds 
pelelek: folds 
Kevin12345Mc: checks 
*** FLOP *** [2c 7d 4d]
Kevin12345Mc: checks 
EESTINOKIA: checks 
*** TURN *** [2c 7d 4d] [2s]
Kevin12345Mc: bets 1386
EESTINOKIA: folds 
Uncalled bet (1386) returned to Kevin12345Mc
Kevin12345Mc collected 2100 from pot
Kevin12345Mc: doesn't show hand 
*** SUMMARY ***
Total pot 2100 | Rake 0 
Board [2c 7d 4d 2s]
Seat 1: official_dapic folded before Flop (didn't bet)
Seat 2: gustavomrp491 (button) folded before Flop (didn't bet)
Seat 3: pelelek (small blind) folded before Flop
Seat 4: Kevin12345Mc (big blind) collected (2100)
Seat 5: stacho10 folded before Flop (didn't bet)
Seat 6: EESTINOKIA folded on the Turn
Seat 7: Boks0 folded before Flop (didn't bet)
Seat 8: omutst folded before Flop (didn't bet)



PokerStars Hand #254672733099: Tournament #3852792524, $4.80+$5.00+$1.20 USD Hold'em No Limit - Level VII (300/600) - 2025/02/02 17:33:34 WET [2025/02/02 12:33:34 ET]
Table '3852792524 145' 8-max Seat #3 is the button
Seat 1: official_dapic (43313 in chips, $5 bounty) 
Seat 2: gustavomrp491 (9056 in chips, $6.25 bounty) 
Seat 3: pelelek (25900 in chips, $5 bounty) 
Seat 4: Kevin12345Mc (43697 in chips, $7.50 bounty) 
Seat 5: stacho10 (55080 in chips, $7.50 bounty) 
Seat 6: EESTINOKIA (68274 in chips, $7.50 bounty) 
Seat 7: Boks0 (21406 in chips, $5 bounty) 
Seat 8: omutst (26179 in chips, $8.12 bounty) 
official_dapic: posts the ante 75
gustavomrp491: posts the ante 75
pelelek: posts the ante 75
Kevin12345Mc: posts the ante 75
stacho10: posts the ante 75
EESTINOKIA: posts the ante 75
Boks0: posts the ante 75
omutst: posts the ante 75
Kevin12345Mc: posts small blind 300
stacho10: posts big blind 600
*** HOLE CARDS ***
Dealt to Kevin12345Mc [4d Th]
EESTINOKIA: calls 600
Boks0: folds 
omutst: folds 
official_dapic: raises 900 to 1500
gustavomrp491: folds 
pelelek: raises 2100 to 3600
Kevin12345Mc: folds 
stacho10: calls 3000
EESTINOKIA: calls 3000
official_dapic: raises 39638 to 43238 and is all-in
pelelek: calls 22225 and is all-in
stacho10: calls 39638
EESTINOKIA: folds 
*** FLOP *** [2c 5d Qd]
*** TURN *** [2c 5d Qd] [7d]
*** RIVER *** [2c 5d Qd 7d] [Kc]
*** SHOW DOWN ***
stacho10: shows [9s 9d] (a pair of Nines)
official_dapic: shows [Ac Tc] (high card Ace)
stacho10 collected 34826 from side pot
pelelek: shows [Ks Ah] (a pair of Kings)
pelelek collected 81975 from main pot
stacho10 wins $2.50 for eliminating official_dapic and their own bounty increases by $2.50 to $10
official_dapic finished the tournament
pedropkr100 is disconnected 
*** SUMMARY ***
Total pot 116801 Main pot 81975. Side pot 34826. | Rake 0 
Board [2c 5d Qd 7d Kc]
Seat 1: official_dapic showed [Ac Tc] and lost with high card Ace
Seat 2: gustavomrp491 folded before Flop (didn't bet)
Seat 3: pelelek (button) showed [Ks Ah] and won (81975) with a pair of Kings
Seat 4: Kevin12345Mc (small blind) folded before Flop
Seat 5: stacho10 (big blind) showed [9s 9d] and won (34826) with a pair of Nines
Seat 6: EESTINOKIA folded before Flop
Seat 7: Boks0 folded before Flop (didn't bet)
Seat 8: omutst folded before Flop (didn't bet)



PokerStars Hand #254672758850: Tournament #3852792524, $4.80+$5.00+$1.20 USD Hold'em No Limit - Level VIII (350/700) - 2025/02/02 17:34:54 WET [2025/02/02 12:34:54 ET]
Table '3852792524 145' 8-max Seat #4 is the button
Seat 1: pedropkr100 (25000 in chips, $5 bounty) 
Seat 2: gustavomrp491 (8981 in chips, $6.25 bounty) 
Seat 3: pelelek (81975 in chips, $5 bounty) 
Seat 4: Kevin12345Mc (43322 in chips, $7.50 bounty) 
Seat 5: stacho10 (46593 in chips, $10 bounty) 
Seat 6: EESTINOKIA (64599 in chips, $7.50 bounty) 
Seat 7: Boks0 (21331 in chips, $5 bounty) 
Seat 8: omutst (26104 in chips, $8.12 bounty) 
pedropkr100: posts the ante 90
gustavomrp491: posts the ante 90
pelelek: posts the ante 90
Kevin12345Mc: posts the ante 90
stacho10: posts the ante 90
EESTINOKIA: posts the ante 90
Boks0: posts the ante 90
omutst: posts the ante 90
stacho10: posts small blind 350
EESTINOKIA: posts big blind 700
*** HOLE CARDS ***
Dealt to Kevin12345Mc [9d Ks]
Boks0: folds 
omutst: folds 
pedropkr100: folds 
gustavomrp491: folds 
pelelek: folds 
Kevin12345Mc: raises 910 to 1610
stacho10: calls 1260
EESTINOKIA: calls 910
*** FLOP *** [3c 7c Kd]
stacho10: checks 
EESTINOKIA: checks 
Kevin12345Mc: bets 1832
stacho10: calls 1832
EESTINOKIA: calls 1832
*** TURN *** [3c 7c Kd] [6d]
stacho10: checks 
EESTINOKIA: checks 
Kevin12345Mc: bets 7990
stacho10: calls 7990
EESTINOKIA: folds 
*** RIVER *** [3c 7c Kd 6d] [2c]
stacho10: bets 35071 and is all-in
Kevin12345Mc: folds 
Uncalled bet (35071) returned to stacho10
stacho10 collected 27026 from pot
stacho10: doesn't show hand 
*** SUMMARY ***
Total pot 27026 | Rake 0 
Board [3c 7c Kd 6d 2c]
Seat 1: pedropkr100 folded before Flop (didn't bet)
Seat 2: gustavomrp491 folded before Flop (didn't bet)
Seat 3: pelelek folded before Flop (didn't bet)
Seat 4: Kevin12345Mc (button) folded on the River
Seat 5: stacho10 (small blind) collected (27026)
Seat 6: EESTINOKIA (big blind) folded on the Turn
Seat 7: Boks0 folded before Flop (didn't bet)
Seat 8: omutst folded before Flop (didn't bet)



PokerStars Hand #254672781381: Tournament #3852792524, $4.80+$5.00+$1.20 USD Hold'em No Limit - Level VIII (350/700) - 2025/02/02 17:36:03 WET [2025/02/02 12:36:03 ET]
Table '3852792524 145' 8-max Seat #5 is the button
Seat 1: pedropkr100 (24910 in chips, $5 bounty) 
Seat 2: gustavomrp491 (8891 in chips, $6.25 bounty) 
Seat 3: pelelek (81885 in chips, $5 bounty) 
Seat 4: Kevin12345Mc (31800 in chips, $7.50 bounty) 
Seat 5: stacho10 (62097 in chips, $10 bounty) 
Seat 6: EESTINOKIA (61067 in chips, $7.50 bounty) 
Seat 7: Boks0 (21241 in chips, $5 bounty) 
Seat 8: omutst (26014 in chips, $8.12 bounty) 
pedropkr100: posts the ante 90
gustavomrp491: posts the ante 90
pelelek: posts the ante 90
Kevin12345Mc: posts the ante 90
stacho10: posts the ante 90
EESTINOKIA: posts the ante 90
Boks0: posts the ante 90
omutst: posts the ante 90
EESTINOKIA: posts small blind 350
Boks0: posts big blind 700
*** HOLE CARDS ***
Dealt to Kevin12345Mc [8d Jd]
omutst: folds 
pedropkr100: folds 
gustavomrp491: folds 
pelelek: raises 840 to 1540
Kevin12345Mc: folds 
stacho10: calls 1540
EESTINOKIA: folds 
Boks0: folds 
*** FLOP *** [5d 3c Kh]
pelelek: bets 2800
stacho10: raises 7000 to 9800
pelelek: raises 11900 to 21700
stacho10: raises 38767 to 60467 and is all-in
pelelek: calls 38767
*** TURN *** [5d 3c Kh] [2d]
*** RIVER *** [5d 3c Kh 2d] [3s]
*** SHOW DOWN ***
pelelek: shows [Kc 5c] (two pair, Kings and Fives)
stacho10: shows [Kd Qc] (two pair, Kings and Threes)
pelelek collected 125784 from pot
pelelek wins $5 for eliminating stacho10 and their own bounty increases by $5 to $10
stacho10 finished the tournament
*** SUMMARY ***
Total pot 125784 | Rake 0 
Board [5d 3c Kh 2d 3s]
Seat 1: pedropkr100 folded before Flop (didn't bet)
Seat 2: gustavomrp491 folded before Flop (didn't bet)
Seat 3: pelelek showed [Kc 5c] and won (125784) with two pair, Kings and Fives
Seat 4: Kevin12345Mc folded before Flop (didn't bet)
Seat 5: stacho10 (button) showed [Kd Qc] and lost with two pair, Kings and Threes
Seat 6: EESTINOKIA (small blind) folded before Flop
Seat 7: Boks0 (big blind) folded before Flop
Seat 8: omutst folded before Flop (didn't bet)



PokerStars Hand #254672803578: Tournament #3852792524, $4.80+$5.00+$1.20 USD Hold'em No Limit - Level VIII (350/700) - 2025/02/02 17:37:13 WET [2025/02/02 12:37:13 ET]
Table '3852792524 145' 8-max Seat #6 is the button
Seat 1: pedropkr100 (24820 in chips, $5 bounty) 
Seat 2: gustavomrp491 (8801 in chips, $6.25 bounty) 
Seat 3: pelelek (145572 in chips, $10 bounty) 
Seat 4: Kevin12345Mc (31710 in chips, $7.50 bounty) 
Seat 6: EESTINOKIA (60627 in chips, $7.50 bounty) 
Seat 7: Boks0 (20451 in chips, $5 bounty) 
Seat 8: omutst (25924 in chips, $8.12 bounty) 
pedropkr100: posts the ante 90
gustavomrp491: posts the ante 90
pelelek: posts the ante 90
Kevin12345Mc: posts the ante 90
EESTINOKIA: posts the ante 90
Boks0: posts the ante 90
omutst: posts the ante 90
Boks0: posts small blind 350
omutst: posts big blind 700
*** HOLE CARDS ***
Dealt to Kevin12345Mc [Qs 4c]
looserGirl27 is disconnected 
pedropkr100: folds 
gustavomrp491: folds 
pelelek: folds 
Kevin12345Mc: folds 
EESTINOKIA: folds 
Boks0: raises 1400 to 2100
omutst: raises 23734 to 25834 and is all-in
Boks0: calls 18261 and is all-in
Uncalled bet (5473) returned to omutst
*** FLOP *** [Kc 5d Jc]
*** TURN *** [Kc 5d Jc] [4h]
*** RIVER *** [Kc 5d Jc 4h] [Jh]
*** SHOW DOWN ***
Boks0: shows [Tc Qc] (a pair of Jacks)
omutst: shows [3c 3s] (two pair, Jacks and Threes)
omutst collected 41352 from pot
omutst wins $2.50 for eliminating Boks0 and their own bounty increases by $2.50 to $10.62
Boks0 finished the tournament
*** SUMMARY ***
Total pot 41352 | Rake 0 
Board [Kc 5d Jc 4h Jh]
Seat 1: pedropkr100 folded before Flop (didn't bet)
Seat 2: gustavomrp491 folded before Flop (didn't bet)
Seat 3: pelelek folded before Flop (didn't bet)
Seat 4: Kevin12345Mc folded before Flop (didn't bet)
Seat 6: EESTINOKIA (button) folded before Flop (didn't bet)
Seat 7: Boks0 (small blind) showed [Tc Qc] and lost with a pair of Jacks
Seat 8: omutst (big blind) showed [3c 3s] and won (41352) with two pair, Jacks and Threes



PokerStars Hand #254672821458: Tournament #3852792524, $4.80+$5.00+$1.20 USD Hold'em No Limit - Level VIII (350/700) - 2025/02/02 17:38:09 WET [2025/02/02 12:38:09 ET]
Table '3852792524 145' 8-max Seat #8 is the button
Seat 1: pedropkr100 (24730 in chips, $5 bounty) 
Seat 2: gustavomrp491 (8711 in chips, $6.25 bounty) 
Seat 3: pelelek (145482 in chips, $10 bounty) 
Seat 4: Kevin12345Mc (31620 in chips, $7.50 bounty) 
Seat 5: looserGirl27 (25000 in chips, $5 bounty) 
Seat 6: EESTINOKIA (60537 in chips, $7.50 bounty) 
Seat 8: omutst (46825 in chips, $10.62 bounty) 
pedropkr100: posts the ante 90
gustavomrp491: posts the ante 90
pelelek: posts the ante 90
Kevin12345Mc: posts the ante 90
looserGirl27: posts the ante 90
EESTINOKIA: posts the ante 90
omutst: posts the ante 90
pedropkr100: posts small blind 350
gustavomrp491: posts big blind 700
*** HOLE CARDS ***
Dealt to Kevin12345Mc [5d 8d]
pelelek: folds 
WalkerDCFC is disconnected 
Kevin12345Mc: folds 
looserGirl27: folds 
EESTINOKIA: folds 
omutst: raises 700 to 1400
pedropkr100: folds 
gustavomrp491: calls 700
*** FLOP *** [2s Qs 2h]
gustavomrp491: checks 
omutst: bets 1096
gustavomrp491: folds 
Uncalled bet (1096) returned to omutst
omutst collected 3780 from pot
omutst: doesn't show hand 
*** SUMMARY ***
Total pot 3780 | Rake 0 
Board [2s Qs 2h]
Seat 1: pedropkr100 (small blind) folded before Flop
Seat 2: gustavomrp491 (big blind) folded on the Flop
Seat 3: pelelek folded before Flop (didn't bet)
Seat 4: Kevin12345Mc folded before Flop (didn't bet)
Seat 5: looserGirl27 folded before Flop (didn't bet)
Seat 6: EESTINOKIA folded before Flop (didn't bet)
Seat 8: omutst (button) collected (3780)



PokerStars Hand #254672834648: Tournament #3852792524, $4.80+$5.00+$1.20 USD Hold'em No Limit - Level VIII (350/700) - 2025/02/02 17:38:50 WET [2025/02/02 12:38:50 ET]
Table '3852792524 145' 8-max Seat #1 is the button
Seat 1: pedropkr100 (24290 in chips, $5 bounty) 
Seat 2: gustavomrp491 (7221 in chips, $6.25 bounty) 
Seat 3: pelelek (145392 in chips, $10 bounty) 
Seat 4: Kevin12345Mc (31530 in chips, $7.50 bounty) 
Seat 5: looserGirl27 (24910 in chips, $5 bounty) 
Seat 6: EESTINOKIA (60447 in chips, $7.50 bounty) 
Seat 7: WalkerDCFC (83644 in chips, $10 bounty) 
Seat 8: omutst (49115 in chips, $10.62 bounty) 
pedropkr100: posts the ante 90
gustavomrp491: posts the ante 90
pelelek: posts the ante 90
Kevin12345Mc: posts the ante 90
looserGirl27: posts the ante 90
EESTINOKIA: posts the ante 90
WalkerDCFC: posts the ante 90
omutst: posts the ante 90
gustavomrp491: posts small blind 350
pelelek: posts big blind 700
*** HOLE CARDS ***
Dealt to Kevin12345Mc [6c Ks]
Kevin12345Mc: folds 
looserGirl27: folds 
EESTINOKIA: calls 700
WalkerDCFC: folds 
omutst: folds 
pedropkr100: calls 700
gustavomrp491: folds 
pelelek: checks 
*** FLOP *** [8h Kc Jc]
pelelek: checks 
EESTINOKIA: checks 
pedropkr100: bets 983
pelelek: folds 
EESTINOKIA: calls 983
*** TURN *** [8h Kc Jc] [Ah]
EESTINOKIA: checks 
pedropkr100: checks 
*** RIVER *** [8h Kc Jc Ah] [Ts]
EESTINOKIA: checks 
pedropkr100: checks 
*** SHOW DOWN ***
EESTINOKIA: shows [5d 8d] (a pair of Eights)
pedropkr100: shows [Tc 8c] (two pair, Tens and Eights)
pedropkr100 collected 5136 from pot
*** SUMMARY ***
Total pot 5136 | Rake 0 
Board [8h Kc Jc Ah Ts]
Seat 1: pedropkr100 (button) showed [Tc 8c] and won (5136) with two pair, Tens and Eights
Seat 2: gustavomrp491 (small blind) folded before Flop
Seat 3: pelelek (big blind) folded on the Flop
Seat 4: Kevin12345Mc folded before Flop (didn't bet)
Seat 5: looserGirl27 folded before Flop (didn't bet)
Seat 6: EESTINOKIA showed [5d 8d] and lost with a pair of Eights
Seat 7: WalkerDCFC folded before Flop (didn't bet)
Seat 8: omutst folded before Flop (didn't bet)



PokerStars Hand #254672854820: Tournament #3852792524, $4.80+$5.00+$1.20 USD Hold'em No Limit - Level VIII (350/700) - 2025/02/02 17:39:53 WET [2025/02/02 12:39:53 ET]
Table '3852792524 145' 8-max Seat #2 is the button
Seat 1: pedropkr100 (27653 in chips, $5 bounty) 
Seat 2: gustavomrp491 (6781 in chips, $6.25 bounty) 
Seat 3: pelelek (144602 in chips, $10 bounty) 
Seat 4: Kevin12345Mc (31440 in chips, $7.50 bounty) 
Seat 5: looserGirl27 (24820 in chips, $5 bounty) 
Seat 6: EESTINOKIA (58674 in chips, $7.50 bounty) 
Seat 7: WalkerDCFC (83554 in chips, $10 bounty) 
Seat 8: omutst (49025 in chips, $10.62 bounty) 
pedropkr100: posts the ante 90
gustavomrp491: posts the ante 90
pelelek: posts the ante 90
Kevin12345Mc: posts the ante 90
looserGirl27: posts the ante 90
EESTINOKIA: posts the ante 90
WalkerDCFC: posts the ante 90
omutst: posts the ante 90
pelelek: posts small blind 350
Kevin12345Mc: posts big blind 700
*** HOLE CARDS ***
Dealt to Kevin12345Mc [Qd 9h]
looserGirl27: raises 700 to 1400
EESTINOKIA: calls 1400
WalkerDCFC: folds 
omutst: calls 1400
pedropkr100: folds 
gustavomrp491: folds 
pelelek: folds 
Kevin12345Mc: calls 700
*** FLOP *** [6d 9d 3s]
Kevin12345Mc: checks 
looserGirl27: checks 
EESTINOKIA: checks 
omutst: checks 
*** TURN *** [6d 9d 3s] [7h]
Kevin12345Mc: bets 3335
looserGirl27: folds 
EESTINOKIA: folds 
omutst: folds 
Uncalled bet (3335) returned to Kevin12345Mc
Kevin12345Mc collected 6670 from pot
Kevin12345Mc: doesn't show hand 
*** SUMMARY ***
Total pot 6670 | Rake 0 
Board [6d 9d 3s 7h]
Seat 1: pedropkr100 folded before Flop (didn't bet)
Seat 2: gustavomrp491 (button) folded before Flop (didn't bet)
Seat 3: pelelek (small blind) folded before Flop
Seat 4: Kevin12345Mc (big blind) collected (6670)
Seat 5: looserGirl27 folded on the Turn
Seat 6: EESTINOKIA folded on the Turn
Seat 7: WalkerDCFC folded before Flop (didn't bet)
Seat 8: omutst folded on the Turn



PokerStars Hand #254672883076: Tournament #3852792524, $4.80+$5.00+$1.20 USD Hold'em No Limit - Level VIII (350/700) - 2025/02/02 17:41:21 WET [2025/02/02 12:41:21 ET]
Table '3852792524 145' 8-max Seat #3 is the button
Seat 1: pedropkr100 (27563 in chips, $5 bounty) 
Seat 2: gustavomrp491 (6691 in chips, $6.25 bounty) 
Seat 3: pelelek (144162 in chips, $10 bounty) 
Seat 4: Kevin12345Mc (36620 in chips, $7.50 bounty) 
Seat 5: looserGirl27 (23330 in chips, $5 bounty) 
Seat 6: EESTINOKIA (57184 in chips, $7.50 bounty) 
Seat 7: WalkerDCFC (83464 in chips, $10 bounty) 
Seat 8: omutst (47535 in chips, $10.62 bounty) 
pedropkr100: posts the ante 90
gustavomrp491: posts the ante 90
pelelek: posts the ante 90
Kevin12345Mc: posts the ante 90
looserGirl27: posts the ante 90
EESTINOKIA: posts the ante 90
WalkerDCFC: posts the ante 90
omutst: posts the ante 90
Kevin12345Mc: posts small blind 350
looserGirl27: posts big blind 700
*** HOLE CARDS ***
Dealt to Kevin12345Mc [6c Ks]
EESTINOKIA: folds 
WalkerDCFC: folds 
omutst: raises 700 to 1400
pedropkr100: folds 
gustavomrp491: folds 
pelelek: folds 
Kevin12345Mc: folds 
looserGirl27: calls 700
*** FLOP *** [Qc 2s Kd]
looserGirl27: checks 
omutst: bets 1122
looserGirl27: folds 
Uncalled bet (1122) returned to omutst
omutst collected 3870 from pot
omutst: doesn't show hand 
*** SUMMARY ***
Total pot 3870 | Rake 0 
Board [Qc 2s Kd]
Seat 1: pedropkr100 folded before Flop (didn't bet)
Seat 2: gustavomrp491 folded before Flop (didn't bet)
Seat 3: pelelek (button) folded before Flop (didn't bet)
Seat 4: Kevin12345Mc (small blind) folded before Flop
Seat 5: looserGirl27 (big blind) folded on the Flop
Seat 6: EESTINOKIA folded before Flop (didn't bet)
Seat 7: WalkerDCFC folded before Flop (didn't bet)
Seat 8: omutst collected (3870)



PokerStars Hand #254672914603: Tournament #3852792524, $4.80+$5.00+$1.20 USD Hold'em No Limit - Level IX (400/800) - 2025/02/02 17:42:59 WET [2025/02/02 12:42:59 ET]
Table '3852792524 145' 8-max Seat #4 is the button
Seat 1: pedropkr100 (27473 in chips, $5 bounty) 
Seat 2: gustavomrp491 (6601 in chips, $6.25 bounty) 
Seat 3: pelelek (144072 in chips, $10 bounty) 
Seat 4: Kevin12345Mc (36180 in chips, $7.50 bounty) 
Seat 5: looserGirl27 (21840 in chips, $5 bounty) 
Seat 6: EESTINOKIA (57094 in chips, $7.50 bounty) 
Seat 7: WalkerDCFC (83374 in chips, $10 bounty) 
Seat 8: omutst (49915 in chips, $10.62 bounty) 
pedropkr100: posts the ante 100
gustavomrp491: posts the ante 100
pelelek: posts the ante 100
Kevin12345Mc: posts the ante 100
looserGirl27: posts the ante 100
EESTINOKIA: posts the ante 100
WalkerDCFC: posts the ante 100
omutst: posts the ante 100
looserGirl27: posts small blind 400
EESTINOKIA: posts big blind 800
*** HOLE CARDS ***
Dealt to Kevin12345Mc [Th 5c]
WalkerDCFC: folds 
omutst: folds 
pedropkr100: raises 800 to 1600
gustavomrp491: folds 
pelelek: folds 
Kevin12345Mc: folds 
looserGirl27: folds 
EESTINOKIA: calls 800
*** FLOP *** [Qd 7h 7d]
EESTINOKIA: checks 
pedropkr100: bets 1364
EESTINOKIA: calls 1364
*** TURN *** [Qd 7h 7d] [3h]
EESTINOKIA: checks 
pedropkr100: checks 
*** RIVER *** [Qd 7h 7d 3h] [6c]
EESTINOKIA: bets 54030 and is all-in
pedropkr100: folds 
Uncalled bet (54030) returned to EESTINOKIA
EESTINOKIA collected 7128 from pot
EESTINOKIA: doesn't show hand 
*** SUMMARY ***
Total pot 7128 | Rake 0 
Board [Qd 7h 7d 3h 6c]
Seat 1: pedropkr100 folded on the River
Seat 2: gustavomrp491 folded before Flop (didn't bet)
Seat 3: pelelek folded before Flop (didn't bet)
Seat 4: Kevin12345Mc (button) folded before Flop (didn't bet)
Seat 5: looserGirl27 (small blind) folded before Flop
Seat 6: EESTINOKIA (big blind) collected (7128)
Seat 7: WalkerDCFC folded before Flop (didn't bet)
Seat 8: omutst folded before Flop (didn't bet)



PokerStars Hand #254672936338: Tournament #3852792524, $4.80+$5.00+$1.20 USD Hold'em No Limit - Level IX (400/800) - 2025/02/02 17:44:08 WET [2025/02/02 12:44:08 ET]
Table '3852792524 145' 8-max Seat #5 is the button
Seat 1: pedropkr100 (24409 in chips, $5 bounty) 
Seat 2: gustavomrp491 (6501 in chips, $6.25 bounty) 
Seat 3: pelelek (143972 in chips, $10 bounty) 
Seat 4: Kevin12345Mc (36080 in chips, $7.50 bounty) 
Seat 5: looserGirl27 (21340 in chips, $5 bounty) 
Seat 6: EESTINOKIA (61158 in chips, $7.50 bounty) 
Seat 7: WalkerDCFC (83274 in chips, $10 bounty) 
Seat 8: omutst (49815 in chips, $10.62 bounty) 
pedropkr100: posts the ante 100
gustavomrp491: posts the ante 100
pelelek: posts the ante 100
Kevin12345Mc: posts the ante 100
looserGirl27: posts the ante 100
EESTINOKIA: posts the ante 100
WalkerDCFC: posts the ante 100
omutst: posts the ante 100
EESTINOKIA: posts small blind 400
WalkerDCFC: posts big blind 800
*** HOLE CARDS ***
Dealt to Kevin12345Mc [5d 3s]
omutst: raises 800 to 1600
pedropkr100: folds 
gustavomrp491: folds 
pelelek: folds 
Kevin12345Mc: folds 
looserGirl27: folds 
EESTINOKIA: calls 1200
WalkerDCFC: calls 800
*** FLOP *** [7h Ah 7s]
EESTINOKIA: checks 
WalkerDCFC: checks 
omutst: bets 1624
EESTINOKIA: folds 
WalkerDCFC: folds 
Uncalled bet (1624) returned to omutst
omutst collected 5600 from pot
omutst: doesn't show hand 
*** SUMMARY ***
Total pot 5600 | Rake 0 
Board [7h Ah 7s]
Seat 1: pedropkr100 folded before Flop (didn't bet)
Seat 2: gustavomrp491 folded before Flop (didn't bet)
Seat 3: pelelek folded before Flop (didn't bet)
Seat 4: Kevin12345Mc folded before Flop (didn't bet)
Seat 5: looserGirl27 (button) folded before Flop (didn't bet)
Seat 6: EESTINOKIA (small blind) folded on the Flop
Seat 7: WalkerDCFC (big blind) folded on the Flop
Seat 8: omutst collected (5600)



PokerStars Hand #254672961553: Tournament #3852792524, $4.80+$5.00+$1.20 USD Hold'em No Limit - Level IX (400/800) - 2025/02/02 17:45:25 WET [2025/02/02 12:45:25 ET]
Table '3852792524 145' 8-max Seat #6 is the button
Seat 1: pedropkr100 (24309 in chips, $5 bounty) 
Seat 2: gustavomrp491 (6401 in chips, $6.25 bounty) 
Seat 3: pelelek (143872 in chips, $10 bounty) 
Seat 4: Kevin12345Mc (35980 in chips, $7.50 bounty) 
Seat 5: looserGirl27 (21240 in chips, $5 bounty) 
Seat 6: EESTINOKIA (59458 in chips, $7.50 bounty) 
Seat 7: WalkerDCFC (81574 in chips, $10 bounty) 
Seat 8: omutst (53715 in chips, $10.62 bounty) 
pedropkr100: posts the ante 100
gustavomrp491: posts the ante 100
pelelek: posts the ante 100
Kevin12345Mc: posts the ante 100
looserGirl27: posts the ante 100
EESTINOKIA: posts the ante 100
WalkerDCFC: posts the ante 100
omutst: posts the ante 100
WalkerDCFC: posts small blind 400
omutst: posts big blind 800
*** HOLE CARDS ***
Dealt to Kevin12345Mc [Kh Jh]
pedropkr100: folds 
gustavomrp491: folds 
pelelek: raises 960 to 1760
Kevin12345Mc: calls 1760
looserGirl27: calls 1760
EESTINOKIA: calls 1760
WalkerDCFC: folds 
omutst: folds 
*** FLOP *** [5h Ac 4c]
pelelek: checks 
Kevin12345Mc: checks 
looserGirl27: checks 
EESTINOKIA: checks 
*** TURN *** [5h Ac 4c] [3d]
pelelek: checks 
Kevin12345Mc: checks 
looserGirl27: bets 3200
EESTINOKIA: folds 
pelelek: calls 3200
Kevin12345Mc: folds 
*** RIVER *** [5h Ac 4c 3d] [7h]
pelelek: checks 
looserGirl27: bets 10400
pelelek: folds 
Uncalled bet (10400) returned to looserGirl27
looserGirl27 collected 15440 from pot
*** SUMMARY ***
Total pot 15440 | Rake 0 
Board [5h Ac 4c 3d 7h]
Seat 1: pedropkr100 folded before Flop (didn't bet)
Seat 2: gustavomrp491 folded before Flop (didn't bet)
Seat 3: pelelek folded on the River
Seat 4: Kevin12345Mc folded on the Turn
Seat 5: looserGirl27 collected (15440)
Seat 6: EESTINOKIA (button) folded on the Turn
Seat 7: WalkerDCFC (small blind) folded before Flop
Seat 8: omutst (big blind) folded before Flop



PokerStars Hand #254673001371: Tournament #3852792524, $4.80+$5.00+$1.20 USD Hold'em No Limit - Level IX (400/800) - 2025/02/02 17:47:28 WET [2025/02/02 12:47:28 ET]
Table '3852792524 145' 8-max Seat #7 is the button
Seat 1: pedropkr100 (24209 in chips, $5 bounty) 
Seat 2: gustavomrp491 (6301 in chips, $6.25 bounty) 
Seat 3: pelelek (138812 in chips, $10 bounty) 
Seat 4: Kevin12345Mc (34120 in chips, $7.50 bounty) 
Seat 5: looserGirl27 (31620 in chips, $5 bounty) 
Seat 6: EESTINOKIA (57598 in chips, $7.50 bounty) 
Seat 7: WalkerDCFC (81074 in chips, $10 bounty) 
Seat 8: omutst (52815 in chips, $10.62 bounty) 
pedropkr100: posts the ante 100
gustavomrp491: posts the ante 100
pelelek: posts the ante 100
Kevin12345Mc: posts the ante 100
looserGirl27: posts the ante 100
EESTINOKIA: posts the ante 100
WalkerDCFC: posts the ante 100
omutst: posts the ante 100
omutst: posts small blind 400
pedropkr100: posts big blind 800
*** HOLE CARDS ***
Dealt to Kevin12345Mc [Qd Qh]
gustavomrp491: folds 
pelelek: folds 
Kevin12345Mc: raises 1040 to 1840
looserGirl27: folds 
EESTINOKIA: calls 1840
WalkerDCFC: folds 
omutst: folds 
pedropkr100: folds 
*** FLOP *** [6h 2d 9s]
Kevin12345Mc: bets 1874
EESTINOKIA: calls 1874
*** TURN *** [6h 2d 9s] [Ad]
Kevin12345Mc: bets 4714
EESTINOKIA: folds 
Uncalled bet (4714) returned to Kevin12345Mc
Kevin12345Mc collected 9428 from pot
Kevin12345Mc: doesn't show hand 
*** SUMMARY ***
Total pot 9428 | Rake 0 
Board [6h 2d 9s Ad]
Seat 1: pedropkr100 (big blind) folded before Flop
Seat 2: gustavomrp491 folded before Flop (didn't bet)
Seat 3: pelelek folded before Flop (didn't bet)
Seat 4: Kevin12345Mc collected (9428)
Seat 5: looserGirl27 folded before Flop (didn't bet)
Seat 6: EESTINOKIA folded on the Turn
Seat 7: WalkerDCFC (button) folded before Flop (didn't bet)
Seat 8: omutst (small blind) folded before Flop



PokerStars Hand #254673019880: Tournament #3852792524, $4.80+$5.00+$1.20 USD Hold'em No Limit - Level IX (400/800) - 2025/02/02 17:48:25 WET [2025/02/02 12:48:25 ET]
Table '3852792524 145' 8-max Seat #8 is the button
Seat 1: pedropkr100 (23309 in chips, $5 bounty) 
Seat 2: gustavomrp491 (6201 in chips, $6.25 bounty) 
Seat 3: pelelek (138712 in chips, $10 bounty) 
Seat 4: Kevin12345Mc (39734 in chips, $7.50 bounty) 
Seat 5: looserGirl27 (31520 in chips, $5 bounty) 
Seat 6: EESTINOKIA (53784 in chips, $7.50 bounty) 
Seat 7: WalkerDCFC (80974 in chips, $10 bounty) 
Seat 8: omutst (52315 in chips, $10.62 bounty) 
pedropkr100: posts the ante 100
gustavomrp491: posts the ante 100
pelelek: posts the ante 100
Kevin12345Mc: posts the ante 100
looserGirl27: posts the ante 100
EESTINOKIA: posts the ante 100
WalkerDCFC: posts the ante 100
omutst: posts the ante 100
pedropkr100: posts small blind 400
gustavomrp491: posts big blind 800
*** HOLE CARDS ***
Dealt to Kevin12345Mc [8d Tc]
pelelek: folds 
Kevin12345Mc: folds 
looserGirl27: folds 
EESTINOKIA: folds 
WalkerDCFC: folds 
omutst: calls 800
pedropkr100: folds 
gustavomrp491: raises 5301 to 6101 and is all-in
omutst: calls 5301
*** FLOP *** [4h Qs 5h]
*** TURN *** [4h Qs 5h] [8s]
*** RIVER *** [4h Qs 5h 8s] [7c]
*** SHOW DOWN ***
gustavomrp491: shows [As 5d] (a pair of Fives)
omutst: shows [6s Jd] (a straight, Four to Eight)
omutst collected 13402 from pot
omutst wins $3.13 for eliminating gustavomrp491 and their own bounty increases by $3.12 to $13.74
gustavomrp491 finished the tournament
*** SUMMARY ***
Total pot 13402 | Rake 0 
Board [4h Qs 5h 8s 7c]
Seat 1: pedropkr100 (small blind) folded before Flop
Seat 2: gustavomrp491 (big blind) showed [As 5d] and lost with a pair of Fives
Seat 3: pelelek folded before Flop (didn't bet)
Seat 4: Kevin12345Mc folded before Flop (didn't bet)
Seat 5: looserGirl27 folded before Flop (didn't bet)
Seat 6: EESTINOKIA folded before Flop (didn't bet)
Seat 7: WalkerDCFC folded before Flop (didn't bet)
Seat 8: omutst (button) showed [6s Jd] and won (13402) with a straight, Four to Eight



PokerStars Hand #254673032561: Tournament #3852792524, $4.80+$5.00+$1.20 USD Hold'em No Limit - Level IX (400/800) - 2025/02/02 17:49:04 WET [2025/02/02 12:49:04 ET]
Table '3852792524 145' 8-max Seat #1 is the button
Seat 1: pedropkr100 (22809 in chips, $5 bounty) 
Seat 3: pelelek (138612 in chips, $10 bounty) 
Seat 4: Kevin12345Mc (39634 in chips, $7.50 bounty) 
Seat 5: looserGirl27 (31420 in chips, $5 bounty) 
Seat 6: EESTINOKIA (53684 in chips, $7.50 bounty) 
Seat 7: WalkerDCFC (80874 in chips, $10 bounty) 
Seat 8: omutst (59516 in chips, $13.74 bounty) 
pedropkr100: posts the ante 100
pelelek: posts the ante 100
Kevin12345Mc: posts the ante 100
looserGirl27: posts the ante 100
EESTINOKIA: posts the ante 100
WalkerDCFC: posts the ante 100
omutst: posts the ante 100
pelelek: posts small blind 400
Kevin12345Mc: posts big blind 800
*** HOLE CARDS ***
Dealt to Kevin12345Mc [Qs 5d]
realkockie is disconnected 
looserGirl27: folds 
EESTINOKIA: folds 
WalkerDCFC: folds 
omutst: folds 
pedropkr100: folds 
pelelek: calls 400
Kevin12345Mc: checks 
*** FLOP *** [Kh 5s Js]
pelelek: checks 
Kevin12345Mc: checks 
*** TURN *** [Kh 5s Js] [Ah]
pelelek: checks 
Kevin12345Mc: checks 
*** RIVER *** [Kh 5s Js Ah] [7h]
pelelek: checks 
Kevin12345Mc: checks 
*** SHOW DOWN ***
pelelek: shows [6s 4d] (high card Ace)
Kevin12345Mc: shows [Qs 5d] (a pair of Fives)
Kevin12345Mc collected 2300 from pot
*** SUMMARY ***
Total pot 2300 | Rake 0 
Board [Kh 5s Js Ah 7h]
Seat 1: pedropkr100 (button) folded before Flop (didn't bet)
Seat 3: pelelek (small blind) showed [6s 4d] and lost with high card Ace
Seat 4: Kevin12345Mc (big blind) showed [Qs 5d] and won (2300) with a pair of Fives
Seat 5: looserGirl27 folded before Flop (didn't bet)
Seat 6: EESTINOKIA folded before Flop (didn't bet)
Seat 7: WalkerDCFC folded before Flop (didn't bet)
Seat 8: omutst folded before Flop (didn't bet)



PokerStars Hand #254673049286: Tournament #3852792524, $4.80+$5.00+$1.20 USD Hold'em No Limit - Level X (500/1000) - 2025/02/02 17:49:56 WET [2025/02/02 12:49:56 ET]
Table '3852792524 145' 8-max Seat #3 is the button
Seat 1: pedropkr100 (22709 in chips, $5 bounty) 
Seat 2: realkockie (64570 in chips, $12.50 bounty) 
Seat 3: pelelek (137712 in chips, $10 bounty) 
Seat 4: Kevin12345Mc (41034 in chips, $7.50 bounty) 
Seat 5: looserGirl27 (31320 in chips, $5 bounty) 
Seat 6: EESTINOKIA (53584 in chips, $7.50 bounty) 
Seat 7: WalkerDCFC (80774 in chips, $10 bounty) 
Seat 8: omutst (59416 in chips, $13.74 bounty) 
pedropkr100: posts the ante 125
realkockie: posts the ante 125
pelelek: posts the ante 125
Kevin12345Mc: posts the ante 125
looserGirl27: posts the ante 125
EESTINOKIA: posts the ante 125
WalkerDCFC: posts the ante 125
omutst: posts the ante 125
Kevin12345Mc: posts small blind 500
looserGirl27: posts big blind 1000
*** HOLE CARDS ***
Dealt to Kevin12345Mc [2c 7s]
EESTINOKIA: folds 
WalkerDCFC: folds 
omutst: folds 
pedropkr100: folds 
realkockie: folds 
pelelek: raises 1200 to 2200
Kevin12345Mc: folds 
looserGirl27: calls 1200
*** FLOP *** [Ac 3c 8c]
looserGirl27: checks 
pelelek: bets 1000
looserGirl27: calls 1000
*** TURN *** [Ac 3c 8c] [6s]
looserGirl27: checks 
pelelek: checks 
*** RIVER *** [Ac 3c 8c 6s] [Jh]
looserGirl27: bets 4000
pelelek: calls 4000
*** SHOW DOWN ***
looserGirl27: shows [5h 4c] (high card Ace)
pelelek: shows [Tc Jd] (a pair of Jacks)
pelelek collected 15900 from pot
*** SUMMARY ***
Total pot 15900 | Rake 0 
Board [Ac 3c 8c 6s Jh]
Seat 1: pedropkr100 folded before Flop (didn't bet)
Seat 2: realkockie folded before Flop (didn't bet)
Seat 3: pelelek (button) showed [Tc Jd] and won (15900) with a pair of Jacks
Seat 4: Kevin12345Mc (small blind) folded before Flop
Seat 5: looserGirl27 (big blind) showed [5h 4c] and lost with high card Ace
Seat 6: EESTINOKIA folded before Flop (didn't bet)
Seat 7: WalkerDCFC folded before Flop (didn't bet)
Seat 8: omutst folded before Flop (didn't bet)



PokerStars Hand #254673081663: Tournament #3852792524, $4.80+$5.00+$1.20 USD Hold'em No Limit - Level X (500/1000) - 2025/02/02 17:51:36 WET [2025/02/02 12:51:36 ET]
Table '3852792524 145' 8-max Seat #4 is the button
Seat 1: pedropkr100 (22584 in chips, $5 bounty) 
Seat 2: realkockie (64445 in chips, $12.50 bounty) 
Seat 3: pelelek (146287 in chips, $10 bounty) 
Seat 4: Kevin12345Mc (40409 in chips, $7.50 bounty) 
Seat 5: looserGirl27 (23995 in chips, $5 bounty) 
Seat 6: EESTINOKIA (53459 in chips, $7.50 bounty) 
Seat 7: WalkerDCFC (80649 in chips, $10 bounty) 
Seat 8: omutst (59291 in chips, $13.74 bounty) 
pedropkr100: posts the ante 125
realkockie: posts the ante 125
pelelek: posts the ante 125
Kevin12345Mc: posts the ante 125
looserGirl27: posts the ante 125
EESTINOKIA: posts the ante 125
WalkerDCFC: posts the ante 125
omutst: posts the ante 125
looserGirl27: posts small blind 500
EESTINOKIA: posts big blind 1000
*** HOLE CARDS ***
Dealt to Kevin12345Mc [2c 9h]
WalkerDCFC: folds 
omutst: folds 
pedropkr100: folds 
realkockie: calls 1000
pelelek: calls 1000
Kevin12345Mc: folds 
looserGirl27: calls 500
EESTINOKIA: checks 
*** FLOP *** [Ts 5h 7d]
looserGirl27: checks 
EESTINOKIA: bets 5000
realkockie: folds 
pelelek: folds 
looserGirl27: folds 
Uncalled bet (5000) returned to EESTINOKIA
EESTINOKIA collected 5000 from pot
EESTINOKIA: doesn't show hand 
*** SUMMARY ***
Total pot 5000 | Rake 0 
Board [Ts 5h 7d]
Seat 1: pedropkr100 folded before Flop (didn't bet)
Seat 2: realkockie folded on the Flop
Seat 3: pelelek folded on the Flop
Seat 4: Kevin12345Mc (button) folded before Flop (didn't bet)
Seat 5: looserGirl27 (small blind) folded on the Flop
Seat 6: EESTINOKIA (big blind) collected (5000)
Seat 7: WalkerDCFC folded before Flop (didn't bet)
Seat 8: omutst folded before Flop (didn't bet)



PokerStars Hand #254673104613: Tournament #3852792524, $4.80+$5.00+$1.20 USD Hold'em No Limit - Level X (500/1000) - 2025/02/02 17:52:48 WET [2025/02/02 12:52:48 ET]
Table '3852792524 145' 8-max Seat #5 is the button
Seat 1: pedropkr100 (22459 in chips, $5 bounty) 
Seat 2: realkockie (63320 in chips, $12.50 bounty) 
Seat 3: pelelek (145162 in chips, $10 bounty) 
Seat 4: Kevin12345Mc (40284 in chips, $7.50 bounty) 
Seat 5: looserGirl27 (22870 in chips, $5 bounty) 
Seat 6: EESTINOKIA (57334 in chips, $7.50 bounty) 
Seat 7: WalkerDCFC (80524 in chips, $10 bounty) 
Seat 8: omutst (59166 in chips, $13.74 bounty) 
pedropkr100: posts the ante 125
realkockie: posts the ante 125
pelelek: posts the ante 125
Kevin12345Mc: posts the ante 125
looserGirl27: posts the ante 125
EESTINOKIA: posts the ante 125
WalkerDCFC: posts the ante 125
omutst: posts the ante 125
EESTINOKIA: posts small blind 500
WalkerDCFC: posts big blind 1000
*** HOLE CARDS ***
Dealt to Kevin12345Mc [Qc Qh]
omutst: folds 
pedropkr100: raises 1000 to 2000
realkockie: folds 
pelelek: folds 
Kevin12345Mc: raises 4000 to 6000
looserGirl27: folds 
EESTINOKIA: folds 
WalkerDCFC: folds 
pedropkr100: raises 16334 to 22334 and is all-in
Kevin12345Mc: calls 16334
*** FLOP *** [2h 8h 4d]
*** TURN *** [2h 8h 4d] [Qd]
*** RIVER *** [2h 8h 4d Qd] [Jd]
*** SHOW DOWN ***
pedropkr100: shows [Js Jh] (three of a kind, Jacks)
Kevin12345Mc: shows [Qc Qh] (three of a kind, Queens)
Kevin12345Mc collected 47168 from pot
Kevin12345Mc wins $2.50 for eliminating pedropkr100 and their own bounty increases by $2.50 to $10
pedropkr100 finished the tournament
AMCLB272 is disconnected 
*** SUMMARY ***
Total pot 47168 | Rake 0 
Board [2h 8h 4d Qd Jd]
Seat 1: pedropkr100 showed [Js Jh] and lost with three of a kind, Jacks
Seat 2: realkockie folded before Flop (didn't bet)
Seat 3: pelelek folded before Flop (didn't bet)
Seat 4: Kevin12345Mc showed [Qc Qh] and won (47168) with three of a kind, Queens
Seat 5: looserGirl27 (button) folded before Flop (didn't bet)
Seat 6: EESTINOKIA (small blind) folded before Flop
Seat 7: WalkerDCFC (big blind) folded before Flop
Seat 8: omutst folded before Flop (didn't bet)



PokerStars Hand #254673120933: Tournament #3852792524, $4.80+$5.00+$1.20 USD Hold'em No Limit - Level X (500/1000) - 2025/02/02 17:53:38 WET [2025/02/02 12:53:38 ET]
Table '3852792524 145' 8-max Seat #6 is the button
Seat 1: AMCLB272 (25000 in chips, $5 bounty) 
Seat 2: realkockie (63195 in chips, $12.50 bounty) 
Seat 3: pelelek (145037 in chips, $10 bounty) 
Seat 4: Kevin12345Mc (64993 in chips, $10 bounty) 
Seat 5: looserGirl27 (22745 in chips, $5 bounty) 
Seat 6: EESTINOKIA (56709 in chips, $7.50 bounty) 
Seat 7: WalkerDCFC (79399 in chips, $10 bounty) 
Seat 8: omutst (59041 in chips, $13.74 bounty) 
AMCLB272: posts the ante 125
realkockie: posts the ante 125
pelelek: posts the ante 125
Kevin12345Mc: posts the ante 125
looserGirl27: posts the ante 125
EESTINOKIA: posts the ante 125
WalkerDCFC: posts the ante 125
omutst: posts the ante 125
WalkerDCFC: posts small blind 500
omutst: posts big blind 1000
*** HOLE CARDS ***
Dealt to Kevin12345Mc [8d 9h]
AMCLB272: folds 
realkockie: folds 
pelelek: folds 
Kevin12345Mc: folds 
looserGirl27: folds 
EESTINOKIA: folds 
WalkerDCFC: raises 2800 to 3800
omutst: calls 2800
*** FLOP *** [8s 7c Kd]
WalkerDCFC: bets 5278
omutst: calls 5278
*** TURN *** [8s 7c Kd] [8h]
WalkerDCFC: bets 13984
omutst: calls 13984
*** RIVER *** [8s 7c Kd 8h] [Qd]
WalkerDCFC: bets 56212 and is all-in
omutst: folds 
Uncalled bet (56212) returned to WalkerDCFC
WalkerDCFC collected 47124 from pot
WalkerDCFC: doesn't show hand 
*** SUMMARY ***
Total pot 47124 | Rake 0 
Board [8s 7c Kd 8h Qd]
Seat 1: AMCLB272 folded before Flop (didn't bet)
Seat 2: realkockie folded before Flop (didn't bet)
Seat 3: pelelek folded before Flop (didn't bet)
Seat 4: Kevin12345Mc folded before Flop (didn't bet)
Seat 5: looserGirl27 folded before Flop (didn't bet)
Seat 6: EESTINOKIA (button) folded before Flop (didn't bet)
Seat 7: WalkerDCFC (small blind) collected (47124)
Seat 8: omutst (big blind) folded on the River



PokerStars Hand #254673284383: Tournament #3852792524, $4.80+$5.00+$1.20 USD Hold'em No Limit - Level X (500/1000) - 2025/02/02 18:04:23 WET [2025/02/02 13:04:23 ET]
Table '3852792524 145' 8-max Seat #8 is the button
Seat 1: AMCLB272 (24875 in chips, $5 bounty) 
Seat 2: realkockie (63070 in chips, $12.50 bounty) 
Seat 3: pelelek (144912 in chips, $10 bounty) 
Seat 4: Kevin12345Mc (64868 in chips, $10 bounty) 
Seat 5: looserGirl27 (22620 in chips, $5 bounty) 
Seat 6: EESTINOKIA (56584 in chips, $7.50 bounty) 
Seat 7: josias28 (25000 in chips, $5 bounty) 
Seat 8: omutst (35854 in chips, $13.74 bounty) 
AMCLB272: posts the ante 125
realkockie: posts the ante 125
pelelek: posts the ante 125
Kevin12345Mc: posts the ante 125
looserGirl27: posts the ante 125
EESTINOKIA: posts the ante 125
josias28: posts the ante 125
omutst: posts the ante 125
AMCLB272: posts small blind 500
realkockie: posts big blind 1000
*** HOLE CARDS ***
Dealt to Kevin12345Mc [7s As]
pelelek: folds 
Kevin12345Mc: raises 1300 to 2300
looserGirl27: calls 2300
EESTINOKIA: calls 2300
josias28: raises 22575 to 24875 and is all-in
omutst: folds 
AMCLB272: folds 
realkockie: folds 
Kevin12345Mc: folds 
looserGirl27: folds 
EESTINOKIA: folds 
Uncalled bet (22575) returned to josias28
josias28 collected 11700 from pot
josias28: doesn't show hand 
*** SUMMARY ***
Total pot 11700 | Rake 0 
Seat 1: AMCLB272 (small blind) folded before Flop
Seat 2: realkockie (big blind) folded before Flop
Seat 3: pelelek folded before Flop (didn't bet)
Seat 4: Kevin12345Mc folded before Flop
Seat 5: looserGirl27 folded before Flop
Seat 6: EESTINOKIA folded before Flop
Seat 7: josias28 collected (11700)
Seat 8: omutst (button) folded before Flop (didn't bet)



PokerStars Hand #254673304379: Tournament #3852792524, $4.80+$5.00+$1.20 USD Hold'em No Limit - Level X (500/1000) - 2025/02/02 18:05:22 WET [2025/02/02 13:05:22 ET]
Table '3852792524 145' 8-max Seat #1 is the button
Seat 1: AMCLB272 (24250 in chips, $5 bounty) 
Seat 2: realkockie (61945 in chips, $12.50 bounty) 
Seat 3: pelelek (144787 in chips, $10 bounty) 
Seat 4: Kevin12345Mc (62443 in chips, $10 bounty) 
Seat 5: looserGirl27 (20195 in chips, $5 bounty) 
Seat 6: EESTINOKIA (54159 in chips, $7.50 bounty) 
Seat 7: josias28 (34275 in chips, $5 bounty) 
Seat 8: omutst (35729 in chips, $13.74 bounty) 
AMCLB272: posts the ante 125
realkockie: posts the ante 125
pelelek: posts the ante 125
Kevin12345Mc: posts the ante 125
looserGirl27: posts the ante 125
EESTINOKIA: posts the ante 125
josias28: posts the ante 125
omutst: posts the ante 125
realkockie: posts small blind 500
pelelek: posts big blind 1000
*** HOLE CARDS ***
Dealt to Kevin12345Mc [4d 2c]
Kevin12345Mc: folds 
looserGirl27: raises 1000 to 2000
EESTINOKIA: calls 2000
josias28: calls 2000
omutst: folds 
AMCLB272: folds 
realkockie: folds 
pelelek: calls 1000
*** FLOP *** [7s Qc Kd]
pelelek: checks 
looserGirl27: checks 
EESTINOKIA: checks 
josias28: bets 3000
pelelek: calls 3000
looserGirl27: folds 
EESTINOKIA: calls 3000
*** TURN *** [7s Qc Kd] [6c]
pelelek: checks 
EESTINOKIA: checks 
josias28: checks 
*** RIVER *** [7s Qc Kd 6c] [Kh]
pelelek: checks 
EESTINOKIA: checks 
josias28: checks 
*** SHOW DOWN ***
pelelek: shows [Qs 8d] (two pair, Kings and Queens)
EESTINOKIA: mucks hand 
josias28: mucks hand 
pelelek collected 18500 from pot
*** SUMMARY ***
Total pot 18500 | Rake 0 
Board [7s Qc Kd 6c Kh]
Seat 1: AMCLB272 (button) folded before Flop (didn't bet)
Seat 2: realkockie (small blind) folded before Flop
Seat 3: pelelek (big blind) showed [Qs 8d] and won (18500) with two pair, Kings and Queens
Seat 4: Kevin12345Mc folded before Flop (didn't bet)
Seat 5: looserGirl27 folded on the Flop
Seat 6: EESTINOKIA mucked [5c 5d]
Seat 7: josias28 mucked [7h 4h]
Seat 8: omutst folded before Flop (didn't bet)



PokerStars Hand #254673334296: Tournament #3852792524, $4.80+$5.00+$1.20 USD Hold'em No Limit - Level X (500/1000) - 2025/02/02 18:06:50 WET [2025/02/02 13:06:50 ET]
Table '3852792524 145' 8-max Seat #2 is the button
Seat 1: AMCLB272 (24125 in chips, $5 bounty) 
Seat 2: realkockie (61320 in chips, $12.50 bounty) 
Seat 3: pelelek (158162 in chips, $10 bounty) 
Seat 4: Kevin12345Mc (62318 in chips, $10 bounty) 
Seat 5: looserGirl27 (18070 in chips, $5 bounty) 
Seat 6: EESTINOKIA (49034 in chips, $7.50 bounty) 
Seat 7: josias28 (29150 in chips, $5 bounty) 
Seat 8: omutst (35604 in chips, $13.74 bounty) 
AMCLB272: posts the ante 125
realkockie: posts the ante 125
pelelek: posts the ante 125
Kevin12345Mc: posts the ante 125
looserGirl27: posts the ante 125
EESTINOKIA: posts the ante 125
josias28: posts the ante 125
omutst: posts the ante 125
pelelek: posts small blind 500
Kevin12345Mc: posts big blind 1000
*** HOLE CARDS ***
Dealt to Kevin12345Mc [Tc 4h]
looserGirl27: raises 1000 to 2000
EESTINOKIA: calls 2000
josias28: folds 
omutst: folds 
AMCLB272: raises 3000 to 5000
realkockie: folds 
pelelek: folds 
Kevin12345Mc: folds 
looserGirl27: folds 
EESTINOKIA: calls 3000
*** FLOP *** [9s Jh 5c]
EESTINOKIA: bets 7250
AMCLB272: calls 7250
*** TURN *** [9s Jh 5c] [Kc]
EESTINOKIA: checks 
AMCLB272: bets 1000
EESTINOKIA: calls 1000
*** RIVER *** [9s Jh 5c Kc] [7d]
EESTINOKIA: checks 
AMCLB272: bets 10750 and is all-in
EESTINOKIA: calls 10750
*** SHOW DOWN ***
AMCLB272: shows [6h 6d] (a pair of Sixes)
EESTINOKIA: shows [Ac Jc] (a pair of Jacks)
EESTINOKIA collected 52500 from pot
EESTINOKIA wins $2.50 for eliminating AMCLB272 and their own bounty increases by $2.50 to $10
AMCLB272 finished the tournament
*** SUMMARY ***
Total pot 52500 | Rake 0 
Board [9s Jh 5c Kc 7d]
Seat 1: AMCLB272 showed [6h 6d] and lost with a pair of Sixes
Seat 2: realkockie (button) folded before Flop (didn't bet)
Seat 3: pelelek (small blind) folded before Flop
Seat 4: Kevin12345Mc (big blind) folded before Flop
Seat 5: looserGirl27 folded before Flop
Seat 6: EESTINOKIA showed [Ac Jc] and won (52500) with a pair of Jacks
Seat 7: josias28 folded before Flop (didn't bet)
Seat 8: omutst folded before Flop (didn't bet)



PokerStars Hand #254673358292: Tournament #3852792524, $4.80+$5.00+$1.20 USD Hold'em No Limit - Level XI (600/1200) - 2025/02/02 18:08:02 WET [2025/02/02 13:08:02 ET]
Table '3852792524 145' 8-max Seat #3 is the button
Seat 2: realkockie (61195 in chips, $12.50 bounty) 
Seat 3: pelelek (157537 in chips, $10 bounty) 
Seat 4: Kevin12345Mc (61193 in chips, $10 bounty) 
Seat 5: looserGirl27 (15945 in chips, $5 bounty) 
Seat 6: EESTINOKIA (77409 in chips, $10 bounty) 
Seat 7: josias28 (29025 in chips, $5 bounty) 
Seat 8: omutst (35479 in chips, $13.74 bounty) 
realkockie: posts the ante 150
pelelek: posts the ante 150
Kevin12345Mc: posts the ante 150
looserGirl27: posts the ante 150
EESTINOKIA: posts the ante 150
josias28: posts the ante 150
omutst: posts the ante 150
Kevin12345Mc: posts small blind 600
looserGirl27: posts big blind 1200
*** HOLE CARDS ***
Dealt to Kevin12345Mc [Td 5s]
EESTINOKIA: calls 1200
josias28: folds 
omutst: folds 
realkockie: folds 
pelelek: folds 
Kevin12345Mc: folds 
looserGirl27: checks 
*** FLOP *** [3d 9s 2d]
looserGirl27: checks 
EESTINOKIA: checks 
*** TURN *** [3d 9s 2d] [Jh]
looserGirl27: checks 
EESTINOKIA: checks 
*** RIVER *** [3d 9s 2d Jh] [Ad]
looserGirl27: checks 
EESTINOKIA: checks 
*** SHOW DOWN ***
looserGirl27: shows [2h Kd] (a pair of Deuces)
EESTINOKIA: mucks hand 
looserGirl27 collected 4050 from pot
*** SUMMARY ***
Total pot 4050 | Rake 0 
Board [3d 9s 2d Jh Ad]
Seat 2: realkockie folded before Flop (didn't bet)
Seat 3: pelelek (button) folded before Flop (didn't bet)
Seat 4: Kevin12345Mc (small blind) folded before Flop
Seat 5: looserGirl27 (big blind) showed [2h Kd] and won (4050) with a pair of Deuces
Seat 6: EESTINOKIA mucked [Ts Qs]
Seat 7: josias28 folded before Flop (didn't bet)
Seat 8: omutst folded before Flop (didn't bet)



PokerStars Hand #254673379824: Tournament #3852792524, $4.80+$5.00+$1.20 USD Hold'em No Limit - Level XI (600/1200) - 2025/02/02 18:09:05 WET [2025/02/02 13:09:05 ET]
Table '3852792524 145' 8-max Seat #4 is the button
Seat 1: The Heavy Sp (25000 in chips, $5 bounty) 
Seat 2: realkockie (61045 in chips, $12.50 bounty) 
Seat 3: pelelek (157387 in chips, $10 bounty) 
Seat 4: Kevin12345Mc (60443 in chips, $10 bounty) 
Seat 5: looserGirl27 (18645 in chips, $5 bounty) 
Seat 6: EESTINOKIA (76059 in chips, $10 bounty) 
Seat 7: josias28 (28875 in chips, $5 bounty) 
Seat 8: omutst (35329 in chips, $13.74 bounty) 
The Heavy Sp: posts the ante 150
realkockie: posts the ante 150
pelelek: posts the ante 150
Kevin12345Mc: posts the ante 150
looserGirl27: posts the ante 150
EESTINOKIA: posts the ante 150
josias28: posts the ante 150
omutst: posts the ante 150
looserGirl27: posts small blind 600
EESTINOKIA: posts big blind 1200
*** HOLE CARDS ***
Dealt to Kevin12345Mc [4s Kc]
josias28: folds 
omutst: folds 
The Heavy Sp: folds 
realkockie: folds 
pelelek: raises 1440 to 2640
Kevin12345Mc: folds 
looserGirl27: folds 
EESTINOKIA: folds 
Uncalled bet (1440) returned to pelelek
pelelek collected 4200 from pot
*** SUMMARY ***
Total pot 4200 | Rake 0 
Seat 1: The Heavy Sp folded before Flop (didn't bet)
Seat 2: realkockie folded before Flop (didn't bet)
Seat 3: pelelek collected (4200)
Seat 4: Kevin12345Mc (button) folded before Flop (didn't bet)
Seat 5: looserGirl27 (small blind) folded before Flop
Seat 6: EESTINOKIA (big blind) folded before Flop
Seat 7: josias28 folded before Flop (didn't bet)
Seat 8: omutst folded before Flop (didn't bet)



PokerStars Hand #254673392589: Tournament #3852792524, $4.80+$5.00+$1.20 USD Hold'em No Limit - Level XI (600/1200) - 2025/02/02 18:09:43 WET [2025/02/02 13:09:43 ET]
Table '3852792524 145' 8-max Seat #5 is the button
Seat 1: The Heavy Sp (24850 in chips, $5 bounty) 
Seat 2: realkockie (60895 in chips, $12.50 bounty) 
Seat 3: pelelek (160237 in chips, $10 bounty) 
Seat 4: Kevin12345Mc (60293 in chips, $10 bounty) 
Seat 5: looserGirl27 (17895 in chips, $5 bounty) 
Seat 6: EESTINOKIA (74709 in chips, $10 bounty) 
Seat 7: josias28 (28725 in chips, $5 bounty) 
Seat 8: omutst (35179 in chips, $13.74 bounty) 
The Heavy Sp: posts the ante 150
realkockie: posts the ante 150
pelelek: posts the ante 150
Kevin12345Mc: posts the ante 150
looserGirl27: posts the ante 150
EESTINOKIA: posts the ante 150
josias28: posts the ante 150
omutst: posts the ante 150
EESTINOKIA: posts small blind 600
josias28: posts big blind 1200
*** HOLE CARDS ***
Dealt to Kevin12345Mc [Ts Jh]
omutst: folds 
The Heavy Sp: folds 
realkockie: folds 
pelelek: folds 
Kevin12345Mc: raises 1560 to 2760
looserGirl27: folds 
EESTINOKIA: folds 
josias28: calls 1560
*** FLOP *** [6h 8s 9d]
josias28: checks 
Kevin12345Mc: bets 2416
josias28: raises 23399 to 25815 and is all-in
Kevin12345Mc: calls 23399
*** TURN *** [6h 8s 9d] [Ah]
*** RIVER *** [6h 8s 9d Ah] [9h]
*** SHOW DOWN ***
josias28: shows [Jc 8c] (two pair, Nines and Eights)
Kevin12345Mc: shows [Ts Jh] (a pair of Nines)
josias28 collected 58950 from pot
*** SUMMARY ***
Total pot 58950 | Rake 0 
Board [6h 8s 9d Ah 9h]
Seat 1: The Heavy Sp folded before Flop (didn't bet)
Seat 2: realkockie folded before Flop (didn't bet)
Seat 3: pelelek folded before Flop (didn't bet)
Seat 4: Kevin12345Mc showed [Ts Jh] and lost with a pair of Nines
Seat 5: looserGirl27 (button) folded before Flop (didn't bet)
Seat 6: EESTINOKIA (small blind) folded before Flop
Seat 7: josias28 (big blind) showed [Jc 8c] and won (58950) with two pair, Nines and Eights
Seat 8: omutst folded before Flop (didn't bet)



PokerStars Hand #254673408186: Tournament #3852792524, $4.80+$5.00+$1.20 USD Hold'em No Limit - Level XI (600/1200) - 2025/02/02 18:10:29 WET [2025/02/02 13:10:29 ET]
Table '3852792524 145' 8-max Seat #6 is the button
Seat 1: The Heavy Sp (24700 in chips, $5 bounty) 
Seat 2: realkockie (60745 in chips, $12.50 bounty) 
Seat 3: pelelek (160087 in chips, $10 bounty) 
Seat 4: Kevin12345Mc (31568 in chips, $10 bounty) 
Seat 5: looserGirl27 (17745 in chips, $5 bounty) 
Seat 6: EESTINOKIA (73959 in chips, $10 bounty) 
Seat 7: josias28 (58950 in chips, $5 bounty) 
Seat 8: omutst (35029 in chips, $13.74 bounty) 
The Heavy Sp: posts the ante 150
realkockie: posts the ante 150
pelelek: posts the ante 150
Kevin12345Mc: posts the ante 150
looserGirl27: posts the ante 150
EESTINOKIA: posts the ante 150
josias28: posts the ante 150
omutst: posts the ante 150
josias28: posts small blind 600
omutst: posts big blind 1200
*** HOLE CARDS ***
Dealt to Kevin12345Mc [Qs 2d]
The Heavy Sp: calls 1200
realkockie: folds 
pelelek: folds 
Kevin12345Mc: folds 
looserGirl27: folds 
EESTINOKIA: calls 1200
josias28: raises 2400 to 3600
omutst: folds 
The Heavy Sp: calls 2400
EESTINOKIA: calls 2400
*** FLOP *** [8c 3c Td]
josias28: bets 13200
The Heavy Sp: folds 
EESTINOKIA: folds 
Uncalled bet (13200) returned to josias28
josias28 collected 13200 from pot
josias28: doesn't show hand 
*** SUMMARY ***
Total pot 13200 | Rake 0 
Board [8c 3c Td]
Seat 1: The Heavy Sp folded on the Flop
Seat 2: realkockie folded before Flop (didn't bet)
Seat 3: pelelek folded before Flop (didn't bet)
Seat 4: Kevin12345Mc folded before Flop (didn't bet)
Seat 5: looserGirl27 folded before Flop (didn't bet)
Seat 6: EESTINOKIA (button) folded on the Flop
Seat 7: josias28 (small blind) collected (13200)
Seat 8: omutst (big blind) folded before Flop



PokerStars Hand #254673427077: Tournament #3852792524, $4.80+$5.00+$1.20 USD Hold'em No Limit - Level XI (600/1200) - 2025/02/02 18:11:25 WET [2025/02/02 13:11:25 ET]
Table '3852792524 145' 8-max Seat #7 is the button
Seat 1: The Heavy Sp (20950 in chips, $5 bounty) 
Seat 2: realkockie (60595 in chips, $12.50 bounty) 
Seat 3: pelelek (159937 in chips, $10 bounty) 
Seat 4: Kevin12345Mc (31418 in chips, $10 bounty) 
Seat 5: looserGirl27 (17595 in chips, $5 bounty) 
Seat 6: EESTINOKIA (70209 in chips, $10 bounty) 
Seat 7: josias28 (68400 in chips, $5 bounty) 
Seat 8: omutst (33679 in chips, $13.74 bounty) 
The Heavy Sp: posts the ante 150
realkockie: posts the ante 150
pelelek: posts the ante 150
Kevin12345Mc: posts the ante 150
looserGirl27: posts the ante 150
EESTINOKIA: posts the ante 150
josias28: posts the ante 150
omutst: posts the ante 150
omutst: posts small blind 600
The Heavy Sp: posts big blind 1200
*** HOLE CARDS ***
Dealt to Kevin12345Mc [5h 8d]
realkockie: calls 1200
pelelek: raises 2400 to 3600
Kevin12345Mc: folds 
looserGirl27: folds 
EESTINOKIA: folds 
josias28: folds 
omutst: folds 
The Heavy Sp: folds 
realkockie: calls 2400
*** FLOP *** [9d 7h 6d]
realkockie: checks 
pelelek: checks 
*** TURN *** [9d 7h 6d] [Kc]
realkockie: checks 
pelelek: checks 
*** RIVER *** [9d 7h 6d Kc] [3c]
realkockie: bets 3060
pelelek: folds 
Uncalled bet (3060) returned to realkockie
realkockie collected 10200 from pot
*** SUMMARY ***
Total pot 10200 | Rake 0 
Board [9d 7h 6d Kc 3c]
Seat 1: The Heavy Sp (big blind) folded before Flop
Seat 2: realkockie collected (10200)
Seat 3: pelelek folded on the River
Seat 4: Kevin12345Mc folded before Flop (didn't bet)
Seat 5: looserGirl27 folded before Flop (didn't bet)
Seat 6: EESTINOKIA folded before Flop (didn't bet)
Seat 7: josias28 (button) folded before Flop (didn't bet)
Seat 8: omutst (small blind) folded before Flop



PokerStars Hand #254673444087: Tournament #3852792524, $4.80+$5.00+$1.20 USD Hold'em No Limit - Level XI (600/1200) - 2025/02/02 18:12:15 WET [2025/02/02 13:12:15 ET]
Table '3852792524 145' 8-max Seat #8 is the button
Seat 1: The Heavy Sp (19600 in chips, $5 bounty) 
Seat 2: realkockie (67045 in chips, $12.50 bounty) 
Seat 3: pelelek (156187 in chips, $10 bounty) 
Seat 4: Kevin12345Mc (31268 in chips, $10 bounty) 
Seat 5: looserGirl27 (17445 in chips, $5 bounty) 
Seat 6: EESTINOKIA (70059 in chips, $10 bounty) 
Seat 7: josias28 (68250 in chips, $5 bounty) 
Seat 8: omutst (32929 in chips, $13.74 bounty) 
The Heavy Sp: posts the ante 150
realkockie: posts the ante 150
pelelek: posts the ante 150
Kevin12345Mc: posts the ante 150
looserGirl27: posts the ante 150
EESTINOKIA: posts the ante 150
josias28: posts the ante 150
omutst: posts the ante 150
The Heavy Sp: posts small blind 600
realkockie: posts big blind 1200
*** HOLE CARDS ***
Dealt to Kevin12345Mc [Qc 9d]
pelelek: folds 
Kevin12345Mc: folds 
looserGirl27: raises 1200 to 2400
EESTINOKIA: calls 2400
josias28: raises 10200 to 12600
omutst: folds 
The Heavy Sp: folds 
realkockie: folds 
looserGirl27: raises 4695 to 17295 and is all-in
EESTINOKIA: folds 
josias28: calls 4695
*** FLOP *** [8c 7s Ts]
*** TURN *** [8c 7s Ts] [Js]
*** RIVER *** [8c 7s Ts Js] [Qd]
*** SHOW DOWN ***
looserGirl27: shows [Ah Ac] (a pair of Aces)
josias28: shows [5s 5h] (a pair of Fives)
looserGirl27 collected 39990 from pot
*** SUMMARY ***
Total pot 39990 | Rake 0 
Board [8c 7s Ts Js Qd]
Seat 1: The Heavy Sp (small blind) folded before Flop
Seat 2: realkockie (big blind) folded before Flop
Seat 3: pelelek folded before Flop (didn't bet)
Seat 4: Kevin12345Mc folded before Flop (didn't bet)
Seat 5: looserGirl27 showed [Ah Ac] and won (39990) with a pair of Aces
Seat 6: EESTINOKIA folded before Flop
Seat 7: josias28 showed [5s 5h] and lost with a pair of Fives
Seat 8: omutst (button) folded before Flop (didn't bet)



PokerStars Hand #254673462327: Tournament #3852792524, $4.80+$5.00+$1.20 USD Hold'em No Limit - Level XI (600/1200) - 2025/02/02 18:13:09 WET [2025/02/02 13:13:09 ET]
Table '3852792524 145' 8-max Seat #1 is the button
Seat 1: The Heavy Sp (18850 in chips, $5 bounty) 
Seat 2: realkockie (65695 in chips, $12.50 bounty) 
Seat 3: pelelek (156037 in chips, $10 bounty) 
Seat 4: Kevin12345Mc (31118 in chips, $10 bounty) 
Seat 5: looserGirl27 (39990 in chips, $5 bounty) 
Seat 6: EESTINOKIA (67509 in chips, $10 bounty) 
Seat 7: josias28 (50805 in chips, $5 bounty) 
Seat 8: omutst (32779 in chips, $13.74 bounty) 
The Heavy Sp: posts the ante 150
realkockie: posts the ante 150
pelelek: posts the ante 150
Kevin12345Mc: posts the ante 150
looserGirl27: posts the ante 150
EESTINOKIA: posts the ante 150
josias28: posts the ante 150
omutst: posts the ante 150
realkockie: posts small blind 600
pelelek: posts big blind 1200
*** HOLE CARDS ***
Dealt to Kevin12345Mc [Kc 8s]
Kevin12345Mc: folds 
looserGirl27: folds 
EESTINOKIA: folds 
josias28: raises 2400 to 3600
omutst: folds 
The Heavy Sp: folds 
realkockie: folds 
pelelek: calls 2400
*** FLOP *** [3c As Ac]
pelelek: checks 
josias28: checks 
*** TURN *** [3c As Ac] [Td]
pelelek: checks 
josias28: bets 9000
pelelek: calls 9000
*** RIVER *** [3c As Ac Td] [4h]
pelelek: checks 
josias28: bets 27000
pelelek: folds 
Uncalled bet (27000) returned to josias28
josias28 collected 27000 from pot
josias28: doesn't show hand 
*** SUMMARY ***
Total pot 27000 | Rake 0 
Board [3c As Ac Td 4h]
Seat 1: The Heavy Sp (button) folded before Flop (didn't bet)
Seat 2: realkockie (small blind) folded before Flop
Seat 3: pelelek (big blind) folded on the River
Seat 4: Kevin12345Mc folded before Flop (didn't bet)
Seat 5: looserGirl27 folded before Flop (didn't bet)
Seat 6: EESTINOKIA folded before Flop (didn't bet)
Seat 7: josias28 collected (27000)
Seat 8: omutst folded before Flop (didn't bet)



PokerStars Hand #254673482948: Tournament #3852792524, $4.80+$5.00+$1.20 USD Hold'em No Limit - Level XI (600/1200) - 2025/02/02 18:14:11 WET [2025/02/02 13:14:11 ET]
Table '3852792524 145' 8-max Seat #2 is the button
Seat 1: The Heavy Sp (18700 in chips, $5 bounty) 
Seat 2: realkockie (64945 in chips, $12.50 bounty) 
Seat 3: pelelek (143287 in chips, $10 bounty) 
Seat 4: Kevin12345Mc (30968 in chips, $10 bounty) 
Seat 5: looserGirl27 (39840 in chips, $5 bounty) 
Seat 6: EESTINOKIA (67359 in chips, $10 bounty) 
Seat 7: josias28 (65055 in chips, $5 bounty) 
Seat 8: omutst (32629 in chips, $13.74 bounty) 
The Heavy Sp: posts the ante 150
realkockie: posts the ante 150
pelelek: posts the ante 150
Kevin12345Mc: posts the ante 150
looserGirl27: posts the ante 150
EESTINOKIA: posts the ante 150
josias28: posts the ante 150
omutst: posts the ante 150
pelelek: posts small blind 600
Kevin12345Mc: posts big blind 1200
*** HOLE CARDS ***
Dealt to Kevin12345Mc [4h 9s]
looserGirl27: folds 
EESTINOKIA: folds 
josias28: raises 2400 to 3600
omutst: folds 
The Heavy Sp: folds 
realkockie: folds 
pelelek: folds 
Kevin12345Mc: folds 
Uncalled bet (2400) returned to josias28
josias28 collected 4200 from pot
josias28: doesn't show hand 
*** SUMMARY ***
Total pot 4200 | Rake 0 
Seat 1: The Heavy Sp folded before Flop (didn't bet)
Seat 2: realkockie (button) folded before Flop (didn't bet)
Seat 3: pelelek (small blind) folded before Flop
Seat 4: Kevin12345Mc (big blind) folded before Flop
Seat 5: looserGirl27 folded before Flop (didn't bet)
Seat 6: EESTINOKIA folded before Flop (didn't bet)
Seat 7: josias28 collected (4200)
Seat 8: omutst folded before Flop (didn't bet)



PokerStars Hand #254673494400: Tournament #3852792524, $4.80+$5.00+$1.20 USD Hold'em No Limit - Level XI (600/1200) - 2025/02/02 18:14:45 WET [2025/02/02 13:14:45 ET]
Table '3852792524 145' 8-max Seat #3 is the button
Seat 1: The Heavy Sp (18550 in chips, $5 bounty) 
Seat 2: realkockie (64795 in chips, $12.50 bounty) 
Seat 3: pelelek (142537 in chips, $10 bounty) 
Seat 4: Kevin12345Mc (29618 in chips, $10 bounty) 
Seat 5: looserGirl27 (39690 in chips, $5 bounty) 
Seat 6: EESTINOKIA (67209 in chips, $10 bounty) 
Seat 7: josias28 (67905 in chips, $5 bounty) 
Seat 8: omutst (32479 in chips, $13.74 bounty) 
The Heavy Sp: posts the ante 150
realkockie: posts the ante 150
pelelek: posts the ante 150
Kevin12345Mc: posts the ante 150
looserGirl27: posts the ante 150
EESTINOKIA: posts the ante 150
josias28: posts the ante 150
omutst: posts the ante 150
Kevin12345Mc: posts small blind 600
looserGirl27: posts big blind 1200
*** HOLE CARDS ***
Dealt to Kevin12345Mc [7h As]
EESTINOKIA: folds 
josias28: folds 
omutst: folds 
The Heavy Sp: folds 
realkockie: folds 
pelelek: folds 
Kevin12345Mc: raises 28268 to 29468 and is all-in
looserGirl27: folds 
Uncalled bet (28268) returned to Kevin12345Mc
Kevin12345Mc collected 3600 from pot
Kevin12345Mc: doesn't show hand 
*** SUMMARY ***
Total pot 3600 | Rake 0 
Seat 1: The Heavy Sp folded before Flop (didn't bet)
Seat 2: realkockie folded before Flop (didn't bet)
Seat 3: pelelek (button) folded before Flop (didn't bet)
Seat 4: Kevin12345Mc (small blind) collected (3600)
Seat 5: looserGirl27 (big blind) folded before Flop
Seat 6: EESTINOKIA folded before Flop (didn't bet)
Seat 7: josias28 folded before Flop (didn't bet)
Seat 8: omutst folded before Flop (didn't bet)



PokerStars Hand #254673508556: Tournament #3852792524, $4.80+$5.00+$1.20 USD Hold'em No Limit - Level XII (700/1400) - 2025/02/02 18:15:27 WET [2025/02/02 13:15:27 ET]
Table '3852792524 145' 8-max Seat #4 is the button
Seat 1: The Heavy Sp (18400 in chips, $5 bounty) 
Seat 2: realkockie (64645 in chips, $12.50 bounty) 
Seat 3: pelelek (142387 in chips, $10 bounty) 
Seat 4: Kevin12345Mc (31868 in chips, $10 bounty) 
Seat 5: looserGirl27 (38340 in chips, $5 bounty) 
Seat 6: EESTINOKIA (67059 in chips, $10 bounty) 
Seat 7: josias28 (67755 in chips, $5 bounty) 
Seat 8: omutst (32329 in chips, $13.74 bounty) 
The Heavy Sp: posts the ante 175
realkockie: posts the ante 175
pelelek: posts the ante 175
Kevin12345Mc: posts the ante 175
looserGirl27: posts the ante 175
EESTINOKIA: posts the ante 175
josias28: posts the ante 175
omutst: posts the ante 175
looserGirl27: posts small blind 700
EESTINOKIA: posts big blind 1400
*** HOLE CARDS ***
Dealt to Kevin12345Mc [8h Kc]
josias28: raises 2800 to 4200
omutst: folds 
The Heavy Sp: folds 
realkockie: folds 
pelelek: folds 
Kevin12345Mc: folds 
looserGirl27: folds 
EESTINOKIA: calls 2800
*** FLOP *** [3d 5c Jd]
EESTINOKIA: checks 
josias28: bets 6650
EESTINOKIA: calls 6650
*** TURN *** [3d 5c Jd] [3c]
EESTINOKIA: checks 
josias28: bets 56730 and is all-in
EESTINOKIA: folds 
Uncalled bet (56730) returned to josias28
josias28 collected 23800 from pot
josias28: doesn't show hand 
*** SUMMARY ***
Total pot 23800 | Rake 0 
Board [3d 5c Jd 3c]
Seat 1: The Heavy Sp folded before Flop (didn't bet)
Seat 2: realkockie folded before Flop (didn't bet)
Seat 3: pelelek folded before Flop (didn't bet)
Seat 4: Kevin12345Mc (button) folded before Flop (didn't bet)
Seat 5: looserGirl27 (small blind) folded before Flop
Seat 6: EESTINOKIA (big blind) folded on the Turn
Seat 7: josias28 collected (23800)
Seat 8: omutst folded before Flop (didn't bet)



PokerStars Hand #254673530110: Tournament #3852792524, $4.80+$5.00+$1.20 USD Hold'em No Limit - Level XII (700/1400) - 2025/02/02 18:16:31 WET [2025/02/02 13:16:31 ET]
Table '3852792524 145' 8-max Seat #5 is the button
Seat 1: The Heavy Sp (18225 in chips, $5 bounty) 
Seat 2: realkockie (64470 in chips, $12.50 bounty) 
Seat 3: pelelek (142212 in chips, $10 bounty) 
Seat 4: Kevin12345Mc (31693 in chips, $10 bounty) 
Seat 5: looserGirl27 (37465 in chips, $5 bounty) 
Seat 6: EESTINOKIA (56034 in chips, $10 bounty) 
Seat 7: josias28 (80530 in chips, $5 bounty) 
Seat 8: omutst (32154 in chips, $13.74 bounty) 
The Heavy Sp: posts the ante 175
realkockie: posts the ante 175
pelelek: posts the ante 175
Kevin12345Mc: posts the ante 175
looserGirl27: posts the ante 175
EESTINOKIA: posts the ante 175
josias28: posts the ante 175
omutst: posts the ante 175
EESTINOKIA: posts small blind 700
josias28: posts big blind 1400
*** HOLE CARDS ***
Dealt to Kevin12345Mc [7h Th]
omutst: raises 1400 to 2800
The Heavy Sp: folds 
realkockie: folds 
pelelek: folds 
Kevin12345Mc: folds 
looserGirl27: raises 6300 to 9100
EESTINOKIA: folds 
josias28: folds 
omutst: folds 
Uncalled bet (6300) returned to looserGirl27
looserGirl27 collected 9100 from pot
*** SUMMARY ***
Total pot 9100 | Rake 0 
Seat 1: The Heavy Sp folded before Flop (didn't bet)
Seat 2: realkockie folded before Flop (didn't bet)
Seat 3: pelelek folded before Flop (didn't bet)
Seat 4: Kevin12345Mc folded before Flop (didn't bet)
Seat 5: looserGirl27 (button) collected (9100)
Seat 6: EESTINOKIA (small blind) folded before Flop
Seat 7: josias28 (big blind) folded before Flop
Seat 8: omutst folded before Flop



PokerStars Hand #254673548773: Tournament #3852792524, $4.80+$5.00+$1.20 USD Hold'em No Limit - Level XII (700/1400) - 2025/02/02 18:17:26 WET [2025/02/02 13:17:26 ET]
Table '3852792524 145' 8-max Seat #6 is the button
Seat 1: The Heavy Sp (18050 in chips, $5 bounty) 
Seat 2: realkockie (64295 in chips, $12.50 bounty) 
Seat 3: pelelek (142037 in chips, $10 bounty) 
Seat 4: Kevin12345Mc (31518 in chips, $10 bounty) 
Seat 5: looserGirl27 (43590 in chips, $5 bounty) 
Seat 6: EESTINOKIA (55159 in chips, $10 bounty) 
Seat 7: josias28 (78955 in chips, $5 bounty) 
Seat 8: omutst (29179 in chips, $13.74 bounty) 
The Heavy Sp: posts the ante 175
realkockie: posts the ante 175
pelelek: posts the ante 175
Kevin12345Mc: posts the ante 175
looserGirl27: posts the ante 175
EESTINOKIA: posts the ante 175
josias28: posts the ante 175
omutst: posts the ante 175
josias28: posts small blind 700
omutst: posts big blind 1400
*** HOLE CARDS ***
Dealt to Kevin12345Mc [7c 7s]
The Heavy Sp: folds 
realkockie: folds 
pelelek: folds 
Kevin12345Mc: raises 1540 to 2940
looserGirl27: calls 2940
EESTINOKIA: folds 
josias28: calls 2240
omutst: folds 
*** FLOP *** [Ks Qh 7d]
josias28: checks 
Kevin12345Mc: bets 3835
looserGirl27: folds 
josias28: folds 
Uncalled bet (3835) returned to Kevin12345Mc
Kevin12345Mc collected 11620 from pot
Kevin12345Mc: doesn't show hand 
*** SUMMARY ***
Total pot 11620 | Rake 0 
Board [Ks Qh 7d]
Seat 1: The Heavy Sp folded before Flop (didn't bet)
Seat 2: realkockie folded before Flop (didn't bet)
Seat 3: pelelek folded before Flop (didn't bet)
Seat 4: Kevin12345Mc collected (11620)
Seat 5: looserGirl27 folded on the Flop
Seat 6: EESTINOKIA (button) folded before Flop (didn't bet)
Seat 7: josias28 (small blind) folded on the Flop
Seat 8: omutst (big blind) folded before Flop



PokerStars Hand #254673568759: Tournament #3852792524, $4.80+$5.00+$1.20 USD Hold'em No Limit - Level XII (700/1400) - 2025/02/02 18:18:25 WET [2025/02/02 13:18:25 ET]
Table '3852792524 145' 8-max Seat #7 is the button
Seat 1: The Heavy Sp (17875 in chips, $5 bounty) 
Seat 2: realkockie (64120 in chips, $12.50 bounty) 
Seat 3: pelelek (141862 in chips, $10 bounty) 
Seat 4: Kevin12345Mc (40023 in chips, $10 bounty) 
Seat 5: looserGirl27 (40475 in chips, $5 bounty) 
Seat 6: EESTINOKIA (54984 in chips, $10 bounty) 
Seat 7: josias28 (75840 in chips, $5 bounty) 
Seat 8: omutst (27604 in chips, $13.74 bounty) 
The Heavy Sp: posts the ante 175
realkockie: posts the ante 175
pelelek: posts the ante 175
Kevin12345Mc: posts the ante 175
looserGirl27: posts the ante 175
EESTINOKIA: posts the ante 175
josias28: posts the ante 175
omutst: posts the ante 175
omutst: posts small blind 700
The Heavy Sp: posts big blind 1400
*** HOLE CARDS ***
Dealt to Kevin12345Mc [Jd 8c]
realkockie: folds 
pelelek: folds 
Kevin12345Mc: folds 
looserGirl27: folds 
EESTINOKIA: calls 1400
josias28: calls 1400
omutst: calls 700
The Heavy Sp: checks 
*** FLOP *** [7s 6h 9h]
omutst: checks 
The Heavy Sp: checks 
EESTINOKIA: bets 7000
josias28: calls 7000
omutst: folds 
The Heavy Sp: folds 
*** TURN *** [7s 6h 9h] [Kc]
EESTINOKIA: checks 
josias28: checks 
*** RIVER *** [7s 6h 9h Kc] [Ks]
EESTINOKIA: checks 
josias28: checks 
*** SHOW DOWN ***
EESTINOKIA: shows [Qc Qs] (two pair, Kings and Queens)
josias28: mucks hand 
EESTINOKIA collected 21000 from pot
*** SUMMARY ***
Total pot 21000 | Rake 0 
Board [7s 6h 9h Kc Ks]
Seat 1: The Heavy Sp (big blind) folded on the Flop
Seat 2: realkockie folded before Flop (didn't bet)
Seat 3: pelelek folded before Flop (didn't bet)
Seat 4: Kevin12345Mc folded before Flop (didn't bet)
Seat 5: looserGirl27 folded before Flop (didn't bet)
Seat 6: EESTINOKIA showed [Qc Qs] and won (21000) with two pair, Kings and Queens
Seat 7: josias28 (button) mucked [Ac 7h]
Seat 8: omutst (small blind) folded on the Flop



PokerStars Hand #254673593385: Tournament #3852792524, $4.80+$5.00+$1.20 USD Hold'em No Limit - Level XII (700/1400) - 2025/02/02 18:19:39 WET [2025/02/02 13:19:39 ET]
Table '3852792524 145' 8-max Seat #8 is the button
Seat 1: The Heavy Sp (16300 in chips, $5 bounty) 
Seat 2: realkockie (63945 in chips, $12.50 bounty) 
Seat 3: pelelek (141687 in chips, $10 bounty) 
Seat 4: Kevin12345Mc (39848 in chips, $10 bounty) 
Seat 5: looserGirl27 (40300 in chips, $5 bounty) 
Seat 6: EESTINOKIA (67409 in chips, $10 bounty) 
Seat 7: josias28 (67265 in chips, $5 bounty) 
Seat 8: omutst (26029 in chips, $13.74 bounty) 
The Heavy Sp: posts the ante 175
realkockie: posts the ante 175
pelelek: posts the ante 175
Kevin12345Mc: posts the ante 175
looserGirl27: posts the ante 175
EESTINOKIA: posts the ante 175
josias28: posts the ante 175
omutst: posts the ante 175
The Heavy Sp: posts small blind 700
realkockie: posts big blind 1400
*** HOLE CARDS ***
Dealt to Kevin12345Mc [Qd 8c]
pelelek: folds 
Kevin12345Mc: folds 
looserGirl27: folds 
EESTINOKIA: calls 1400
josias28: raises 1400 to 2800
omutst: raises 8400 to 11200
The Heavy Sp: folds 
realkockie: folds 
EESTINOKIA: folds 
josias28: folds 
Uncalled bet (8400) returned to omutst
omutst collected 10500 from pot
omutst: doesn't show hand 
*** SUMMARY ***
Total pot 10500 | Rake 0 
Seat 1: The Heavy Sp (small blind) folded before Flop
Seat 2: realkockie (big blind) folded before Flop
Seat 3: pelelek folded before Flop (didn't bet)
Seat 4: Kevin12345Mc folded before Flop (didn't bet)
Seat 5: looserGirl27 folded before Flop (didn't bet)
Seat 6: EESTINOKIA folded before Flop
Seat 7: josias28 folded before Flop
Seat 8: omutst (button) collected (10500)



PokerStars Hand #254673608622: Tournament #3852792524, $4.80+$5.00+$1.20 USD Hold'em No Limit - Level XII (700/1400) - 2025/02/02 18:20:24 WET [2025/02/02 13:20:24 ET]
Table '3852792524 145' 8-max Seat #1 is the button
Seat 1: The Heavy Sp (15425 in chips, $5 bounty) 
Seat 2: realkockie (62370 in chips, $12.50 bounty) 
Seat 3: pelelek (141512 in chips, $10 bounty) 
Seat 4: Kevin12345Mc (39673 in chips, $10 bounty) 
Seat 5: looserGirl27 (40125 in chips, $5 bounty) 
Seat 6: EESTINOKIA (65834 in chips, $10 bounty) 
Seat 7: josias28 (64290 in chips, $5 bounty) 
Seat 8: omutst (33554 in chips, $13.74 bounty) 
The Heavy Sp: posts the ante 175
realkockie: posts the ante 175
pelelek: posts the ante 175
Kevin12345Mc: posts the ante 175
looserGirl27: posts the ante 175
EESTINOKIA: posts the ante 175
josias28: posts the ante 175
omutst: posts the ante 175
realkockie: posts small blind 700
pelelek: posts big blind 1400
*** HOLE CARDS ***
Dealt to Kevin12345Mc [4s 6d]
Kevin12345Mc: folds 
looserGirl27: raises 1400 to 2800
EESTINOKIA: folds 
josias28: folds 
omutst: folds 
The Heavy Sp: folds 
realkockie: folds 
pelelek: folds 
Uncalled bet (1400) returned to looserGirl27
looserGirl27 collected 4900 from pot
*** SUMMARY ***
Total pot 4900 | Rake 0 
Seat 1: The Heavy Sp (button) folded before Flop (didn't bet)
Seat 2: realkockie (small blind) folded before Flop
Seat 3: pelelek (big blind) folded before Flop
Seat 4: Kevin12345Mc folded before Flop (didn't bet)
Seat 5: looserGirl27 collected (4900)
Seat 6: EESTINOKIA folded before Flop (didn't bet)
Seat 7: josias28 folded before Flop (didn't bet)
Seat 8: omutst folded before Flop (didn't bet)



PokerStars Hand #254673618360: Tournament #3852792524, $4.80+$5.00+$1.20 USD Hold'em No Limit - Level XII (700/1400) - 2025/02/02 18:20:53 WET [2025/02/02 13:20:53 ET]
Table '3852792524 145' 8-max Seat #2 is the button
Seat 1: The Heavy Sp (15250 in chips, $5 bounty) 
Seat 2: realkockie (61495 in chips, $12.50 bounty) 
Seat 3: pelelek (139937 in chips, $10 bounty) 
Seat 4: Kevin12345Mc (39498 in chips, $10 bounty) 
Seat 5: looserGirl27 (43450 in chips, $5 bounty) 
Seat 6: EESTINOKIA (65659 in chips, $10 bounty) 
Seat 7: josias28 (64115 in chips, $5 bounty) 
Seat 8: omutst (33379 in chips, $13.74 bounty) 
The Heavy Sp: posts the ante 175
realkockie: posts the ante 175
pelelek: posts the ante 175
Kevin12345Mc: posts the ante 175
looserGirl27: posts the ante 175
EESTINOKIA: posts the ante 175
josias28: posts the ante 175
omutst: posts the ante 175
pelelek: posts small blind 700
Kevin12345Mc: posts big blind 1400
*** HOLE CARDS ***
Dealt to Kevin12345Mc [Kd Td]
looserGirl27: folds 
EESTINOKIA: folds 
josias28: folds 
omutst: raises 1680 to 3080
The Heavy Sp: folds 
realkockie: calls 3080
pelelek: folds 
Kevin12345Mc: raises 36243 to 39323 and is all-in
omutst: folds 
realkockie: folds 
Uncalled bet (36243) returned to Kevin12345Mc
Kevin12345Mc collected 11340 from pot
Kevin12345Mc: doesn't show hand 
*** SUMMARY ***
Total pot 11340 | Rake 0 
Seat 1: The Heavy Sp folded before Flop (didn't bet)
Seat 2: realkockie (button) folded before Flop
Seat 3: pelelek (small blind) folded before Flop
Seat 4: Kevin12345Mc (big blind) collected (11340)
Seat 5: looserGirl27 folded before Flop (didn't bet)
Seat 6: EESTINOKIA folded before Flop (didn't bet)
Seat 7: josias28 folded before Flop (didn't bet)
Seat 8: omutst folded before Flop



PokerStars Hand #254673641232: Tournament #3852792524, $4.80+$5.00+$1.20 USD Hold'em No Limit - Level XII (700/1400) - 2025/02/02 18:22:00 WET [2025/02/02 13:22:00 ET]
Table '3852792524 145' 8-max Seat #3 is the button
Seat 1: The Heavy Sp (15075 in chips, $5 bounty) 
Seat 2: realkockie (58240 in chips, $12.50 bounty) 
Seat 3: pelelek (139062 in chips, $10 bounty) 
Seat 4: Kevin12345Mc (47583 in chips, $10 bounty) 
Seat 5: looserGirl27 (43275 in chips, $5 bounty) 
Seat 6: EESTINOKIA (65484 in chips, $10 bounty) 
Seat 7: josias28 (63940 in chips, $5 bounty) 
Seat 8: omutst (30124 in chips, $13.74 bounty) 
The Heavy Sp: posts the ante 175
realkockie: posts the ante 175
pelelek: posts the ante 175
Kevin12345Mc: posts the ante 175
looserGirl27: posts the ante 175
EESTINOKIA: posts the ante 175
josias28: posts the ante 175
omutst: posts the ante 175
Kevin12345Mc: posts small blind 700
looserGirl27: posts big blind 1400
*** HOLE CARDS ***
Dealt to Kevin12345Mc [7d 8d]
EESTINOKIA: calls 1400
josias28: calls 1400
omutst: folds 
The Heavy Sp: raises 2800 to 4200
realkockie: folds 
pelelek: calls 4200
Kevin12345Mc: folds 
looserGirl27: folds 
EESTINOKIA: calls 2800
josias28: calls 2800
*** FLOP *** [8c 3d 8s]
EESTINOKIA: checks 
josias28: checks 
The Heavy Sp: bets 10700 and is all-in
pelelek: calls 10700
EESTINOKIA: folds 
josias28: folds 
*** TURN *** [8c 3d 8s] [Jh]
*** RIVER *** [8c 3d 8s Jh] [5d]
*** SHOW DOWN ***
The Heavy Sp: shows [Kd Ks] (two pair, Kings and Eights)
pelelek: shows [9d 9c] (two pair, Nines and Eights)
The Heavy Sp collected 41700 from pot
*** SUMMARY ***
Total pot 41700 | Rake 0 
Board [8c 3d 8s Jh 5d]
Seat 1: The Heavy Sp showed [Kd Ks] and won (41700) with two pair, Kings and Eights
Seat 2: realkockie folded before Flop (didn't bet)
Seat 3: pelelek (button) showed [9d 9c] and lost with two pair, Nines and Eights
Seat 4: Kevin12345Mc (small blind) folded before Flop
Seat 5: looserGirl27 (big blind) folded before Flop
Seat 6: EESTINOKIA folded on the Flop
Seat 7: josias28 folded on the Flop
Seat 8: omutst folded before Flop (didn't bet)



PokerStars Hand #254673666228: Tournament #3852792524, $4.80+$5.00+$1.20 USD Hold'em No Limit - Level XIII (800/1600) - 2025/02/02 18:23:14 WET [2025/02/02 13:23:14 ET]
Table '3852792524 145' 8-max Seat #4 is the button
Seat 1: The Heavy Sp (41700 in chips, $5 bounty) 
Seat 2: realkockie (58065 in chips, $12.50 bounty) 
Seat 3: pelelek (123987 in chips, $10 bounty) 
Seat 4: Kevin12345Mc (46708 in chips, $10 bounty) 
Seat 5: looserGirl27 (41700 in chips, $5 bounty) 
Seat 6: EESTINOKIA (61109 in chips, $10 bounty) 
Seat 7: josias28 (59565 in chips, $5 bounty) 
Seat 8: omutst (29949 in chips, $13.74 bounty) 
The Heavy Sp: posts the ante 200
realkockie: posts the ante 200
pelelek: posts the ante 200
Kevin12345Mc: posts the ante 200
looserGirl27: posts the ante 200
EESTINOKIA: posts the ante 200
josias28: posts the ante 200
omutst: posts the ante 200
looserGirl27: posts small blind 800
EESTINOKIA: posts big blind 1600
*** HOLE CARDS ***
Dealt to Kevin12345Mc [6c 9c]
josias28: folds 
omutst: folds 
The Heavy Sp: raises 1600 to 3200
realkockie: folds 
pelelek: folds 
Kevin12345Mc: folds 
looserGirl27: folds 
EESTINOKIA: calls 1600
*** FLOP *** [8h Js 7c]
EESTINOKIA: bets 4400
The Heavy Sp: calls 4400
*** TURN *** [8h Js 7c] [Jc]
EESTINOKIA: checks 
The Heavy Sp: bets 4800
EESTINOKIA: calls 4800
*** RIVER *** [8h Js 7c Jc] [3s]
EESTINOKIA: checks 
The Heavy Sp: checks 
*** SHOW DOWN ***
EESTINOKIA: shows [Tc Jh] (three of a kind, Jacks)
The Heavy Sp: mucks hand 
EESTINOKIA collected 27200 from pot
*** SUMMARY ***
Total pot 27200 | Rake 0 
Board [8h Js 7c Jc 3s]
Seat 1: The Heavy Sp mucked [As 7s]
Seat 2: realkockie folded before Flop (didn't bet)
Seat 3: pelelek folded before Flop (didn't bet)
Seat 4: Kevin12345Mc (button) folded before Flop (didn't bet)
Seat 5: looserGirl27 (small blind) folded before Flop
Seat 6: EESTINOKIA (big blind) showed [Tc Jh] and won (27200) with three of a kind, Jacks
Seat 7: josias28 folded before Flop (didn't bet)
Seat 8: omutst folded before Flop (didn't bet)



PokerStars Hand #254673683759: Tournament #3852792524, $4.80+$5.00+$1.20 USD Hold'em No Limit - Level XIII (800/1600) - 2025/02/02 18:24:07 WET [2025/02/02 13:24:07 ET]
Table '3852792524 145' 8-max Seat #5 is the button
Seat 1: The Heavy Sp (29100 in chips, $5 bounty) 
Seat 2: realkockie (57865 in chips, $12.50 bounty) 
Seat 3: pelelek (123787 in chips, $10 bounty) 
Seat 4: Kevin12345Mc (46508 in chips, $10 bounty) 
Seat 5: looserGirl27 (40700 in chips, $5 bounty) 
Seat 6: EESTINOKIA (75709 in chips, $10 bounty) 
Seat 7: josias28 (59365 in chips, $5 bounty) 
Seat 8: omutst (29749 in chips, $13.74 bounty) 
The Heavy Sp: posts the ante 200
realkockie: posts the ante 200
pelelek: posts the ante 200
Kevin12345Mc: posts the ante 200
looserGirl27: posts the ante 200
EESTINOKIA: posts the ante 200
josias28: posts the ante 200
omutst: posts the ante 200
EESTINOKIA: posts small blind 800
josias28: posts big blind 1600
*** HOLE CARDS ***
Dealt to Kevin12345Mc [Ah Ts]
omutst: folds 
The Heavy Sp: folds 
realkockie: folds 
pelelek: folds 
Kevin12345Mc: raises 1760 to 3360
looserGirl27: folds 
EESTINOKIA: folds 
josias28: calls 1760
*** FLOP *** [3d Ks Ad]
josias28: checks 
Kevin12345Mc: bets 3010
josias28: calls 3010
*** TURN *** [3d Ks Ad] [6s]
josias28: checks 
Kevin12345Mc: bets 9992
josias28: calls 9992
*** RIVER *** [3d Ks Ad 6s] [5s]
josias28: checks 
Kevin12345Mc: bets 29946 and is all-in
josias28: folds 
Uncalled bet (29946) returned to Kevin12345Mc
Kevin12345Mc collected 35124 from pot
Kevin12345Mc: doesn't show hand 
*** SUMMARY ***
Total pot 35124 | Rake 0 
Board [3d Ks Ad 6s 5s]
Seat 1: The Heavy Sp folded before Flop (didn't bet)
Seat 2: realkockie folded before Flop (didn't bet)
Seat 3: pelelek folded before Flop (didn't bet)
Seat 4: Kevin12345Mc collected (35124)
Seat 5: looserGirl27 (button) folded before Flop (didn't bet)
Seat 6: EESTINOKIA (small blind) folded before Flop
Seat 7: josias28 (big blind) folded on the River
Seat 8: omutst folded before Flop (didn't bet)



PokerStars Hand #254673702954: Tournament #3852792524, $4.80+$5.00+$1.20 USD Hold'em No Limit - Level XIII (800/1600) - 2025/02/02 18:25:03 WET [2025/02/02 13:25:03 ET]
Table '3852792524 145' 8-max Seat #6 is the button
Seat 1: The Heavy Sp (28900 in chips, $5 bounty) 
Seat 2: realkockie (57665 in chips, $12.50 bounty) 
Seat 3: pelelek (123587 in chips, $10 bounty) 
Seat 4: Kevin12345Mc (65070 in chips, $10 bounty) 
Seat 5: looserGirl27 (40500 in chips, $5 bounty) 
Seat 6: EESTINOKIA (74709 in chips, $10 bounty) 
Seat 7: josias28 (42803 in chips, $5 bounty) 
Seat 8: omutst (29549 in chips, $13.74 bounty) 
The Heavy Sp: posts the ante 200
realkockie: posts the ante 200
pelelek: posts the ante 200
Kevin12345Mc: posts the ante 200
looserGirl27: posts the ante 200
EESTINOKIA: posts the ante 200
josias28: posts the ante 200
omutst: posts the ante 200
josias28: posts small blind 800
omutst: posts big blind 1600
*** HOLE CARDS ***
Dealt to Kevin12345Mc [5s 5h]
The Heavy Sp: calls 1600
realkockie: folds 
pelelek: folds 
Kevin12345Mc: calls 1600
looserGirl27: folds 
EESTINOKIA: folds 
josias28: raises 41003 to 42603 and is all-in
omutst: folds 
The Heavy Sp: calls 27100 and is all-in
Kevin12345Mc: folds 
Uncalled bet (13903) returned to josias28
*** FLOP *** [Ts As Tc]
*** TURN *** [Ts As Tc] [Qs]
*** RIVER *** [Ts As Tc Qs] [8c]
*** SHOW DOWN ***
josias28: shows [2h 2d] (two pair, Tens and Deuces)
The Heavy Sp: shows [9d Ad] (two pair, Aces and Tens)
The Heavy Sp collected 62200 from pot
*** SUMMARY ***
Total pot 62200 | Rake 0 
Board [Ts As Tc Qs 8c]
Seat 1: The Heavy Sp showed [9d Ad] and won (62200) with two pair, Aces and Tens
Seat 2: realkockie folded before Flop (didn't bet)
Seat 3: pelelek folded before Flop (didn't bet)
Seat 4: Kevin12345Mc folded before Flop
Seat 5: looserGirl27 folded before Flop (didn't bet)
Seat 6: EESTINOKIA (button) folded before Flop (didn't bet)
Seat 7: josias28 (small blind) showed [2h 2d] and lost with two pair, Tens and Deuces
Seat 8: omutst (big blind) folded before Flop



PokerStars Hand #254673722490: Tournament #3852792524, $4.80+$5.00+$1.20 USD Hold'em No Limit - Level XIII (800/1600) - 2025/02/02 18:25:59 WET [2025/02/02 13:25:59 ET]
Table '3852792524 145' 8-max Seat #7 is the button
Seat 1: The Heavy Sp (62200 in chips, $5 bounty) 
Seat 2: realkockie (57465 in chips, $12.50 bounty) 
Seat 3: pelelek (123387 in chips, $10 bounty) 
Seat 4: Kevin12345Mc (63270 in chips, $10 bounty) 
Seat 5: looserGirl27 (40300 in chips, $5 bounty) 
Seat 6: EESTINOKIA (74509 in chips, $10 bounty) 
Seat 7: josias28 (13903 in chips, $5 bounty) 
Seat 8: omutst (27749 in chips, $13.74 bounty) 
The Heavy Sp: posts the ante 200
realkockie: posts the ante 200
pelelek: posts the ante 200
Kevin12345Mc: posts the ante 200
looserGirl27: posts the ante 200
EESTINOKIA: posts the ante 200
josias28: posts the ante 200
omutst: posts the ante 200
omutst: posts small blind 800
The Heavy Sp: posts big blind 1600
*** HOLE CARDS ***
Dealt to Kevin12345Mc [3d 4s]
realkockie: folds 
pelelek: raises 1920 to 3520
Kevin12345Mc: folds 
looserGirl27: folds 
EESTINOKIA: folds 
josias28: folds 
omutst: folds 
The Heavy Sp: calls 1920
*** FLOP *** [2d Qs 5d]
The Heavy Sp: checks 
pelelek: bets 3200
The Heavy Sp: folds 
Uncalled bet (3200) returned to pelelek
pelelek collected 9440 from pot
pelelek: doesn't show hand 
*** SUMMARY ***
Total pot 9440 | Rake 0 
Board [2d Qs 5d]
Seat 1: The Heavy Sp (big blind) folded on the Flop
Seat 2: realkockie folded before Flop (didn't bet)
Seat 3: pelelek collected (9440)
Seat 4: Kevin12345Mc folded before Flop (didn't bet)
Seat 5: looserGirl27 folded before Flop (didn't bet)
Seat 6: EESTINOKIA folded before Flop (didn't bet)
Seat 7: josias28 (button) folded before Flop (didn't bet)
Seat 8: omutst (small blind) folded before Flop



PokerStars Hand #254673741282: Tournament #3852792524, $4.80+$5.00+$1.20 USD Hold'em No Limit - Level XIII (800/1600) - 2025/02/02 18:26:54 WET [2025/02/02 13:26:54 ET]
Table '3852792524 145' 8-max Seat #8 is the button
Seat 1: The Heavy Sp (58480 in chips, $5 bounty) 
Seat 2: realkockie (57265 in chips, $12.50 bounty) 
Seat 3: pelelek (129107 in chips, $10 bounty) 
Seat 4: Kevin12345Mc (63070 in chips, $10 bounty) 
Seat 5: looserGirl27 (40100 in chips, $5 bounty) 
Seat 6: EESTINOKIA (74309 in chips, $10 bounty) 
Seat 7: josias28 (13703 in chips, $5 bounty) 
Seat 8: omutst (26749 in chips, $13.74 bounty) 
The Heavy Sp: posts the ante 200
realkockie: posts the ante 200
pelelek: posts the ante 200
Kevin12345Mc: posts the ante 200
looserGirl27: posts the ante 200
EESTINOKIA: posts the ante 200
josias28: posts the ante 200
omutst: posts the ante 200
The Heavy Sp: posts small blind 800
realkockie: posts big blind 1600
*** HOLE CARDS ***
Dealt to Kevin12345Mc [8d 5d]
pelelek: folds 
Kevin12345Mc: folds 
looserGirl27: folds 
EESTINOKIA: folds 
josias28: raises 1600 to 3200
omutst: folds 
The Heavy Sp: calls 2400
realkockie: calls 1600
*** FLOP *** [8c Jh 4s]
The Heavy Sp: checks 
realkockie: checks 
josias28: bets 4800
The Heavy Sp: folds 
realkockie: calls 4800
*** TURN *** [8c Jh 4s] [3c]
realkockie: checks 
josias28: checks 
*** RIVER *** [8c Jh 4s 3c] [Td]
realkockie: bets 20800
josias28: folds 
Uncalled bet (20800) returned to realkockie
realkockie collected 20800 from pot
*** SUMMARY ***
Total pot 20800 | Rake 0 
Board [8c Jh 4s 3c Td]
Seat 1: The Heavy Sp (small blind) folded on the Flop
Seat 2: realkockie (big blind) collected (20800)
Seat 3: pelelek folded before Flop (didn't bet)
Seat 4: Kevin12345Mc folded before Flop (didn't bet)
Seat 5: looserGirl27 folded before Flop (didn't bet)
Seat 6: EESTINOKIA folded before Flop (didn't bet)
Seat 7: josias28 folded on the River
Seat 8: omutst (button) folded before Flop (didn't bet)



PokerStars Hand #254673756957: Tournament #3852792524, $4.80+$5.00+$1.20 USD Hold'em No Limit - Level XIII (800/1600) - 2025/02/02 18:27:40 WET [2025/02/02 13:27:40 ET]
Table '3852792524 145' 8-max Seat #1 is the button
Seat 1: The Heavy Sp (55080 in chips, $5 bounty) 
Seat 2: realkockie (69865 in chips, $12.50 bounty) 
Seat 3: pelelek (128907 in chips, $10 bounty) 
Seat 4: Kevin12345Mc (62870 in chips, $10 bounty) 
Seat 5: looserGirl27 (39900 in chips, $5 bounty) 
Seat 6: EESTINOKIA (74109 in chips, $10 bounty) 
Seat 7: josias28 (5503 in chips, $5 bounty) 
Seat 8: omutst (26549 in chips, $13.74 bounty) 
The Heavy Sp: posts the ante 200
realkockie: posts the ante 200
pelelek: posts the ante 200
Kevin12345Mc: posts the ante 200
looserGirl27: posts the ante 200
EESTINOKIA: posts the ante 200
josias28: posts the ante 200
omutst: posts the ante 200
realkockie: posts small blind 800
pelelek: posts big blind 1600
*** HOLE CARDS ***
Dealt to Kevin12345Mc [5h 7h]
Kevin12345Mc: folds 
looserGirl27: raises 1600 to 3200
EESTINOKIA: folds 
josias28: raises 2103 to 5303 and is all-in
omutst: folds 
The Heavy Sp: folds 
realkockie: folds 
pelelek: folds 
looserGirl27: calls 2103
*** FLOP *** [6d Qh Ks]
*** TURN *** [6d Qh Ks] [2d]
*** RIVER *** [6d Qh Ks 2d] [3s]
*** SHOW DOWN ***
looserGirl27: shows [Ah Kc] (a pair of Kings)
josias28: shows [Tc Th] (a pair of Tens)
looserGirl27 collected 14606 from pot
looserGirl27 wins $2.50 for eliminating josias28 and their own bounty increases by $2.50 to $7.50
josias28 finished the tournament
*** SUMMARY ***
Total pot 14606 | Rake 0 
Board [6d Qh Ks 2d 3s]
Seat 1: The Heavy Sp (button) folded before Flop (didn't bet)
Seat 2: realkockie (small blind) folded before Flop
Seat 3: pelelek (big blind) folded before Flop
Seat 4: Kevin12345Mc folded before Flop (didn't bet)
Seat 5: looserGirl27 showed [Ah Kc] and won (14606) with a pair of Kings
Seat 6: EESTINOKIA folded before Flop (didn't bet)
Seat 7: josias28 showed [Tc Th] and lost with a pair of Tens
Seat 8: omutst folded before Flop (didn't bet)



PokerStars Hand #254673767389: Tournament #3852792524, $4.80+$5.00+$1.20 USD Hold'em No Limit - Level XIII (800/1600) - 2025/02/02 18:28:11 WET [2025/02/02 13:28:11 ET]
Table '3852792524 145' 8-max Seat #2 is the button
Seat 1: The Heavy Sp (54880 in chips, $5 bounty) 
Seat 2: realkockie (68865 in chips, $12.50 bounty) 
Seat 3: pelelek (127107 in chips, $10 bounty) 
Seat 4: Kevin12345Mc (62670 in chips, $10 bounty) 
Seat 5: looserGirl27 (49003 in chips, $7.50 bounty) 
Seat 6: EESTINOKIA (73909 in chips, $10 bounty) 
Seat 7: louisklaassen (95893 in chips, $6.25 bounty) 
Seat 8: omutst (26349 in chips, $13.74 bounty) 
The Heavy Sp: posts the ante 200
realkockie: posts the ante 200
pelelek: posts the ante 200
Kevin12345Mc: posts the ante 200
looserGirl27: posts the ante 200
EESTINOKIA: posts the ante 200
louisklaassen: posts the ante 200
omutst: posts the ante 200
pelelek: posts small blind 800
Kevin12345Mc: posts big blind 1600
*** HOLE CARDS ***
Dealt to Kevin12345Mc [Ah 6c]
looserGirl27: folds 
EESTINOKIA: folds 
louisklaassen: calls 1600
omutst: folds 
The Heavy Sp: folds 
realkockie: calls 1600
pelelek: calls 800
Kevin12345Mc: checks 
*** FLOP *** [Jd 9h 6d]
pelelek: checks 
Kevin12345Mc: checks 
louisklaassen: checks 
realkockie: bets 2400
pelelek: raises 4480 to 6880
Kevin12345Mc: folds 
louisklaassen: folds 
realkockie: folds 
Uncalled bet (4480) returned to pelelek
pelelek collected 12800 from pot
pelelek: doesn't show hand 
*** SUMMARY ***
Total pot 12800 | Rake 0 
Board [Jd 9h 6d]
Seat 1: The Heavy Sp folded before Flop (didn't bet)
Seat 2: realkockie (button) folded on the Flop
Seat 3: pelelek (small blind) collected (12800)
Seat 4: Kevin12345Mc (big blind) folded on the Flop
Seat 5: looserGirl27 folded before Flop (didn't bet)
Seat 6: EESTINOKIA folded before Flop (didn't bet)
Seat 7: louisklaassen folded on the Flop
Seat 8: omutst folded before Flop (didn't bet)



PokerStars Hand #254673799620: Tournament #3852792524, $4.80+$5.00+$1.20 USD Hold'em No Limit - Level XIII (800/1600) - 2025/02/02 18:29:45 WET [2025/02/02 13:29:45 ET]
Table '3852792524 145' 8-max Seat #3 is the button
Seat 1: The Heavy Sp (54680 in chips, $5 bounty) 
Seat 2: realkockie (64665 in chips, $12.50 bounty) 
Seat 3: pelelek (135707 in chips, $10 bounty) 
Seat 4: Kevin12345Mc (60870 in chips, $10 bounty) 
Seat 5: looserGirl27 (48803 in chips, $7.50 bounty) 
Seat 6: EESTINOKIA (73709 in chips, $10 bounty) 
Seat 7: louisklaassen (94093 in chips, $6.25 bounty) 
Seat 8: omutst (26149 in chips, $13.74 bounty) 
The Heavy Sp: posts the ante 200
realkockie: posts the ante 200
pelelek: posts the ante 200
Kevin12345Mc: posts the ante 200
looserGirl27: posts the ante 200
EESTINOKIA: posts the ante 200
louisklaassen: posts the ante 200
omutst: posts the ante 200
Kevin12345Mc: posts small blind 800
looserGirl27: posts big blind 1600
*** HOLE CARDS ***
Dealt to Kevin12345Mc [Jh 6c]
EESTINOKIA: calls 1600
louisklaassen: folds 
omutst: raises 24349 to 25949 and is all-in
The Heavy Sp: folds 
realkockie: folds 
pelelek: folds 
Kevin12345Mc: folds 
looserGirl27: folds 
EESTINOKIA: calls 24349
*** FLOP *** [6h 5s Ks]
*** TURN *** [6h 5s Ks] [Js]
*** RIVER *** [6h 5s Ks Js] [7d]
*** SHOW DOWN ***
EESTINOKIA: shows [Ac Jc] (a pair of Jacks)
omutst: shows [Th Tc] (a pair of Tens)
EESTINOKIA collected 55898 from pot
EESTINOKIA wins $6.87 for eliminating omutst and their own bounty increases by $6.87 to $16.87
omutst finished the tournament
*** SUMMARY ***
Total pot 55898 | Rake 0 
Board [6h 5s Ks Js 7d]
Seat 1: The Heavy Sp folded before Flop (didn't bet)
Seat 2: realkockie folded before Flop (didn't bet)
Seat 3: pelelek (button) folded before Flop (didn't bet)
Seat 4: Kevin12345Mc (small blind) folded before Flop
Seat 5: looserGirl27 (big blind) folded before Flop
Seat 6: EESTINOKIA showed [Ac Jc] and won (55898) with a pair of Jacks
Seat 7: louisklaassen folded before Flop (didn't bet)
Seat 8: omutst showed [Th Tc] and lost with a pair of Tens



PokerStars Hand #254673823038: Tournament #3852792524, $4.80+$5.00+$1.20 USD Hold'em No Limit - Level XIII (800/1600) - 2025/02/02 18:30:52 WET [2025/02/02 13:30:52 ET]
Table '3852792524 145' 8-max Seat #4 is the button
Seat 1: The Heavy Sp (54480 in chips, $5 bounty) 
Seat 2: realkockie (64465 in chips, $12.50 bounty) 
Seat 3: pelelek (135507 in chips, $10 bounty) 
Seat 4: Kevin12345Mc (59870 in chips, $10 bounty) 
Seat 5: looserGirl27 (47003 in chips, $7.50 bounty) 
Seat 6: EESTINOKIA (103458 in chips, $16.87 bounty) 
Seat 7: louisklaassen (93893 in chips, $6.25 bounty) 
Seat 8: scuba1690 (141620 in chips, $11.25 bounty) 
The Heavy Sp: posts the ante 200
realkockie: posts the ante 200
pelelek: posts the ante 200
Kevin12345Mc: posts the ante 200
looserGirl27: posts the ante 200
EESTINOKIA: posts the ante 200
louisklaassen: posts the ante 200
scuba1690: posts the ante 200
looserGirl27: posts small blind 800
EESTINOKIA: posts big blind 1600
*** HOLE CARDS ***
Dealt to Kevin12345Mc [5d Ks]
louisklaassen: raises 1600 to 3200
scuba1690: folds 
The Heavy Sp: folds 
realkockie: folds 
pelelek: folds 
Kevin12345Mc: folds 
looserGirl27: folds 
EESTINOKIA: calls 1600
*** FLOP *** [3s Qc 6d]
EESTINOKIA: checks 
louisklaassen: bets 3200
EESTINOKIA: calls 3200
*** TURN *** [3s Qc 6d] [7d]
EESTINOKIA: checks 
louisklaassen: checks 
*** RIVER *** [3s Qc 6d 7d] [9c]
EESTINOKIA: checks 
louisklaassen: checks 
*** SHOW DOWN ***
EESTINOKIA: shows [5c 6c] (a pair of Sixes)
louisklaassen: mucks hand 
EESTINOKIA collected 15200 from pot
*** SUMMARY ***
Total pot 15200 | Rake 0 
Board [3s Qc 6d 7d 9c]
Seat 1: The Heavy Sp folded before Flop (didn't bet)
Seat 2: realkockie folded before Flop (didn't bet)
Seat 3: pelelek folded before Flop (didn't bet)
Seat 4: Kevin12345Mc (button) folded before Flop (didn't bet)
Seat 5: looserGirl27 (small blind) folded before Flop
Seat 6: EESTINOKIA (big blind) showed [5c 6c] and won (15200) with a pair of Sixes
Seat 7: louisklaassen mucked [Ah Kc]
Seat 8: scuba1690 folded before Flop (didn't bet)



PokerStars Hand #254673843041: Tournament #3852792524, $4.80+$5.00+$1.20 USD Hold'em No Limit - Level XIV (1000/2000) - 2025/02/02 18:31:51 WET [2025/02/02 13:31:51 ET]
Table '3852792524 145' 8-max Seat #5 is the button
Seat 1: The Heavy Sp (54280 in chips, $5 bounty) 
Seat 2: realkockie (64265 in chips, $12.50 bounty) 
Seat 3: pelelek (135307 in chips, $10 bounty) 
Seat 4: Kevin12345Mc (59670 in chips, $10 bounty) 
Seat 5: looserGirl27 (46003 in chips, $7.50 bounty) 
Seat 6: EESTINOKIA (112058 in chips, $16.87 bounty) 
Seat 7: louisklaassen (87293 in chips, $6.25 bounty) 
Seat 8: scuba1690 (141420 in chips, $11.25 bounty) 
The Heavy Sp: posts the ante 250
realkockie: posts the ante 250
pelelek: posts the ante 250
Kevin12345Mc: posts the ante 250
looserGirl27: posts the ante 250
EESTINOKIA: posts the ante 250
louisklaassen: posts the ante 250
scuba1690: posts the ante 250
EESTINOKIA: posts small blind 1000
louisklaassen: posts big blind 2000
*** HOLE CARDS ***
Dealt to Kevin12345Mc [8h 6c]
scuba1690: calls 2000
The Heavy Sp: folds 
realkockie: folds 
pelelek: folds 
Kevin12345Mc: folds 
looserGirl27: raises 4000 to 6000
EESTINOKIA: folds 
louisklaassen: calls 4000
scuba1690: calls 4000
*** FLOP *** [Kh 7h As]
louisklaassen: checks 
scuba1690: checks 
looserGirl27: bets 9000
louisklaassen: folds 
scuba1690: calls 9000
*** TURN *** [Kh 7h As] [Ad]
scuba1690: checks 
looserGirl27: checks 
*** RIVER *** [Kh 7h As Ad] [9c]
scuba1690: checks 
looserGirl27: bets 24000
scuba1690: folds 
Uncalled bet (24000) returned to looserGirl27
looserGirl27 collected 39000 from pot
*** SUMMARY ***
Total pot 39000 | Rake 0 
Board [Kh 7h As Ad 9c]
Seat 1: The Heavy Sp folded before Flop (didn't bet)
Seat 2: realkockie folded before Flop (didn't bet)
Seat 3: pelelek folded before Flop (didn't bet)
Seat 4: Kevin12345Mc folded before Flop (didn't bet)
Seat 5: looserGirl27 (button) collected (39000)
Seat 6: EESTINOKIA (small blind) folded before Flop
Seat 7: louisklaassen (big blind) folded on the Flop
Seat 8: scuba1690 folded on the River



PokerStars Hand #254673877980: Tournament #3852792524, $4.80+$5.00+$1.20 USD Hold'em No Limit - Level XIV (1000/2000) - 2025/02/02 18:33:31 WET [2025/02/02 13:33:31 ET]
Table '3852792524 145' 8-max Seat #6 is the button
Seat 1: The Heavy Sp (54030 in chips, $5 bounty) 
Seat 2: realkockie (64015 in chips, $12.50 bounty) 
Seat 3: pelelek (135057 in chips, $10 bounty) 
Seat 4: Kevin12345Mc (59420 in chips, $10 bounty) 
Seat 5: looserGirl27 (69753 in chips, $7.50 bounty) 
Seat 6: EESTINOKIA (110808 in chips, $16.87 bounty) 
Seat 7: louisklaassen (81043 in chips, $6.25 bounty) 
Seat 8: scuba1690 (126170 in chips, $11.25 bounty) 
The Heavy Sp: posts the ante 250
realkockie: posts the ante 250
pelelek: posts the ante 250
Kevin12345Mc: posts the ante 250
looserGirl27: posts the ante 250
EESTINOKIA: posts the ante 250
louisklaassen: posts the ante 250
scuba1690: posts the ante 250
louisklaassen: posts small blind 1000
scuba1690: posts big blind 2000
*** HOLE CARDS ***
Dealt to Kevin12345Mc [6h Qs]
The Heavy Sp: folds 
realkockie: folds 
pelelek: folds 
Kevin12345Mc: folds 
looserGirl27: folds 
EESTINOKIA: folds 
louisklaassen: folds 
Uncalled bet (1000) returned to scuba1690
scuba1690 collected 4000 from pot
*** SUMMARY ***
Total pot 4000 | Rake 0 
Seat 1: The Heavy Sp folded before Flop (didn't bet)
Seat 2: realkockie folded before Flop (didn't bet)
Seat 3: pelelek folded before Flop (didn't bet)
Seat 4: Kevin12345Mc folded before Flop (didn't bet)
Seat 5: looserGirl27 folded before Flop (didn't bet)
Seat 6: EESTINOKIA (button) folded before Flop (didn't bet)
Seat 7: louisklaassen (small blind) folded before Flop
Seat 8: scuba1690 (big blind) collected (4000)



PokerStars Hand #254673885360: Tournament #3852792524, $4.80+$5.00+$1.20 USD Hold'em No Limit - Level XIV (1000/2000) - 2025/02/02 18:33:52 WET [2025/02/02 13:33:52 ET]
Table '3852792524 145' 8-max Seat #7 is the button
Seat 1: The Heavy Sp (53780 in chips, $5 bounty) 
Seat 2: realkockie (63765 in chips, $12.50 bounty) 
Seat 3: pelelek (134807 in chips, $10 bounty) 
Seat 4: Kevin12345Mc (59170 in chips, $10 bounty) 
Seat 5: looserGirl27 (69503 in chips, $7.50 bounty) 
Seat 6: EESTINOKIA (110558 in chips, $16.87 bounty) 
Seat 7: louisklaassen (79793 in chips, $6.25 bounty) 
Seat 8: scuba1690 (128920 in chips, $11.25 bounty) 
The Heavy Sp: posts the ante 250
realkockie: posts the ante 250
pelelek: posts the ante 250
Kevin12345Mc: posts the ante 250
looserGirl27: posts the ante 250
EESTINOKIA: posts the ante 250
louisklaassen: posts the ante 250
scuba1690: posts the ante 250
scuba1690: posts small blind 1000
The Heavy Sp: posts big blind 2000
*** HOLE CARDS ***
Dealt to Kevin12345Mc [Td 7s]
realkockie: folds 
pelelek: folds 
Kevin12345Mc: folds 
looserGirl27: raises 2000 to 4000
EESTINOKIA: calls 4000
louisklaassen: folds 
scuba1690: calls 3000
The Heavy Sp: folds 
*** FLOP *** [Kd 7h 8d]
scuba1690: checks 
looserGirl27: checks 
EESTINOKIA: checks 
*** TURN *** [Kd 7h 8d] [Qd]
scuba1690: checks 
looserGirl27: checks 
EESTINOKIA: checks 
*** RIVER *** [Kd 7h 8d Qd] [Jd]
scuba1690: bets 4000
looserGirl27: folds 
EESTINOKIA: folds 
Uncalled bet (4000) returned to scuba1690
scuba1690 collected 16000 from pot
*** SUMMARY ***
Total pot 16000 | Rake 0 
Board [Kd 7h 8d Qd Jd]
Seat 1: The Heavy Sp (big blind) folded before Flop
Seat 2: realkockie folded before Flop (didn't bet)
Seat 3: pelelek folded before Flop (didn't bet)
Seat 4: Kevin12345Mc folded before Flop (didn't bet)
Seat 5: looserGirl27 folded on the River
Seat 6: EESTINOKIA folded on the River
Seat 7: louisklaassen (button) folded before Flop (didn't bet)
Seat 8: scuba1690 (small blind) collected (16000)



PokerStars Hand #254673909098: Tournament #3852792524, $4.80+$5.00+$1.20 USD Hold'em No Limit - Level XIV (1000/2000) - 2025/02/02 18:35:00 WET [2025/02/02 13:35:00 ET]
Table '3852792524 145' 8-max Seat #8 is the button
Seat 1: The Heavy Sp (51530 in chips, $5 bounty) 
Seat 2: realkockie (63515 in chips, $12.50 bounty) 
Seat 3: pelelek (134557 in chips, $10 bounty) 
Seat 4: Kevin12345Mc (58920 in chips, $10 bounty) 
Seat 5: looserGirl27 (65253 in chips, $7.50 bounty) 
Seat 6: EESTINOKIA (106308 in chips, $16.87 bounty) 
Seat 7: louisklaassen (79543 in chips, $6.25 bounty) 
Seat 8: scuba1690 (140670 in chips, $11.25 bounty) 
The Heavy Sp: posts the ante 250
realkockie: posts the ante 250
pelelek: posts the ante 250
Kevin12345Mc: posts the ante 250
looserGirl27: posts the ante 250
EESTINOKIA: posts the ante 250
louisklaassen: posts the ante 250
scuba1690: posts the ante 250
The Heavy Sp: posts small blind 1000
realkockie: posts big blind 2000
*** HOLE CARDS ***
Dealt to Kevin12345Mc [4d Qh]
pelelek: folds 
Kevin12345Mc: folds 
looserGirl27: folds 
EESTINOKIA: folds 
louisklaassen: folds 
scuba1690 is disconnected 
scuba1690 has timed out while disconnected
scuba1690: folds 
scuba1690 is sitting out
The Heavy Sp: calls 1000
realkockie: raises 5000 to 7000
The Heavy Sp: calls 5000
*** FLOP *** [3c 9d As]
The Heavy Sp: checks 
realkockie: bets 8000
The Heavy Sp: calls 8000
*** TURN *** [3c 9d As] [Tc]
The Heavy Sp: checks 
realkockie: checks 
*** RIVER *** [3c 9d As Tc] [8d]
The Heavy Sp: bets 12000
scuba1690 is disconnected 
scuba1690 has returned
realkockie: folds 
Uncalled bet (12000) returned to The Heavy Sp
The Heavy Sp collected 32000 from pot
*** SUMMARY ***
Total pot 32000 | Rake 0 
Board [3c 9d As Tc 8d]
Seat 1: The Heavy Sp (small blind) collected (32000)
Seat 2: realkockie (big blind) folded on the River
Seat 3: pelelek folded before Flop (didn't bet)
Seat 4: Kevin12345Mc folded before Flop (didn't bet)
Seat 5: looserGirl27 folded before Flop (didn't bet)
Seat 6: EESTINOKIA folded before Flop (didn't bet)
Seat 7: louisklaassen folded before Flop (didn't bet)
Seat 8: scuba1690 (button) folded before Flop (didn't bet)



PokerStars Hand #254673935231: Tournament #3852792524, $4.80+$5.00+$1.20 USD Hold'em No Limit - Level XIV (1000/2000) - 2025/02/02 18:36:14 WET [2025/02/02 13:36:14 ET]
Table '3852792524 145' 8-max Seat #1 is the button
Seat 1: The Heavy Sp (68280 in chips, $5 bounty) 
Seat 2: realkockie (48265 in chips, $12.50 bounty) 
Seat 3: pelelek (134307 in chips, $10 bounty) 
Seat 4: Kevin12345Mc (58670 in chips, $10 bounty) 
Seat 5: looserGirl27 (65003 in chips, $7.50 bounty) 
Seat 6: EESTINOKIA (106058 in chips, $16.87 bounty) 
Seat 7: louisklaassen (79293 in chips, $6.25 bounty) 
Seat 8: scuba1690 (140420 in chips, $11.25 bounty) 
The Heavy Sp: posts the ante 250
realkockie: posts the ante 250
pelelek: posts the ante 250
Kevin12345Mc: posts the ante 250
looserGirl27: posts the ante 250
EESTINOKIA: posts the ante 250
louisklaassen: posts the ante 250
scuba1690: posts the ante 250
realkockie: posts small blind 1000
pelelek: posts big blind 2000
*** HOLE CARDS ***
Dealt to Kevin12345Mc [Ac 7c]
Kevin12345Mc: raises 2200 to 4200
looserGirl27: folds 
EESTINOKIA: folds 
louisklaassen: calls 4200
scuba1690: calls 4200
The Heavy Sp: folds 
realkockie: folds 
pelelek: folds 
*** FLOP *** [3c Ks Ah]
Kevin12345Mc: bets 5808
louisklaassen: calls 5808
scuba1690: folds 
*** TURN *** [3c Ks Ah] [6s]
Kevin12345Mc: bets 19283
louisklaassen: folds 
Uncalled bet (19283) returned to Kevin12345Mc
Kevin12345Mc collected 29216 from pot
Kevin12345Mc: doesn't show hand 
*** SUMMARY ***
Total pot 29216 | Rake 0 
Board [3c Ks Ah 6s]
Seat 1: The Heavy Sp (button) folded before Flop (didn't bet)
Seat 2: realkockie (small blind) folded before Flop
Seat 3: pelelek (big blind) folded before Flop
Seat 4: Kevin12345Mc collected (29216)
Seat 5: looserGirl27 folded before Flop (didn't bet)
Seat 6: EESTINOKIA folded before Flop (didn't bet)
Seat 7: louisklaassen folded on the Turn
Seat 8: scuba1690 folded on the Flop



PokerStars Hand #254673950242: Tournament #3852792524, $4.80+$5.00+$1.20 USD Hold'em No Limit - Level XIV (1000/2000) - 2025/02/02 18:36:57 WET [2025/02/02 13:36:57 ET]
Table '3852792524 145' 8-max Seat #2 is the button
Seat 1: The Heavy Sp (68030 in chips, $5 bounty) 
Seat 2: realkockie (47015 in chips, $12.50 bounty) 
Seat 3: pelelek (132057 in chips, $10 bounty) 
Seat 4: Kevin12345Mc (77628 in chips, $10 bounty) 
Seat 5: looserGirl27 (64753 in chips, $7.50 bounty) 
Seat 6: EESTINOKIA (105808 in chips, $16.87 bounty) 
Seat 7: louisklaassen (69035 in chips, $6.25 bounty) 
Seat 8: scuba1690 (135970 in chips, $11.25 bounty) 
The Heavy Sp: posts the ante 250
realkockie: posts the ante 250
pelelek: posts the ante 250
Kevin12345Mc: posts the ante 250
looserGirl27: posts the ante 250
EESTINOKIA: posts the ante 250
louisklaassen: posts the ante 250
scuba1690: posts the ante 250
pelelek: posts small blind 1000
Kevin12345Mc: posts big blind 2000
*** HOLE CARDS ***
Dealt to Kevin12345Mc [3c 2d]
looserGirl27: folds 
EESTINOKIA: folds 
louisklaassen: folds 
scuba1690: folds 
The Heavy Sp: folds 
realkockie: raises 2400 to 4400
pelelek: folds 
Kevin12345Mc: folds 
Uncalled bet (2400) returned to realkockie
realkockie collected 7000 from pot
*** SUMMARY ***
Total pot 7000 | Rake 0 
Seat 1: The Heavy Sp folded before Flop (didn't bet)
Seat 2: realkockie (button) collected (7000)
Seat 3: pelelek (small blind) folded before Flop
Seat 4: Kevin12345Mc (big blind) folded before Flop
Seat 5: looserGirl27 folded before Flop (didn't bet)
Seat 6: EESTINOKIA folded before Flop (didn't bet)
Seat 7: louisklaassen folded before Flop (didn't bet)
Seat 8: scuba1690 folded before Flop (didn't bet)



PokerStars Hand #254673961957: Tournament #3852792524, $4.80+$5.00+$1.20 USD Hold'em No Limit - Level XIV (1000/2000) - 2025/02/02 18:37:30 WET [2025/02/02 13:37:30 ET]
Table '3852792524 145' 8-max Seat #3 is the button
Seat 1: The Heavy Sp (67780 in chips, $5 bounty) 
Seat 2: realkockie (51765 in chips, $12.50 bounty) 
Seat 3: pelelek (130807 in chips, $10 bounty) 
Seat 4: Kevin12345Mc (75378 in chips, $10 bounty) 
Seat 5: looserGirl27 (64503 in chips, $7.50 bounty) 
Seat 6: EESTINOKIA (105558 in chips, $16.87 bounty) 
Seat 7: louisklaassen (68785 in chips, $6.25 bounty) 
Seat 8: scuba1690 (135720 in chips, $11.25 bounty) 
The Heavy Sp: posts the ante 250
realkockie: posts the ante 250
pelelek: posts the ante 250
Kevin12345Mc: posts the ante 250
looserGirl27: posts the ante 250
EESTINOKIA: posts the ante 250
louisklaassen: posts the ante 250
scuba1690: posts the ante 250
Kevin12345Mc: posts small blind 1000
looserGirl27: posts big blind 2000
*** HOLE CARDS ***
Dealt to Kevin12345Mc [Jd 6s]
EESTINOKIA: calls 2000
louisklaassen: folds 
scuba1690: calls 2000
The Heavy Sp: raises 6000 to 8000
realkockie: folds 
pelelek: folds 
Kevin12345Mc: folds 
looserGirl27: folds 
EESTINOKIA: calls 6000
scuba1690: calls 6000
*** FLOP *** [Kh 3h 2d]
EESTINOKIA: checks 
scuba1690: bets 127470 and is all-in
The Heavy Sp: calls 59530 and is all-in
EESTINOKIA: folds 
Uncalled bet (67940) returned to scuba1690
*** TURN *** [Kh 3h 2d] [3d]
*** RIVER *** [Kh 3h 2d 3d] [2c]
*** SHOW DOWN ***
scuba1690: shows [7h 6h] (two pair, Threes and Deuces)
The Heavy Sp: shows [Jc Kc] (two pair, Kings and Threes)
The Heavy Sp collected 148060 from pot
*** SUMMARY ***
Total pot 148060 | Rake 0 
Board [Kh 3h 2d 3d 2c]
Seat 1: The Heavy Sp showed [Jc Kc] and won (148060) with two pair, Kings and Threes
Seat 2: realkockie folded before Flop (didn't bet)
Seat 3: pelelek (button) folded before Flop (didn't bet)
Seat 4: Kevin12345Mc (small blind) folded before Flop
Seat 5: looserGirl27 (big blind) folded before Flop
Seat 6: EESTINOKIA folded on the Flop
Seat 7: louisklaassen folded before Flop (didn't bet)
Seat 8: scuba1690 showed [7h 6h] and lost with two pair, Threes and Deuces



PokerStars Hand #254673981797: Tournament #3852792524, $4.80+$5.00+$1.20 USD Hold'em No Limit - Level XIV (1000/2000) - 2025/02/02 18:38:27 WET [2025/02/02 13:38:27 ET]
Table '3852792524 145' 8-max Seat #4 is the button
Seat 1: The Heavy Sp (148060 in chips, $5 bounty) 
Seat 2: realkockie (51515 in chips, $12.50 bounty) 
Seat 3: pelelek (130557 in chips, $10 bounty) 
Seat 4: Kevin12345Mc (74128 in chips, $10 bounty) 
Seat 5: looserGirl27 (62253 in chips, $7.50 bounty) 
Seat 6: EESTINOKIA (97308 in chips, $16.87 bounty) 
Seat 7: louisklaassen (68535 in chips, $6.25 bounty) 
Seat 8: scuba1690 (67940 in chips, $11.25 bounty) 
The Heavy Sp: posts the ante 250
realkockie: posts the ante 250
pelelek: posts the ante 250
Kevin12345Mc: posts the ante 250
looserGirl27: posts the ante 250
EESTINOKIA: posts the ante 250
louisklaassen: posts the ante 250
scuba1690: posts the ante 250
looserGirl27: posts small blind 1000
EESTINOKIA: posts big blind 2000
*** HOLE CARDS ***
Dealt to Kevin12345Mc [4c Ad]
louisklaassen: folds 
scuba1690: raises 65690 to 67690 and is all-in
The Heavy Sp: folds 
realkockie: folds 
pelelek: folds 
Kevin12345Mc: folds 
looserGirl27: folds 
EESTINOKIA: folds 
Uncalled bet (65690) returned to scuba1690
scuba1690 collected 7000 from pot
*** SUMMARY ***
Total pot 7000 | Rake 0 
Seat 1: The Heavy Sp folded before Flop (didn't bet)
Seat 2: realkockie folded before Flop (didn't bet)
Seat 3: pelelek folded before Flop (didn't bet)
Seat 4: Kevin12345Mc (button) folded before Flop (didn't bet)
Seat 5: looserGirl27 (small blind) folded before Flop
Seat 6: EESTINOKIA (big blind) folded before Flop
Seat 7: louisklaassen folded before Flop (didn't bet)
Seat 8: scuba1690 collected (7000)



PokerStars Hand #254673995472: Tournament #3852792524, $4.80+$5.00+$1.20 USD Hold'em No Limit - Level XV (1250/2500) - 2025/02/02 18:39:06 WET [2025/02/02 13:39:06 ET]
Table '3852792524 145' 8-max Seat #5 is the button
Seat 1: The Heavy Sp (147810 in chips, $5 bounty) 
Seat 2: realkockie (51265 in chips, $12.50 bounty) 
Seat 3: pelelek (130307 in chips, $10 bounty) 
Seat 4: Kevin12345Mc (73878 in chips, $10 bounty) 
Seat 5: looserGirl27 (61003 in chips, $7.50 bounty) 
Seat 6: EESTINOKIA (95058 in chips, $16.87 bounty) 
Seat 7: louisklaassen (68285 in chips, $6.25 bounty) 
Seat 8: scuba1690 (72690 in chips, $11.25 bounty) 
The Heavy Sp: posts the ante 325
realkockie: posts the ante 325
pelelek: posts the ante 325
Kevin12345Mc: posts the ante 325
looserGirl27: posts the ante 325
EESTINOKIA: posts the ante 325
louisklaassen: posts the ante 325
scuba1690: posts the ante 325
EESTINOKIA: posts small blind 1250
louisklaassen: posts big blind 2500
*** HOLE CARDS ***
Dealt to Kevin12345Mc [3d 9d]
scuba1690: folds 
The Heavy Sp: folds 
realkockie: folds 
pelelek: folds 
Kevin12345Mc: folds 
looserGirl27: raises 2500 to 5000
EESTINOKIA: calls 3750
louisklaassen: folds 
*** FLOP *** [Jc 7h Kd]
EESTINOKIA: checks 
looserGirl27: checks 
*** TURN *** [Jc 7h Kd] [9c]
EESTINOKIA: bets 15100
looserGirl27: folds 
Uncalled bet (15100) returned to EESTINOKIA
EESTINOKIA collected 15100 from pot
EESTINOKIA: doesn't show hand 
*** SUMMARY ***
Total pot 15100 | Rake 0 
Board [Jc 7h Kd 9c]
Seat 1: The Heavy Sp folded before Flop (didn't bet)
Seat 2: realkockie folded before Flop (didn't bet)
Seat 3: pelelek folded before Flop (didn't bet)
Seat 4: Kevin12345Mc folded before Flop (didn't bet)
Seat 5: looserGirl27 (button) folded on the Turn
Seat 6: EESTINOKIA (small blind) collected (15100)
Seat 7: louisklaassen (big blind) folded before Flop
Seat 8: scuba1690 folded before Flop (didn't bet)



PokerStars Hand #254674010524: Tournament #3852792524, $4.80+$5.00+$1.20 USD Hold'em No Limit - Level XV (1250/2500) - 2025/02/02 18:39:49 WET [2025/02/02 13:39:49 ET]
Table '3852792524 145' 8-max Seat #6 is the button
Seat 1: The Heavy Sp (147485 in chips, $5 bounty) 
Seat 2: realkockie (50940 in chips, $12.50 bounty) 
Seat 3: pelelek (129982 in chips, $10 bounty) 
Seat 4: Kevin12345Mc (73553 in chips, $10 bounty) 
Seat 5: looserGirl27 (55678 in chips, $7.50 bounty) 
Seat 6: EESTINOKIA (104833 in chips, $16.87 bounty) 
Seat 7: louisklaassen (65460 in chips, $6.25 bounty) 
Seat 8: scuba1690 (72365 in chips, $11.25 bounty) 
The Heavy Sp: posts the ante 325
realkockie: posts the ante 325
pelelek: posts the ante 325
Kevin12345Mc: posts the ante 325
looserGirl27: posts the ante 325
EESTINOKIA: posts the ante 325
louisklaassen: posts the ante 325
scuba1690: posts the ante 325
louisklaassen: posts small blind 1250
scuba1690: posts big blind 2500
*** HOLE CARDS ***
Dealt to Kevin12345Mc [6d Ks]
The Heavy Sp: folds 
realkockie: raises 3000 to 5500
pelelek: folds 
Kevin12345Mc: folds 
looserGirl27: folds 
EESTINOKIA: folds 
louisklaassen: calls 4250
scuba1690: calls 3000
*** FLOP *** [3c Qh 7d]
louisklaassen: checks 
scuba1690: bets 9550
realkockie: folds 
louisklaassen: calls 9550
*** TURN *** [3c Qh 7d] [4s]
louisklaassen: checks 
scuba1690: bets 56990 and is all-in
louisklaassen: folds 
Uncalled bet (56990) returned to scuba1690
scuba1690 collected 38200 from pot
*** SUMMARY ***
Total pot 38200 | Rake 0 
Board [3c Qh 7d 4s]
Seat 1: The Heavy Sp folded before Flop (didn't bet)
Seat 2: realkockie folded on the Flop
Seat 3: pelelek folded before Flop (didn't bet)
Seat 4: Kevin12345Mc folded before Flop (didn't bet)
Seat 5: looserGirl27 folded before Flop (didn't bet)
Seat 6: EESTINOKIA (button) folded before Flop (didn't bet)
Seat 7: louisklaassen (small blind) folded on the Turn
Seat 8: scuba1690 (big blind) collected (38200)



PokerStars Hand #254674033665: Tournament #3852792524, $4.80+$5.00+$1.20 USD Hold'em No Limit - Level XV (1250/2500) - 2025/02/02 18:40:56 WET [2025/02/02 13:40:56 ET]
Table '3852792524 145' 8-max Seat #7 is the button
Seat 1: The Heavy Sp (147160 in chips, $5 bounty) 
Seat 2: realkockie (45115 in chips, $12.50 bounty) 
Seat 3: pelelek (129657 in chips, $10 bounty) 
Seat 4: Kevin12345Mc (73228 in chips, $10 bounty) 
Seat 5: looserGirl27 (55353 in chips, $7.50 bounty) 
Seat 6: EESTINOKIA (104508 in chips, $16.87 bounty) 
Seat 7: louisklaassen (50085 in chips, $6.25 bounty) 
Seat 8: scuba1690 (95190 in chips, $11.25 bounty) 
The Heavy Sp: posts the ante 325
realkockie: posts the ante 325
pelelek: posts the ante 325
Kevin12345Mc: posts the ante 325
looserGirl27: posts the ante 325
EESTINOKIA: posts the ante 325
louisklaassen: posts the ante 325
scuba1690: posts the ante 325
scuba1690: posts small blind 1250
The Heavy Sp: posts big blind 2500
*** HOLE CARDS ***
Dealt to Kevin12345Mc [Ac 4s]
realkockie: folds 
pelelek: folds 
Kevin12345Mc: folds 
looserGirl27: raises 2500 to 5000
EESTINOKIA: calls 5000
louisklaassen: raises 44760 to 49760 and is all-in
scuba1690: folds 
The Heavy Sp: folds 
looserGirl27: calls 44760
EESTINOKIA: calls 44760
*** FLOP *** [Qh Jd 2c]
looserGirl27: checks 
EESTINOKIA: bets 54423 and is all-in
looserGirl27: calls 5268 and is all-in
Uncalled bet (49155) returned to EESTINOKIA
*** TURN *** [Qh Jd 2c] [8s]
*** RIVER *** [Qh Jd 2c 8s] [8h]
*** SHOW DOWN ***
looserGirl27: shows [As Ad] (two pair, Aces and Eights)
EESTINOKIA: shows [Qd Qc] (a full house, Queens full of Eights)
EESTINOKIA collected 10536 from side pot
louisklaassen: shows [Jc Ah] (two pair, Jacks and Eights)
EESTINOKIA collected 155630 from main pot
EESTINOKIA wins $3.75 for eliminating looserGirl27 and their own bounty increases by $3.75 to $20.62
EESTINOKIA wins $3.13 for eliminating louisklaassen and their own bounty increases by $3.12 to $23.74
looserGirl27 finished the tournament
louisklaassen finished the tournament
MonkeyD.Leoo is disconnected 
Gonzalobasti is disconnected 
*** SUMMARY ***
Total pot 166166 Main pot 155630. Side pot 10536. | Rake 0 
Board [Qh Jd 2c 8s 8h]
Seat 1: The Heavy Sp (big blind) folded before Flop
Seat 2: realkockie folded before Flop (didn't bet)
Seat 3: pelelek folded before Flop (didn't bet)
Seat 4: Kevin12345Mc folded before Flop (didn't bet)
Seat 5: looserGirl27 showed [As Ad] and lost with two pair, Aces and Eights
Seat 6: EESTINOKIA showed [Qd Qc] and won (166166) with a full house, Queens full of Eights
Seat 7: louisklaassen (button) showed [Jc Ah] and lost with two pair, Jacks and Eights
Seat 8: scuba1690 (small blind) folded before Flop



PokerStars Hand #254674056985: Tournament #3852792524, $4.80+$5.00+$1.20 USD Hold'em No Limit - Level XV (1250/2500) - 2025/02/02 18:42:03 WET [2025/02/02 13:42:03 ET]
Table '3852792524 145' 8-max Seat #8 is the button
Seat 1: The Heavy Sp (144335 in chips, $5 bounty) 
Seat 2: realkockie (44790 in chips, $12.50 bounty) 
Seat 3: pelelek (129332 in chips, $10 bounty) 
Seat 4: Kevin12345Mc (72903 in chips, $10 bounty) 
Seat 5: MonkeyD.Leoo (275842 in chips, $27.50 bounty) 
Seat 6: EESTINOKIA (215321 in chips, $23.74 bounty) 
Seat 7: Gonzalobasti (76103 in chips, $7.50 bounty) 
Seat 8: scuba1690 (93615 in chips, $11.25 bounty) 
The Heavy Sp: posts the ante 325
realkockie: posts the ante 325
pelelek: posts the ante 325
Kevin12345Mc: posts the ante 325
MonkeyD.Leoo: posts the ante 325
EESTINOKIA: posts the ante 325
Gonzalobasti: posts the ante 325
scuba1690: posts the ante 325
The Heavy Sp: posts small blind 1250
realkockie: posts big blind 2500
*** HOLE CARDS ***
Dealt to Kevin12345Mc [5s Ac]
pelelek: folds 
Kevin12345Mc: folds 
MonkeyD.Leoo: folds 
EESTINOKIA: folds 
Gonzalobasti: folds 
scuba1690: calls 2500
The Heavy Sp: folds 
realkockie: checks 
*** FLOP *** [4d 8s Tc]
realkockie: checks 
scuba1690: checks 
*** TURN *** [4d 8s Tc] [Qd]
realkockie: checks 
scuba1690: checks 
*** RIVER *** [4d 8s Tc Qd] [2c]
realkockie: checks 
scuba1690: checks 
*** SHOW DOWN ***
realkockie: shows [Kh 6s] (high card King)
scuba1690: shows [Ks 9c] (high card King - Queen+Ten+Nine kicker)
scuba1690 collected 8850 from pot
*** SUMMARY ***
Total pot 8850 | Rake 0 
Board [4d 8s Tc Qd 2c]
Seat 1: The Heavy Sp (small blind) folded before Flop
Seat 2: realkockie (big blind) showed [Kh 6s] and lost with high card King
Seat 3: pelelek folded before Flop (didn't bet)
Seat 4: Kevin12345Mc folded before Flop (didn't bet)
Seat 5: MonkeyD.Leoo folded before Flop (didn't bet)
Seat 6: EESTINOKIA folded before Flop (didn't bet)
Seat 7: Gonzalobasti folded before Flop (didn't bet)
Seat 8: scuba1690 (button) showed [Ks 9c] and won (8850) with high card King



PokerStars Hand #254674071553: Tournament #3852792524, $4.80+$5.00+$1.20 USD Hold'em No Limit - Level XV (1250/2500) - 2025/02/02 18:42:44 WET [2025/02/02 13:42:44 ET]
Table '3852792524 145' 8-max Seat #1 is the button
Seat 1: The Heavy Sp (142760 in chips, $5 bounty) 
Seat 2: realkockie (41965 in chips, $12.50 bounty) 
Seat 3: pelelek (129007 in chips, $10 bounty) 
Seat 4: Kevin12345Mc (72578 in chips, $10 bounty) 
Seat 5: MonkeyD.Leoo (275517 in chips, $27.50 bounty) 
Seat 6: EESTINOKIA (214996 in chips, $23.74 bounty) 
Seat 7: Gonzalobasti (75778 in chips, $7.50 bounty) 
Seat 8: scuba1690 (99640 in chips, $11.25 bounty) 
The Heavy Sp: posts the ante 325
realkockie: posts the ante 325
pelelek: posts the ante 325
Kevin12345Mc: posts the ante 325
MonkeyD.Leoo: posts the ante 325
EESTINOKIA: posts the ante 325
Gonzalobasti: posts the ante 325
scuba1690: posts the ante 325
realkockie: posts small blind 1250
pelelek: posts big blind 2500
*** HOLE CARDS ***
Dealt to Kevin12345Mc [2h Qh]
Kevin12345Mc: folds 
MonkeyD.Leoo: folds 
EESTINOKIA: calls 2500
Gonzalobasti: raises 6250 to 8750
scuba1690: folds 
The Heavy Sp: calls 8750
realkockie: folds 
pelelek: calls 6250
EESTINOKIA: folds 
*** FLOP *** [2s Js Ts]
pelelek: checks 
Gonzalobasti: bets 8150
The Heavy Sp: folds 
pelelek: folds 
Uncalled bet (8150) returned to Gonzalobasti
Gonzalobasti collected 32600 from pot
Gonzalobasti: doesn't show hand 
*** SUMMARY ***
Total pot 32600 | Rake 0 
Board [2s Js Ts]
Seat 1: The Heavy Sp (button) folded on the Flop
Seat 2: realkockie (small blind) folded before Flop
Seat 3: pelelek (big blind) folded on the Flop
Seat 4: Kevin12345Mc folded before Flop (didn't bet)
Seat 5: MonkeyD.Leoo folded before Flop (didn't bet)
Seat 6: EESTINOKIA folded before Flop
Seat 7: Gonzalobasti collected (32600)
Seat 8: scuba1690 folded before Flop (didn't bet)



PokerStars Hand #254674094445: Tournament #3852792524, $4.80+$5.00+$1.20 USD Hold'em No Limit - Level XV (1250/2500) - 2025/02/02 18:43:49 WET [2025/02/02 13:43:49 ET]
Table '3852792524 145' 8-max Seat #2 is the button
Seat 1: The Heavy Sp (133685 in chips, $5 bounty) 
Seat 2: realkockie (40390 in chips, $12.50 bounty) 
Seat 3: pelelek (119932 in chips, $10 bounty) 
Seat 4: Kevin12345Mc (72253 in chips, $10 bounty) 
Seat 5: MonkeyD.Leoo (275192 in chips, $27.50 bounty) 
Seat 6: EESTINOKIA (212171 in chips, $23.74 bounty) 
Seat 7: Gonzalobasti (99303 in chips, $7.50 bounty) 
Seat 8: scuba1690 (99315 in chips, $11.25 bounty) 
The Heavy Sp: posts the ante 325
realkockie: posts the ante 325
pelelek: posts the ante 325
Kevin12345Mc: posts the ante 325
MonkeyD.Leoo: posts the ante 325
EESTINOKIA: posts the ante 325
Gonzalobasti: posts the ante 325
scuba1690: posts the ante 325
pelelek: posts small blind 1250
Kevin12345Mc: posts big blind 2500
*** HOLE CARDS ***
Dealt to Kevin12345Mc [7d 8s]
MonkeyD.Leoo: raises 2500 to 5000
EESTINOKIA: calls 5000
Gonzalobasti: folds 
scuba1690: calls 5000
The Heavy Sp: folds 
realkockie: folds 
pelelek: calls 3750
Kevin12345Mc: folds 
*** FLOP *** [7c 6c Td]
pelelek: checks 
MonkeyD.Leoo: checks 
EESTINOKIA: checks 
scuba1690: bets 25100
pelelek: folds 
MonkeyD.Leoo: folds 
EESTINOKIA: folds 
Uncalled bet (25100) returned to scuba1690
scuba1690 collected 25100 from pot
*** SUMMARY ***
Total pot 25100 | Rake 0 
Board [7c 6c Td]
Seat 1: The Heavy Sp folded before Flop (didn't bet)
Seat 2: realkockie (button) folded before Flop (didn't bet)
Seat 3: pelelek (small blind) folded on the Flop
Seat 4: Kevin12345Mc (big blind) folded before Flop
Seat 5: MonkeyD.Leoo folded on the Flop
Seat 6: EESTINOKIA folded on the Flop
Seat 7: Gonzalobasti folded before Flop (didn't bet)
Seat 8: scuba1690 collected (25100)



PokerStars Hand #254674117417: Tournament #3852792524, $4.80+$5.00+$1.20 USD Hold'em No Limit - Level XV (1250/2500) - 2025/02/02 18:44:54 WET [2025/02/02 13:44:54 ET]
Table '3852792524 145' 8-max Seat #3 is the button
Seat 1: The Heavy Sp (133360 in chips, $5 bounty) 
Seat 2: realkockie (40065 in chips, $12.50 bounty) 
Seat 3: pelelek (114607 in chips, $10 bounty) 
Seat 4: Kevin12345Mc (69428 in chips, $10 bounty) 
Seat 5: MonkeyD.Leoo (269867 in chips, $27.50 bounty) 
Seat 6: EESTINOKIA (206846 in chips, $23.74 bounty) 
Seat 7: Gonzalobasti (98978 in chips, $7.50 bounty) 
Seat 8: scuba1690 (119090 in chips, $11.25 bounty) 
The Heavy Sp: posts the ante 325
realkockie: posts the ante 325
pelelek: posts the ante 325
Kevin12345Mc: posts the ante 325
MonkeyD.Leoo: posts the ante 325
EESTINOKIA: posts the ante 325
Gonzalobasti: posts the ante 325
scuba1690: posts the ante 325
Kevin12345Mc: posts small blind 1250
MonkeyD.Leoo: posts big blind 2500
*** HOLE CARDS ***
Dealt to Kevin12345Mc [9h As]
EESTINOKIA: folds 
Gonzalobasti: folds 
scuba1690: calls 2500
The Heavy Sp: folds 
realkockie: folds 
pelelek: calls 2500
Kevin12345Mc: calls 1250
MonkeyD.Leoo: raises 11250 to 13750
scuba1690: calls 11250
pelelek: folds 
Kevin12345Mc: folds 
*** FLOP *** [Kd 4s Jd]
MonkeyD.Leoo: bets 20000
scuba1690: calls 20000
*** TURN *** [Kd 4s Jd] [2c]
MonkeyD.Leoo: bets 235792 and is all-in
scuba1690: calls 85015 and is all-in
Uncalled bet (150777) returned to MonkeyD.Leoo
*** RIVER *** [Kd 4s Jd 2c] [7d]
*** SHOW DOWN ***
MonkeyD.Leoo: shows [Ad Ac] (a pair of Aces)
scuba1690: shows [Jh 9s] (a pair of Jacks)
MonkeyD.Leoo collected 245130 from pot
MonkeyD.Leoo wins $5.63 for eliminating scuba1690 and their own bounty increases by $5.62 to $33.12
scuba1690 finished the tournament in 3254th place
*** SUMMARY ***
Total pot 245130 | Rake 0 
Board [Kd 4s Jd 2c 7d]
Seat 1: The Heavy Sp folded before Flop (didn't bet)
Seat 2: realkockie folded before Flop (didn't bet)
Seat 3: pelelek (button) folded before Flop
Seat 4: Kevin12345Mc (small blind) folded before Flop
Seat 5: MonkeyD.Leoo (big blind) showed [Ad Ac] and won (245130) with a pair of Aces
Seat 6: EESTINOKIA folded before Flop (didn't bet)
Seat 7: Gonzalobasti folded before Flop (didn't bet)
Seat 8: scuba1690 showed [Jh 9s] and lost with a pair of Jacks



PokerStars Hand #254674143989: Tournament #3852792524, $4.80+$5.00+$1.20 USD Hold'em No Limit - Level XV (1250/2500) - 2025/02/02 18:46:10 WET [2025/02/02 13:46:10 ET]
Table '3852792524 145' 8-max Seat #4 is the button
Seat 1: The Heavy Sp (133035 in chips, $5 bounty) 
Seat 2: realkockie (39740 in chips, $12.50 bounty) 
Seat 3: pelelek (111782 in chips, $10 bounty) 
Seat 4: Kevin12345Mc (66603 in chips, $10 bounty) 
Seat 5: MonkeyD.Leoo (395907 in chips, $33.12 bounty) 
Seat 6: EESTINOKIA (206521 in chips, $23.74 bounty) 
Seat 7: Gonzalobasti (98653 in chips, $7.50 bounty) 
The Heavy Sp: posts the ante 325
realkockie: posts the ante 325
pelelek: posts the ante 325
Kevin12345Mc: posts the ante 325
MonkeyD.Leoo: posts the ante 325
EESTINOKIA: posts the ante 325
Gonzalobasti: posts the ante 325
MonkeyD.Leoo: posts small blind 1250
EESTINOKIA: posts big blind 2500
*** HOLE CARDS ***
Dealt to Kevin12345Mc [6d Ks]
Serviooo is disconnected 
Gonzalobasti: folds 
The Heavy Sp: raises 7500 to 10000
realkockie: folds 
pelelek: folds 
Kevin12345Mc: folds 
MonkeyD.Leoo: folds 
EESTINOKIA: folds 
Uncalled bet (7500) returned to The Heavy Sp
The Heavy Sp collected 8525 from pot
*** SUMMARY ***
Total pot 8525 | Rake 0 
Seat 1: The Heavy Sp collected (8525)
Seat 2: realkockie folded before Flop (didn't bet)
Seat 3: pelelek folded before Flop (didn't bet)
Seat 4: Kevin12345Mc (button) folded before Flop (didn't bet)
Seat 5: MonkeyD.Leoo (small blind) folded before Flop
Seat 6: EESTINOKIA (big blind) folded before Flop
Seat 7: Gonzalobasti folded before Flop (didn't bet)



PokerStars Hand #254674156637: Tournament #3852792524, $4.80+$5.00+$1.20 USD Hold'em No Limit - Level XV (1250/2500) - 2025/02/02 18:46:46 WET [2025/02/02 13:46:46 ET]
Table '3852792524 145' 8-max Seat #5 is the button
Seat 1: The Heavy Sp (138735 in chips, $5 bounty) 
Seat 2: realkockie (39415 in chips, $12.50 bounty) 
Seat 3: pelelek (111457 in chips, $10 bounty) 
Seat 4: Kevin12345Mc (66278 in chips, $10 bounty) 
Seat 5: MonkeyD.Leoo (394332 in chips, $33.12 bounty) 
Seat 6: EESTINOKIA (203696 in chips, $23.74 bounty) 
Seat 7: Gonzalobasti (98328 in chips, $7.50 bounty) 
Seat 8: Serviooo (94079 in chips, $15 bounty) 
The Heavy Sp: posts the ante 325
realkockie: posts the ante 325
pelelek: posts the ante 325
Kevin12345Mc: posts the ante 325
MonkeyD.Leoo: posts the ante 325
EESTINOKIA: posts the ante 325
Gonzalobasti: posts the ante 325
Serviooo: posts the ante 325
EESTINOKIA: posts small blind 1250
Gonzalobasti: posts big blind 2500
*** HOLE CARDS ***
Dealt to Kevin12345Mc [8s 9h]
Serviooo: folds 
The Heavy Sp: folds 
realkockie: folds 
pelelek: folds 
Kevin12345Mc: folds 
MonkeyD.Leoo: raises 2500 to 5000
EESTINOKIA: folds 
Gonzalobasti: folds 
Uncalled bet (2500) returned to MonkeyD.Leoo
MonkeyD.Leoo collected 8850 from pot
MonkeyD.Leoo: doesn't show hand 
*** SUMMARY ***
Total pot 8850 | Rake 0 
Seat 1: The Heavy Sp folded before Flop (didn't bet)
Seat 2: realkockie folded before Flop (didn't bet)
Seat 3: pelelek folded before Flop (didn't bet)
Seat 4: Kevin12345Mc folded before Flop (didn't bet)
Seat 5: MonkeyD.Leoo (button) collected (8850)
Seat 6: EESTINOKIA (small blind) folded before Flop
Seat 7: Gonzalobasti (big blind) folded before Flop
Seat 8: Serviooo folded before Flop (didn't bet)



PokerStars Hand #254674172374: Tournament #3852792524, $4.80+$5.00+$1.20 USD Hold'em No Limit - Level XVI (1500/3000) - 2025/02/02 18:47:32 WET [2025/02/02 13:47:32 ET]
Table '3852792524 145' 8-max Seat #6 is the button
Seat 1: The Heavy Sp (138410 in chips, $5 bounty) 
Seat 2: realkockie (39090 in chips, $12.50 bounty) 
Seat 3: pelelek (111132 in chips, $10 bounty) 
Seat 4: Kevin12345Mc (65953 in chips, $10 bounty) 
Seat 5: MonkeyD.Leoo (400357 in chips, $33.12 bounty) 
Seat 6: EESTINOKIA (202121 in chips, $23.74 bounty) 
Seat 7: Gonzalobasti (95503 in chips, $7.50 bounty) 
Seat 8: Serviooo (93754 in chips, $15 bounty) 
The Heavy Sp: posts the ante 375
realkockie: posts the ante 375
pelelek: posts the ante 375
Kevin12345Mc: posts the ante 375
MonkeyD.Leoo: posts the ante 375
EESTINOKIA: posts the ante 375
Gonzalobasti: posts the ante 375
Serviooo: posts the ante 375
Gonzalobasti: posts small blind 1500
Serviooo: posts big blind 3000
*** HOLE CARDS ***
Dealt to Kevin12345Mc [Qh 5d]
The Heavy Sp: folds 
realkockie: folds 
pelelek: folds 
Kevin12345Mc: folds 
MonkeyD.Leoo: raises 3000 to 6000
EESTINOKIA: calls 6000
Gonzalobasti: folds 
Serviooo: calls 3000
*** FLOP *** [Ad 7d 4s]
Serviooo: checks 
MonkeyD.Leoo: checks 
EESTINOKIA: checks 
*** TURN *** [Ad 7d 4s] [2c]
Serviooo: bets 7425
MonkeyD.Leoo: folds 
EESTINOKIA: folds 
Uncalled bet (7425) returned to Serviooo
Serviooo collected 22500 from pot
Serviooo: doesn't show hand 
*** SUMMARY ***
Total pot 22500 | Rake 0 
Board [Ad 7d 4s 2c]
Seat 1: The Heavy Sp folded before Flop (didn't bet)
Seat 2: realkockie folded before Flop (didn't bet)
Seat 3: pelelek folded before Flop (didn't bet)
Seat 4: Kevin12345Mc folded before Flop (didn't bet)
Seat 5: MonkeyD.Leoo folded on the Turn
Seat 6: EESTINOKIA (button) folded on the Turn
Seat 7: Gonzalobasti (small blind) folded before Flop
Seat 8: Serviooo (big blind) collected (22500)



PokerStars Hand #254674197297: Tournament #3852792524, $4.80+$5.00+$1.20 USD Hold'em No Limit - Level XVI (1500/3000) - 2025/02/02 18:48:43 WET [2025/02/02 13:48:43 ET]
Table '3852792524 145' 8-max Seat #7 is the button
Seat 1: The Heavy Sp (138035 in chips, $5 bounty) 
Seat 2: realkockie (38715 in chips, $12.50 bounty) 
Seat 3: pelelek (110757 in chips, $10 bounty) 
Seat 4: Kevin12345Mc (65578 in chips, $10 bounty) 
Seat 5: MonkeyD.Leoo (393982 in chips, $33.12 bounty) 
Seat 6: EESTINOKIA (195746 in chips, $23.74 bounty) 
Seat 7: Gonzalobasti (93628 in chips, $7.50 bounty) 
Seat 8: Serviooo (109879 in chips, $15 bounty) 
The Heavy Sp: posts the ante 375
realkockie: posts the ante 375
pelelek: posts the ante 375
Kevin12345Mc: posts the ante 375
MonkeyD.Leoo: posts the ante 375
EESTINOKIA: posts the ante 375
Gonzalobasti: posts the ante 375
Serviooo: posts the ante 375
Serviooo: posts small blind 1500
The Heavy Sp: posts big blind 3000
*** HOLE CARDS ***
Dealt to Kevin12345Mc [6c 7s]
realkockie: folds 
pelelek: folds 
Kevin12345Mc: folds 
MonkeyD.Leoo: folds 
EESTINOKIA: calls 3000
Gonzalobasti: folds 
Serviooo: raises 3150 to 6150
The Heavy Sp: folds 
EESTINOKIA: calls 3150
*** FLOP *** [Kc 2s 2h]
Serviooo: bets 6039
EESTINOKIA: calls 6039
*** TURN *** [Kc 2s 2h] [9d]
Serviooo: checks 
EESTINOKIA: bets 15189
Serviooo: folds 
Uncalled bet (15189) returned to EESTINOKIA
EESTINOKIA collected 30378 from pot
EESTINOKIA: doesn't show hand 
*** SUMMARY ***
Total pot 30378 | Rake 0 
Board [Kc 2s 2h 9d]
Seat 1: The Heavy Sp (big blind) folded before Flop
Seat 2: realkockie folded before Flop (didn't bet)
Seat 3: pelelek folded before Flop (didn't bet)
Seat 4: Kevin12345Mc folded before Flop (didn't bet)
Seat 5: MonkeyD.Leoo folded before Flop (didn't bet)
Seat 6: EESTINOKIA collected (30378)
Seat 7: Gonzalobasti (button) folded before Flop (didn't bet)
Seat 8: Serviooo (small blind) folded on the Turn



PokerStars Hand #254674212449: Tournament #3852792524, $4.80+$5.00+$1.20 USD Hold'em No Limit - Level XVI (1500/3000) - 2025/02/02 18:49:26 WET [2025/02/02 13:49:26 ET]
Table '3852792524 145' 8-max Seat #8 is the button
Seat 1: The Heavy Sp (134660 in chips, $5 bounty) 
Seat 2: realkockie (38340 in chips, $12.50 bounty) 
Seat 3: pelelek (110382 in chips, $10 bounty) 
Seat 4: Kevin12345Mc (65203 in chips, $10 bounty) 
Seat 5: MonkeyD.Leoo (393607 in chips, $33.12 bounty) 
Seat 6: EESTINOKIA (213560 in chips, $23.74 bounty) 
Seat 7: Gonzalobasti (93253 in chips, $7.50 bounty) 
Seat 8: Serviooo (97315 in chips, $15 bounty) 
The Heavy Sp: posts the ante 375
realkockie: posts the ante 375
pelelek: posts the ante 375
Kevin12345Mc: posts the ante 375
MonkeyD.Leoo: posts the ante 375
EESTINOKIA: posts the ante 375
Gonzalobasti: posts the ante 375
Serviooo: posts the ante 375
The Heavy Sp: posts small blind 1500
realkockie: posts big blind 3000
*** HOLE CARDS ***
Dealt to Kevin12345Mc [Qc 7h]
pelelek: folds 
Kevin12345Mc: folds 
MonkeyD.Leoo: folds 
EESTINOKIA: folds 
Gonzalobasti: folds 
Serviooo: raises 3150 to 6150
The Heavy Sp: folds 
realkockie: calls 3150
*** FLOP *** [6d Tc 4h]
realkockie: checks 
Serviooo: checks 
*** TURN *** [6d Tc 4h] [3s]
realkockie: bets 8400
Serviooo: calls 8400
*** RIVER *** [6d Tc 4h 3s] [Kc]
realkockie: bets 23415 and is all-in
Serviooo: folds 
Uncalled bet (23415) returned to realkockie
realkockie collected 33600 from pot
*** SUMMARY ***
Total pot 33600 | Rake 0 
Board [6d Tc 4h 3s Kc]
Seat 1: The Heavy Sp (small blind) folded before Flop
Seat 2: realkockie (big blind) collected (33600)
Seat 3: pelelek folded before Flop (didn't bet)
Seat 4: Kevin12345Mc folded before Flop (didn't bet)
Seat 5: MonkeyD.Leoo folded before Flop (didn't bet)
Seat 6: EESTINOKIA folded before Flop (didn't bet)
Seat 7: Gonzalobasti folded before Flop (didn't bet)
Seat 8: Serviooo (button) folded on the River



PokerStars Hand #254674229608: Tournament #3852792524, $4.80+$5.00+$1.20 USD Hold'em No Limit - Level XVI (1500/3000) - 2025/02/02 18:50:16 WET [2025/02/02 13:50:16 ET]
Table '3852792524 145' 8-max Seat #1 is the button
Seat 1: The Heavy Sp (132785 in chips, $5 bounty) 
Seat 2: realkockie (57015 in chips, $12.50 bounty) 
Seat 3: pelelek (110007 in chips, $10 bounty) 
Seat 4: Kevin12345Mc (64828 in chips, $10 bounty) 
Seat 5: MonkeyD.Leoo (393232 in chips, $33.12 bounty) 
Seat 6: EESTINOKIA (213185 in chips, $23.74 bounty) 
Seat 7: Gonzalobasti (92878 in chips, $7.50 bounty) 
Seat 8: Serviooo (82390 in chips, $15 bounty) 
The Heavy Sp: posts the ante 375
realkockie: posts the ante 375
pelelek: posts the ante 375
Kevin12345Mc: posts the ante 375
MonkeyD.Leoo: posts the ante 375
EESTINOKIA: posts the ante 375
Gonzalobasti: posts the ante 375
Serviooo: posts the ante 375
realkockie: posts small blind 1500
pelelek: posts big blind 3000
*** HOLE CARDS ***
Dealt to Kevin12345Mc [Js 4d]
Kevin12345Mc: folds 
MonkeyD.Leoo: folds 
EESTINOKIA: calls 3000
Gonzalobasti: folds 
Serviooo: folds 
The Heavy Sp: folds 
realkockie: calls 1500
pelelek: checks 
*** FLOP *** [3d 8h 5h]
realkockie: bets 3600
pelelek: folds 
EESTINOKIA: folds 
Uncalled bet (3600) returned to realkockie
realkockie collected 12000 from pot
*** SUMMARY ***
Total pot 12000 | Rake 0 
Board [3d 8h 5h]
Seat 1: The Heavy Sp (button) folded before Flop (didn't bet)
Seat 2: realkockie (small blind) collected (12000)
Seat 3: pelelek (big blind) folded on the Flop
Seat 4: Kevin12345Mc folded before Flop (didn't bet)
Seat 5: MonkeyD.Leoo folded before Flop (didn't bet)
Seat 6: EESTINOKIA folded on the Flop
Seat 7: Gonzalobasti folded before Flop (didn't bet)
Seat 8: Serviooo folded before Flop (didn't bet)



PokerStars Hand #254674243733: Tournament #3852792524, $4.80+$5.00+$1.20 USD Hold'em No Limit - Level XVI (1500/3000) - 2025/02/02 18:50:57 WET [2025/02/02 13:50:57 ET]
Table '3852792524 145' 8-max Seat #2 is the button
Seat 1: The Heavy Sp (132410 in chips, $5 bounty) 
Seat 2: realkockie (65640 in chips, $12.50 bounty) 
Seat 3: pelelek (106632 in chips, $10 bounty) 
Seat 4: Kevin12345Mc (64453 in chips, $10 bounty) 
Seat 5: MonkeyD.Leoo (392857 in chips, $33.12 bounty) 
Seat 6: EESTINOKIA (209810 in chips, $23.74 bounty) 
Seat 7: Gonzalobasti (92503 in chips, $7.50 bounty) 
Seat 8: Serviooo (82015 in chips, $15 bounty) 
The Heavy Sp: posts the ante 375
realkockie: posts the ante 375
pelelek: posts the ante 375
Kevin12345Mc: posts the ante 375
MonkeyD.Leoo: posts the ante 375
EESTINOKIA: posts the ante 375
Gonzalobasti: posts the ante 375
Serviooo: posts the ante 375
pelelek: posts small blind 1500
Kevin12345Mc: posts big blind 3000
*** HOLE CARDS ***
Dealt to Kevin12345Mc [Js Qc]
MonkeyD.Leoo: folds 
EESTINOKIA: folds 
Gonzalobasti: folds 
Serviooo: raises 3150 to 6150
The Heavy Sp: folds 
realkockie: folds 
pelelek: folds 
Kevin12345Mc: calls 3150
*** FLOP *** [6c 3c Ah]
Kevin12345Mc: checks 
Serviooo: bets 5544
Kevin12345Mc: folds 
Uncalled bet (5544) returned to Serviooo
Serviooo collected 16800 from pot
Serviooo: doesn't show hand 
*** SUMMARY ***
Total pot 16800 | Rake 0 
Board [6c 3c Ah]
Seat 1: The Heavy Sp folded before Flop (didn't bet)
Seat 2: realkockie (button) folded before Flop (didn't bet)
Seat 3: pelelek (small blind) folded before Flop
Seat 4: Kevin12345Mc (big blind) folded on the Flop
Seat 5: MonkeyD.Leoo folded before Flop (didn't bet)
Seat 6: EESTINOKIA folded before Flop (didn't bet)
Seat 7: Gonzalobasti folded before Flop (didn't bet)
Seat 8: Serviooo collected (16800)



PokerStars Hand #254674252434: Tournament #3852792524, $4.80+$5.00+$1.20 USD Hold'em No Limit - Level XVI (1500/3000) - 2025/02/02 18:51:22 WET [2025/02/02 13:51:22 ET]
Table '3852792524 145' 8-max Seat #3 is the button
Seat 1: The Heavy Sp (132035 in chips, $5 bounty) 
Seat 2: realkockie (65265 in chips, $12.50 bounty) 
Seat 3: pelelek (104757 in chips, $10 bounty) 
Seat 4: Kevin12345Mc (57928 in chips, $10 bounty) 
Seat 5: MonkeyD.Leoo (392482 in chips, $33.12 bounty) 
Seat 6: EESTINOKIA (209435 in chips, $23.74 bounty) 
Seat 7: Gonzalobasti (92128 in chips, $7.50 bounty) 
Seat 8: Serviooo (92290 in chips, $15 bounty) 
The Heavy Sp: posts the ante 375
realkockie: posts the ante 375
pelelek: posts the ante 375
Kevin12345Mc: posts the ante 375
MonkeyD.Leoo: posts the ante 375
EESTINOKIA: posts the ante 375
Gonzalobasti: posts the ante 375
Serviooo: posts the ante 375
Kevin12345Mc: posts small blind 1500
MonkeyD.Leoo: posts big blind 3000
*** HOLE CARDS ***
Dealt to Kevin12345Mc [5h Js]
EESTINOKIA: folds 
Gonzalobasti: raises 3600 to 6600
Serviooo: folds 
The Heavy Sp: folds 
realkockie: calls 6600
pelelek: folds 
Kevin12345Mc: folds 
MonkeyD.Leoo: calls 3600
*** FLOP *** [9d 4s 6s]
MonkeyD.Leoo: checks 
Gonzalobasti: bets 8019
realkockie: folds 
MonkeyD.Leoo: calls 8019
*** TURN *** [9d 4s 6s] [Qs]
MonkeyD.Leoo: checks 
Gonzalobasti: checks 
*** RIVER *** [9d 4s 6s Qs] [3d]
MonkeyD.Leoo: bets 377488 and is all-in
Gonzalobasti: folds 
Uncalled bet (377488) returned to MonkeyD.Leoo
MonkeyD.Leoo collected 40338 from pot
MonkeyD.Leoo: doesn't show hand 
*** SUMMARY ***
Total pot 40338 | Rake 0 
Board [9d 4s 6s Qs 3d]
Seat 1: The Heavy Sp folded before Flop (didn't bet)
Seat 2: realkockie folded on the Flop
Seat 3: pelelek (button) folded before Flop (didn't bet)
Seat 4: Kevin12345Mc (small blind) folded before Flop
Seat 5: MonkeyD.Leoo (big blind) collected (40338)
Seat 6: EESTINOKIA folded before Flop (didn't bet)
Seat 7: Gonzalobasti folded on the River
Seat 8: Serviooo folded before Flop (didn't bet)



PokerStars Hand #254674286742: Tournament #3852792524, $4.80+$5.00+$1.20 USD Hold'em No Limit - Level XVI (1500/3000) - 2025/02/02 18:53:01 WET [2025/02/02 13:53:01 ET]
Table '3852792524 145' 8-max Seat #4 is the button
Seat 1: The Heavy Sp (131660 in chips, $5 bounty) 
Seat 2: realkockie (58290 in chips, $12.50 bounty) 
Seat 3: pelelek (104382 in chips, $10 bounty) 
Seat 4: Kevin12345Mc (56053 in chips, $10 bounty) 
Seat 5: MonkeyD.Leoo (417826 in chips, $33.12 bounty) 
Seat 6: EESTINOKIA (209060 in chips, $23.74 bounty) 
Seat 7: Gonzalobasti (77134 in chips, $7.50 bounty) 
Seat 8: Serviooo (91915 in chips, $15 bounty) 
The Heavy Sp: posts the ante 375
realkockie: posts the ante 375
pelelek: posts the ante 375
Kevin12345Mc: posts the ante 375
MonkeyD.Leoo: posts the ante 375
EESTINOKIA: posts the ante 375
Gonzalobasti: posts the ante 375
Serviooo: posts the ante 375
MonkeyD.Leoo: posts small blind 1500
EESTINOKIA: posts big blind 3000
*** HOLE CARDS ***
Dealt to Kevin12345Mc [Jc 5h]
Gonzalobasti: folds 
Serviooo: folds 
The Heavy Sp: folds 
realkockie: folds 
pelelek: folds 
Kevin12345Mc: folds 
MonkeyD.Leoo: calls 1500
EESTINOKIA: checks 
*** FLOP *** [Js Jh 6s]
MonkeyD.Leoo: bets 3000
EESTINOKIA: folds 
Uncalled bet (3000) returned to MonkeyD.Leoo
MonkeyD.Leoo collected 9000 from pot
MonkeyD.Leoo: doesn't show hand 
*** SUMMARY ***
Total pot 9000 | Rake 0 
Board [Js Jh 6s]
Seat 1: The Heavy Sp folded before Flop (didn't bet)
Seat 2: realkockie folded before Flop (didn't bet)
Seat 3: pelelek folded before Flop (didn't bet)
Seat 4: Kevin12345Mc (button) folded before Flop (didn't bet)
Seat 5: MonkeyD.Leoo (small blind) collected (9000)
Seat 6: EESTINOKIA (big blind) folded on the Flop
Seat 7: Gonzalobasti folded before Flop (didn't bet)
Seat 8: Serviooo folded before Flop (didn't bet)



PokerStars Hand #254674303711: Tournament #3852792524, $4.80+$5.00+$1.20 USD Hold'em No Limit - Level XVI (1500/3000) - 2025/02/02 18:53:51 WET [2025/02/02 13:53:51 ET]
Table '3852792524 145' 8-max Seat #5 is the button
Seat 1: The Heavy Sp (131285 in chips, $5 bounty) 
Seat 2: realkockie (57915 in chips, $12.50 bounty) 
Seat 3: pelelek (104007 in chips, $10 bounty) 
Seat 4: Kevin12345Mc (55678 in chips, $10 bounty) 
Seat 5: MonkeyD.Leoo (423451 in chips, $33.12 bounty) 
Seat 6: EESTINOKIA (205685 in chips, $23.74 bounty) 
Seat 7: Gonzalobasti (76759 in chips, $7.50 bounty) 
Seat 8: Serviooo (91540 in chips, $15 bounty) 
The Heavy Sp: posts the ante 375
realkockie: posts the ante 375
pelelek: posts the ante 375
Kevin12345Mc: posts the ante 375
MonkeyD.Leoo: posts the ante 375
EESTINOKIA: posts the ante 375
Gonzalobasti: posts the ante 375
Serviooo: posts the ante 375
EESTINOKIA: posts small blind 1500
Gonzalobasti: posts big blind 3000
*** HOLE CARDS ***
Dealt to Kevin12345Mc [4h 8h]
Serviooo: folds 
The Heavy Sp: raises 6000 to 9000
realkockie: folds 
pelelek: calls 9000
Kevin12345Mc: folds 
MonkeyD.Leoo: folds 
EESTINOKIA: folds 
Gonzalobasti: calls 6000
*** FLOP *** [6s Ks 8d]
Gonzalobasti: checks 
The Heavy Sp: bets 9000
pelelek: calls 9000
Gonzalobasti: folds 
*** TURN *** [6s Ks 8d] [Tc]
The Heavy Sp: bets 24750
pelelek: calls 24750
*** RIVER *** [6s Ks 8d Tc] [Qd]
The Heavy Sp: bets 33000
pelelek: calls 33000
*** SHOW DOWN ***
The Heavy Sp: shows [Kd As] (a pair of Kings)
pelelek: shows [Qc Qh] (three of a kind, Queens)
pelelek collected 165000 from pot
*** SUMMARY ***
Total pot 165000 | Rake 0 
Board [6s Ks 8d Tc Qd]
Seat 1: The Heavy Sp showed [Kd As] and lost with a pair of Kings
Seat 2: realkockie folded before Flop (didn't bet)
Seat 3: pelelek showed [Qc Qh] and won (165000) with three of a kind, Queens
Seat 4: Kevin12345Mc folded before Flop (didn't bet)
Seat 5: MonkeyD.Leoo (button) folded before Flop (didn't bet)
Seat 6: EESTINOKIA (small blind) folded before Flop
Seat 7: Gonzalobasti (big blind) folded on the Flop
Seat 8: Serviooo folded before Flop (didn't bet)



PokerStars Hand #254674437257: Tournament #3852792524, $4.80+$5.00+$1.20 USD Hold'em No Limit - Level XVI (1500/3000) - 2025/02/02 19:02:46 WET [2025/02/02 14:02:46 ET]
Table '3852792524 145' 8-max Seat #6 is the button
Seat 1: The Heavy Sp (55160 in chips, $5 bounty) 
Seat 2: realkockie (57540 in chips, $12.50 bounty) 
Seat 3: pelelek (192882 in chips, $10 bounty) 
Seat 4: Kevin12345Mc (55303 in chips, $10 bounty) 
Seat 5: MonkeyD.Leoo (423076 in chips, $33.12 bounty) 
Seat 6: EESTINOKIA (203810 in chips, $23.74 bounty) 
Seat 7: Gonzalobasti (67384 in chips, $7.50 bounty) 
Seat 8: Serviooo (91165 in chips, $15 bounty) 
The Heavy Sp: posts the ante 375
realkockie: posts the ante 375
pelelek: posts the ante 375
Kevin12345Mc: posts the ante 375
MonkeyD.Leoo: posts the ante 375
EESTINOKIA: posts the ante 375
Gonzalobasti: posts the ante 375
Serviooo: posts the ante 375
Gonzalobasti: posts small blind 1500
Serviooo: posts big blind 3000
*** HOLE CARDS ***
Dealt to Kevin12345Mc [Th Tc]
The Heavy Sp: folds 
realkockie: folds 
pelelek: folds 
Kevin12345Mc: raises 3000 to 6000
MonkeyD.Leoo: folds 
EESTINOKIA: folds 
Gonzalobasti: folds 
Serviooo: folds 
Uncalled bet (3000) returned to Kevin12345Mc
Kevin12345Mc collected 10500 from pot
Kevin12345Mc: doesn't show hand 
*** SUMMARY ***
Total pot 10500 | Rake 0 
Seat 1: The Heavy Sp folded before Flop (didn't bet)
Seat 2: realkockie folded before Flop (didn't bet)
Seat 3: pelelek folded before Flop (didn't bet)
Seat 4: Kevin12345Mc collected (10500)
Seat 5: MonkeyD.Leoo folded before Flop (didn't bet)
Seat 6: EESTINOKIA (button) folded before Flop (didn't bet)
Seat 7: Gonzalobasti (small blind) folded before Flop
Seat 8: Serviooo (big blind) folded before Flop



PokerStars Hand #254674469497: Tournament #3852792524, $4.80+$5.00+$1.20 USD Hold'em No Limit - Level XVI (1500/3000) - 2025/02/02 19:04:18 WET [2025/02/02 14:04:18 ET]
Table '3852792524 145' 8-max Seat #7 is the button
Seat 1: The Heavy Sp (54785 in chips, $5 bounty) 
Seat 2: realkockie (57165 in chips, $12.50 bounty) 
Seat 3: pelelek (192507 in chips, $10 bounty) 
Seat 4: Kevin12345Mc (62428 in chips, $10 bounty) 
Seat 5: MonkeyD.Leoo (422701 in chips, $33.12 bounty) 
Seat 6: EESTINOKIA (203435 in chips, $23.74 bounty) 
Seat 7: Gonzalobasti (65509 in chips, $7.50 bounty) 
Seat 8: Serviooo (87790 in chips, $15 bounty) 
The Heavy Sp: posts the ante 375
realkockie: posts the ante 375
pelelek: posts the ante 375
Kevin12345Mc: posts the ante 375
MonkeyD.Leoo: posts the ante 375
EESTINOKIA: posts the ante 375
Gonzalobasti: posts the ante 375
Serviooo: posts the ante 375
Serviooo: posts small blind 1500
The Heavy Sp: posts big blind 3000
*** HOLE CARDS ***
Dealt to Kevin12345Mc [Jh 3d]
realkockie: folds 
pelelek: folds 
Kevin12345Mc: folds 
MonkeyD.Leoo: folds 
EESTINOKIA: calls 3000
Gonzalobasti: calls 3000
Serviooo: calls 1500
The Heavy Sp: checks 
*** FLOP *** [2d Jc Qh]
Serviooo: checks 
The Heavy Sp: checks 
EESTINOKIA: bets 7500
Gonzalobasti: folds 
Serviooo: folds 
The Heavy Sp: folds 
Uncalled bet (7500) returned to EESTINOKIA
EESTINOKIA collected 15000 from pot
EESTINOKIA: doesn't show hand 
*** SUMMARY ***
Total pot 15000 | Rake 0 
Board [2d Jc Qh]
Seat 1: The Heavy Sp (big blind) folded on the Flop
Seat 2: realkockie folded before Flop (didn't bet)
Seat 3: pelelek folded before Flop (didn't bet)
Seat 4: Kevin12345Mc folded before Flop (didn't bet)
Seat 5: MonkeyD.Leoo folded before Flop (didn't bet)
Seat 6: EESTINOKIA collected (15000)
Seat 7: Gonzalobasti (button) folded on the Flop
Seat 8: Serviooo (small blind) folded on the Flop



PokerStars Hand #254674488827: Tournament #3852792524, $4.80+$5.00+$1.20 USD Hold'em No Limit - Level XVII (1750/3500) - 2025/02/02 19:05:12 WET [2025/02/02 14:05:12 ET]
Table '3852792524 145' 8-max Seat #8 is the button
Seat 1: The Heavy Sp (51410 in chips, $5 bounty) 
Seat 2: realkockie (56790 in chips, $12.50 bounty) 
Seat 3: pelelek (192132 in chips, $10 bounty) 
Seat 4: Kevin12345Mc (62053 in chips, $10 bounty) 
Seat 5: MonkeyD.Leoo (422326 in chips, $33.12 bounty) 
Seat 6: EESTINOKIA (215060 in chips, $23.74 bounty) 
Seat 7: Gonzalobasti (62134 in chips, $7.50 bounty) 
Seat 8: Serviooo (84415 in chips, $15 bounty) 
The Heavy Sp: posts the ante 450
realkockie: posts the ante 450
pelelek: posts the ante 450
Kevin12345Mc: posts the ante 450
MonkeyD.Leoo: posts the ante 450
EESTINOKIA: posts the ante 450
Gonzalobasti: posts the ante 450
Serviooo: posts the ante 450
The Heavy Sp: posts small blind 1750
realkockie: posts big blind 3500
*** HOLE CARDS ***
Dealt to Kevin12345Mc [5s 2d]
pelelek: folds 
Kevin12345Mc: folds 
MonkeyD.Leoo: folds 
EESTINOKIA: folds 
Gonzalobasti: folds 
Serviooo: raises 3675 to 7175
The Heavy Sp: raises 43785 to 50960 and is all-in
realkockie: folds 
Serviooo: folds 
Uncalled bet (43785) returned to The Heavy Sp
The Heavy Sp collected 21450 from pot
*** SUMMARY ***
Total pot 21450 | Rake 0 
Seat 1: The Heavy Sp (small blind) collected (21450)
Seat 2: realkockie (big blind) folded before Flop
Seat 3: pelelek folded before Flop (didn't bet)
Seat 4: Kevin12345Mc folded before Flop (didn't bet)
Seat 5: MonkeyD.Leoo folded before Flop (didn't bet)
Seat 6: EESTINOKIA folded before Flop (didn't bet)
Seat 7: Gonzalobasti folded before Flop (didn't bet)
Seat 8: Serviooo (button) folded before Flop



PokerStars Hand #254674498907: Tournament #3852792524, $4.80+$5.00+$1.20 USD Hold'em No Limit - Level XVII (1750/3500) - 2025/02/02 19:05:41 WET [2025/02/02 14:05:41 ET]
Table '3852792524 145' 8-max Seat #1 is the button
Seat 1: The Heavy Sp (65235 in chips, $5 bounty) 
Seat 2: realkockie (52840 in chips, $12.50 bounty) 
Seat 3: pelelek (191682 in chips, $10 bounty) 
Seat 4: Kevin12345Mc (61603 in chips, $10 bounty) 
Seat 5: MonkeyD.Leoo (421876 in chips, $33.12 bounty) 
Seat 6: EESTINOKIA (214610 in chips, $23.74 bounty) 
Seat 7: Gonzalobasti (61684 in chips, $7.50 bounty) 
Seat 8: Serviooo (76790 in chips, $15 bounty) 
The Heavy Sp: posts the ante 450
realkockie: posts the ante 450
pelelek: posts the ante 450
Kevin12345Mc: posts the ante 450
MonkeyD.Leoo: posts the ante 450
EESTINOKIA: posts the ante 450
Gonzalobasti: posts the ante 450
Serviooo: posts the ante 450
realkockie: posts small blind 1750
pelelek: posts big blind 3500
*** HOLE CARDS ***
Dealt to Kevin12345Mc [Qs 3c]
Kevin12345Mc: folds 
MonkeyD.Leoo: raises 3500 to 7000
EESTINOKIA: folds 
Gonzalobasti: folds 
Serviooo: folds 
The Heavy Sp: folds 
realkockie: raises 45390 to 52390 and is all-in
pelelek: folds 
MonkeyD.Leoo: calls 45390
*** FLOP *** [8d 5d 2d]
*** TURN *** [8d 5d 2d] [5s]
*** RIVER *** [8d 5d 2d 5s] [3s]
*** SHOW DOWN ***
realkockie: shows [Jd Jh] (two pair, Jacks and Fives)
MonkeyD.Leoo: shows [Qh Js] (a pair of Fives)
realkockie collected 111880 from pot
*** SUMMARY ***
Total pot 111880 | Rake 0 
Board [8d 5d 2d 5s 3s]
Seat 1: The Heavy Sp (button) folded before Flop (didn't bet)
Seat 2: realkockie (small blind) showed [Jd Jh] and won (111880) with two pair, Jacks and Fives
Seat 3: pelelek (big blind) folded before Flop
Seat 4: Kevin12345Mc folded before Flop (didn't bet)
Seat 5: MonkeyD.Leoo showed [Qh Js] and lost with a pair of Fives
Seat 6: EESTINOKIA folded before Flop (didn't bet)
Seat 7: Gonzalobasti folded before Flop (didn't bet)
Seat 8: Serviooo folded before Flop (didn't bet)



PokerStars Hand #254674518679: Tournament #3852792524, $4.80+$5.00+$1.20 USD Hold'em No Limit - Level XVII (1750/3500) - 2025/02/02 19:06:36 WET [2025/02/02 14:06:36 ET]
Table '3852792524 145' 8-max Seat #2 is the button
Seat 1: The Heavy Sp (64785 in chips, $5 bounty) 
Seat 2: realkockie (111880 in chips, $12.50 bounty) 
Seat 3: pelelek (187732 in chips, $10 bounty) 
Seat 4: Kevin12345Mc (61153 in chips, $10 bounty) 
Seat 5: MonkeyD.Leoo (369036 in chips, $33.12 bounty) 
Seat 6: EESTINOKIA (214160 in chips, $23.74 bounty) 
Seat 7: Gonzalobasti (61234 in chips, $7.50 bounty) 
Seat 8: Serviooo (76340 in chips, $15 bounty) 
The Heavy Sp: posts the ante 450
realkockie: posts the ante 450
pelelek: posts the ante 450
Kevin12345Mc: posts the ante 450
MonkeyD.Leoo: posts the ante 450
EESTINOKIA: posts the ante 450
Gonzalobasti: posts the ante 450
Serviooo: posts the ante 450
pelelek: posts small blind 1750
Kevin12345Mc: posts big blind 3500
*** HOLE CARDS ***
Dealt to Kevin12345Mc [6s 2s]
MonkeyD.Leoo: folds 
EESTINOKIA: folds 
Gonzalobasti: folds 
Serviooo: calls 3500
The Heavy Sp: raises 10500 to 14000
realkockie: folds 
pelelek: folds 
Kevin12345Mc: folds 
Serviooo: calls 10500
*** FLOP *** [6h As 8c]
Serviooo: checks 
The Heavy Sp: bets 18425
Serviooo: folds 
Uncalled bet (18425) returned to The Heavy Sp
The Heavy Sp collected 36850 from pot
*** SUMMARY ***
Total pot 36850 | Rake 0 
Board [6h As 8c]
Seat 1: The Heavy Sp collected (36850)
Seat 2: realkockie (button) folded before Flop (didn't bet)
Seat 3: pelelek (small blind) folded before Flop
Seat 4: Kevin12345Mc (big blind) folded before Flop
Seat 5: MonkeyD.Leoo folded before Flop (didn't bet)
Seat 6: EESTINOKIA folded before Flop (didn't bet)
Seat 7: Gonzalobasti folded before Flop (didn't bet)
Seat 8: Serviooo folded on the Flop



PokerStars Hand #254674540260: Tournament #3852792524, $4.80+$5.00+$1.20 USD Hold'em No Limit - Level XVII (1750/3500) - 2025/02/02 19:07:36 WET [2025/02/02 14:07:36 ET]
Table '3852792524 145' 8-max Seat #3 is the button
Seat 1: The Heavy Sp (87185 in chips, $5 bounty) 
Seat 2: realkockie (111430 in chips, $12.50 bounty) 
Seat 3: pelelek (185532 in chips, $10 bounty) 
Seat 4: Kevin12345Mc (57203 in chips, $10 bounty) 
Seat 5: MonkeyD.Leoo (368586 in chips, $33.12 bounty) 
Seat 6: EESTINOKIA (213710 in chips, $23.74 bounty) 
Seat 7: Gonzalobasti (60784 in chips, $7.50 bounty) 
Seat 8: Serviooo (61890 in chips, $15 bounty) 
The Heavy Sp: posts the ante 450
realkockie: posts the ante 450
pelelek: posts the ante 450
Kevin12345Mc: posts the ante 450
MonkeyD.Leoo: posts the ante 450
EESTINOKIA: posts the ante 450
Gonzalobasti: posts the ante 450
Serviooo: posts the ante 450
Kevin12345Mc: posts small blind 1750
MonkeyD.Leoo: posts big blind 3500
*** HOLE CARDS ***
Dealt to Kevin12345Mc [2c 6d]
EESTINOKIA: calls 3500
Gonzalobasti: folds 
Serviooo: raises 57940 to 61440 and is all-in
The Heavy Sp: folds 
realkockie: folds 
pelelek: folds 
Kevin12345Mc: folds 
MonkeyD.Leoo: folds 
EESTINOKIA: folds 
Uncalled bet (57940) returned to Serviooo
Serviooo collected 15850 from pot
Serviooo: doesn't show hand 
*** SUMMARY ***
Total pot 15850 | Rake 0 
Seat 1: The Heavy Sp folded before Flop (didn't bet)
Seat 2: realkockie folded before Flop (didn't bet)
Seat 3: pelelek (button) folded before Flop (didn't bet)
Seat 4: Kevin12345Mc (small blind) folded before Flop
Seat 5: MonkeyD.Leoo (big blind) folded before Flop
Seat 6: EESTINOKIA folded before Flop
Seat 7: Gonzalobasti folded before Flop (didn't bet)
Seat 8: Serviooo collected (15850)



PokerStars Hand #254674552774: Tournament #3852792524, $4.80+$5.00+$1.20 USD Hold'em No Limit - Level XVII (1750/3500) - 2025/02/02 19:08:11 WET [2025/02/02 14:08:11 ET]
Table '3852792524 145' 8-max Seat #4 is the button
Seat 1: The Heavy Sp (86735 in chips, $5 bounty) 
Seat 2: realkockie (110980 in chips, $12.50 bounty) 
Seat 3: pelelek (185082 in chips, $10 bounty) 
Seat 4: Kevin12345Mc (55003 in chips, $10 bounty) 
Seat 5: MonkeyD.Leoo (364636 in chips, $33.12 bounty) 
Seat 6: EESTINOKIA (209760 in chips, $23.74 bounty) 
Seat 7: Gonzalobasti (60334 in chips, $7.50 bounty) 
Seat 8: Serviooo (73790 in chips, $15 bounty) 
The Heavy Sp: posts the ante 450
realkockie: posts the ante 450
pelelek: posts the ante 450
Kevin12345Mc: posts the ante 450
MonkeyD.Leoo: posts the ante 450
EESTINOKIA: posts the ante 450
Gonzalobasti: posts the ante 450
Serviooo: posts the ante 450
MonkeyD.Leoo: posts small blind 1750
EESTINOKIA: posts big blind 3500
*** HOLE CARDS ***
Dealt to Kevin12345Mc [Qh Qs]
Gonzalobasti: folds 
Serviooo: calls 3500
The Heavy Sp: folds 
realkockie: folds 
pelelek: folds 
Kevin12345Mc: raises 4550 to 8050
MonkeyD.Leoo: folds 
EESTINOKIA: folds 
Serviooo: calls 4550
*** FLOP *** [4d Ac 8s]
Serviooo: checks 
Kevin12345Mc: bets 8234
Serviooo: calls 8234
*** TURN *** [4d Ac 8s] [9d]
Serviooo: checks 
Kevin12345Mc: checks 
*** RIVER *** [4d Ac 8s 9d] [Td]
Serviooo: bets 57056 and is all-in
Kevin12345Mc: calls 38269 and is all-in
Uncalled bet (18787) returned to Serviooo
*** SHOW DOWN ***
Serviooo: shows [Ad 6c] (a pair of Aces)
Kevin12345Mc: shows [Qh Qs] (a pair of Queens)
Serviooo collected 117956 from pot
Serviooo wins $5 for eliminating Kevin12345Mc and their own bounty increases by $5 to $20
Kevin12345Mc finished the tournament in 2307th place
Dejvis93 is disconnected 
*** SUMMARY ***
Total pot 117956 | Rake 0 
Board [4d Ac 8s 9d Td]
Seat 1: The Heavy Sp folded before Flop (didn't bet)
Seat 2: realkockie folded before Flop (didn't bet)
Seat 3: pelelek folded before Flop (didn't bet)
Seat 4: Kevin12345Mc (button) showed [Qh Qs] and lost with a pair of Queens
Seat 5: MonkeyD.Leoo (small blind) folded before Flop
Seat 6: EESTINOKIA (big blind) folded before Flop
Seat 7: Gonzalobasti folded before Flop (didn't bet)
Seat 8: Serviooo showed [Ad 6c] and won (117956) with a pair of Aces



