PokerStars Hand #254988136422: Tournament #3858857107, $2.45+$2.45+$0.60 USD Hold'em No Limit - Level I (100/200) - 2025/02/22 17:29:47 WET [2025/02/22 12:29:47 ET]
Table '3858857107 71' 8-max Seat #1 is the button
Seat 1: 578346 (25000 in chips, $2.45 bounty) 
Seat 2: IoannisVaios (25000 in chips, $2.45 bounty) 
Seat 3: SaLouTiGR (25000 in chips, $2.45 bounty) 
Seat 4: LvivskeBear (25000 in chips, $2.45 bounty) 
Seat 5: Kevin12345Mc (25000 in chips, $2.45 bounty) 
Seat 6: taluk_00 (25000 in chips, $2.45 bounty) 
Seat 7: Toppmoller (25000 in chips, $2.45 bounty) 
Seat 8: bereket31 (25000 in chips, $2.45 bounty) is sitting out
578346: posts the ante 25
IoannisVaios: posts the ante 25
SaLouTiGR: posts the ante 25
LvivskeBear: posts the ante 25
Kevin12345Mc: posts the ante 25
taluk_00: posts the ante 25
Toppmoller: posts the ante 25
bereket31: posts the ante 25
IoannisVaios: posts small blind 100
SaLouTiGR: posts big blind 200
*** HOLE CARDS ***
Dealt to Kevin12345Mc [4c 7d]
LvivskeBear: folds 
Kevin12345Mc: folds 
taluk_00: raises 200 to 400
Toppmoller: calls 400
bereket31: folds 
578346: raises 1200 to 1600
IoannisVaios: folds 
SaLouTiGR: folds 
taluk_00: folds 
Toppmoller: folds 
Uncalled bet (1200) returned to 578346
578346 collected 1700 from pot
578346: doesn't show hand 
*** SUMMARY ***
Total pot 1700 | Rake 0 
Seat 1: 578346 (button) collected (1700)
Seat 2: IoannisVaios (small blind) folded before Flop
Seat 3: SaLouTiGR (big blind) folded before Flop
Seat 4: LvivskeBear folded before Flop (didn't bet)
Seat 5: Kevin12345Mc folded before Flop (didn't bet)
Seat 6: taluk_00 folded before Flop
Seat 7: Toppmoller folded before Flop
Seat 8: bereket31 folded before Flop (didn't bet)



PokerStars Hand #254988148914: Tournament #3858857107, $2.45+$2.45+$0.60 USD Hold'em No Limit - Level I (100/200) - 2025/02/22 17:30:37 WET [2025/02/22 12:30:37 ET]
Table '3858857107 71' 8-max Seat #2 is the button
Seat 1: 578346 (26275 in chips, $2.45 bounty) 
Seat 2: IoannisVaios (24875 in chips, $2.45 bounty) 
Seat 3: SaLouTiGR (24775 in chips, $2.45 bounty) 
Seat 4: LvivskeBear (24975 in chips, $2.45 bounty) 
Seat 5: Kevin12345Mc (24975 in chips, $2.45 bounty) 
Seat 6: taluk_00 (24575 in chips, $2.45 bounty) 
Seat 7: Toppmoller (24575 in chips, $2.45 bounty) 
Seat 8: bereket31 (24975 in chips, $2.45 bounty) is sitting out
578346: posts the ante 25
IoannisVaios: posts the ante 25
SaLouTiGR: posts the ante 25
LvivskeBear: posts the ante 25
Kevin12345Mc: posts the ante 25
taluk_00: posts the ante 25
Toppmoller: posts the ante 25
bereket31: posts the ante 25
SaLouTiGR: posts small blind 100
LvivskeBear: posts big blind 200
*** HOLE CARDS ***
Dealt to Kevin12345Mc [2s 5d]
Kevin12345Mc: folds 
taluk_00: folds 
Toppmoller: folds 
bereket31: folds 
578346: raises 260 to 460
IoannisVaios: folds 
SaLouTiGR: folds 
LvivskeBear: folds 
Uncalled bet (260) returned to 578346
578346 collected 700 from pot
578346: doesn't show hand 
*** SUMMARY ***
Total pot 700 | Rake 0 
Seat 1: 578346 collected (700)
Seat 2: IoannisVaios (button) folded before Flop (didn't bet)
Seat 3: SaLouTiGR (small blind) folded before Flop
Seat 4: LvivskeBear (big blind) folded before Flop
Seat 5: Kevin12345Mc folded before Flop (didn't bet)
Seat 6: taluk_00 folded before Flop (didn't bet)
Seat 7: Toppmoller folded before Flop (didn't bet)
Seat 8: bereket31 folded before Flop (didn't bet)



PokerStars Hand #254988155760: Tournament #3858857107, $2.45+$2.45+$0.60 USD Hold'em No Limit - Level I (100/200) - 2025/02/22 17:31:03 WET [2025/02/22 12:31:03 ET]
Table '3858857107 71' 8-max Seat #3 is the button
Seat 1: 578346 (26750 in chips, $2.45 bounty) 
Seat 2: IoannisVaios (24850 in chips, $2.45 bounty) 
Seat 3: SaLouTiGR (24650 in chips, $2.45 bounty) 
Seat 4: LvivskeBear (24750 in chips, $2.45 bounty) 
Seat 5: Kevin12345Mc (24950 in chips, $2.45 bounty) 
Seat 6: taluk_00 (24550 in chips, $2.45 bounty) 
Seat 7: Toppmoller (24550 in chips, $2.45 bounty) 
Seat 8: bereket31 (24950 in chips, $2.45 bounty) is sitting out
578346: posts the ante 25
IoannisVaios: posts the ante 25
SaLouTiGR: posts the ante 25
LvivskeBear: posts the ante 25
Kevin12345Mc: posts the ante 25
taluk_00: posts the ante 25
Toppmoller: posts the ante 25
bereket31: posts the ante 25
LvivskeBear: posts small blind 100
Kevin12345Mc: posts big blind 200
*** HOLE CARDS ***
Dealt to Kevin12345Mc [4d Kh]
taluk_00: folds 
Toppmoller: raises 220 to 420
bereket31: folds 
578346: calls 420
IoannisVaios: folds 
SaLouTiGR: folds 
LvivskeBear: raises 2580 to 3000
Kevin12345Mc: folds 
Toppmoller: folds 
578346: folds 
Uncalled bet (2580) returned to LvivskeBear
LvivskeBear collected 1660 from pot
LvivskeBear: doesn't show hand 
*** SUMMARY ***
Total pot 1660 | Rake 0 
Seat 1: 578346 folded before Flop
Seat 2: IoannisVaios folded before Flop (didn't bet)
Seat 3: SaLouTiGR (button) folded before Flop (didn't bet)
Seat 4: LvivskeBear (small blind) collected (1660)
Seat 5: Kevin12345Mc (big blind) folded before Flop
Seat 6: taluk_00 folded before Flop (didn't bet)
Seat 7: Toppmoller folded before Flop
Seat 8: bereket31 folded before Flop (didn't bet)



PokerStars Hand #254988166829: Tournament #3858857107, $2.45+$2.45+$0.60 USD Hold'em No Limit - Level I (100/200) - 2025/02/22 17:31:47 WET [2025/02/22 12:31:47 ET]
Table '3858857107 71' 8-max Seat #4 is the button
Seat 1: 578346 (26305 in chips, $2.45 bounty) 
Seat 2: IoannisVaios (24825 in chips, $2.45 bounty) 
Seat 3: SaLouTiGR (24625 in chips, $2.45 bounty) 
Seat 4: LvivskeBear (25965 in chips, $2.45 bounty) 
Seat 5: Kevin12345Mc (24725 in chips, $2.45 bounty) 
Seat 6: taluk_00 (24525 in chips, $2.45 bounty) 
Seat 7: Toppmoller (24105 in chips, $2.45 bounty) 
Seat 8: bereket31 (24925 in chips, $2.45 bounty) is sitting out
578346: posts the ante 25
IoannisVaios: posts the ante 25
SaLouTiGR: posts the ante 25
LvivskeBear: posts the ante 25
Kevin12345Mc: posts the ante 25
taluk_00: posts the ante 25
Toppmoller: posts the ante 25
bereket31: posts the ante 25
Kevin12345Mc: posts small blind 100
taluk_00: posts big blind 200
*** HOLE CARDS ***
Dealt to Kevin12345Mc [Ah Qs]
Toppmoller: folds 
bereket31: folds 
578346: folds 
IoannisVaios: folds 
SaLouTiGR: folds 
LvivskeBear: raises 200 to 400
bereket31 is disconnected 
bereket31 has returned
Kevin12345Mc: raises 1200 to 1600
taluk_00: folds 
LvivskeBear: folds 
Uncalled bet (1200) returned to Kevin12345Mc
Kevin12345Mc collected 1200 from pot
Kevin12345Mc: doesn't show hand 
*** SUMMARY ***
Total pot 1200 | Rake 0 
Seat 1: 578346 folded before Flop (didn't bet)
Seat 2: IoannisVaios folded before Flop (didn't bet)
Seat 3: SaLouTiGR folded before Flop (didn't bet)
Seat 4: LvivskeBear (button) folded before Flop
Seat 5: Kevin12345Mc (small blind) collected (1200)
Seat 6: taluk_00 (big blind) folded before Flop
Seat 7: Toppmoller folded before Flop (didn't bet)
Seat 8: bereket31 folded before Flop (didn't bet)



PokerStars Hand #254988174604: Tournament #3858857107, $2.45+$2.45+$0.60 USD Hold'em No Limit - Level I (100/200) - 2025/02/22 17:32:17 WET [2025/02/22 12:32:17 ET]
Table '3858857107 71' 8-max Seat #5 is the button
Seat 1: 578346 (26280 in chips, $2.45 bounty) 
Seat 2: IoannisVaios (24800 in chips, $2.45 bounty) 
Seat 3: SaLouTiGR (24600 in chips, $2.45 bounty) 
Seat 4: LvivskeBear (25540 in chips, $2.45 bounty) 
Seat 5: Kevin12345Mc (25500 in chips, $2.45 bounty) 
Seat 6: taluk_00 (24300 in chips, $2.45 bounty) 
Seat 7: Toppmoller (24080 in chips, $2.45 bounty) 
Seat 8: bereket31 (24900 in chips, $2.45 bounty) 
578346: posts the ante 25
IoannisVaios: posts the ante 25
SaLouTiGR: posts the ante 25
LvivskeBear: posts the ante 25
Kevin12345Mc: posts the ante 25
taluk_00: posts the ante 25
Toppmoller: posts the ante 25
bereket31: posts the ante 25
taluk_00: posts small blind 100
Toppmoller: posts big blind 200
*** HOLE CARDS ***
Dealt to Kevin12345Mc [Kd Js]
bereket31: calls 200
578346: folds 
IoannisVaios: raises 216 to 416
SaLouTiGR: folds 
LvivskeBear: folds 
Kevin12345Mc: calls 416
taluk_00: folds 
Toppmoller: calls 216
bereket31: calls 216
*** FLOP *** [Ks Qc As]
Toppmoller: checks 
bereket31: checks 
IoannisVaios: checks 
Kevin12345Mc: checks 
*** TURN *** [Ks Qc As] [3s]
Toppmoller: bets 786
bereket31: calls 786
IoannisVaios: folds 
Kevin12345Mc: calls 786
*** RIVER *** [Ks Qc As 3s] [4c]
Toppmoller: bets 1730
bereket31: folds 
Kevin12345Mc: folds 
Uncalled bet (1730) returned to Toppmoller
Toppmoller collected 4322 from pot
Toppmoller: doesn't show hand 
*** SUMMARY ***
Total pot 4322 | Rake 0 
Board [Ks Qc As 3s 4c]
Seat 1: 578346 folded before Flop (didn't bet)
Seat 2: IoannisVaios folded on the Turn
Seat 3: SaLouTiGR folded before Flop (didn't bet)
Seat 4: LvivskeBear folded before Flop (didn't bet)
Seat 5: Kevin12345Mc (button) folded on the River
Seat 6: taluk_00 (small blind) folded before Flop
Seat 7: Toppmoller (big blind) collected (4322)
Seat 8: bereket31 folded on the River



PokerStars Hand #254988201731: Tournament #3858857107, $2.45+$2.45+$0.60 USD Hold'em No Limit - Level I (100/200) - 2025/02/22 17:34:04 WET [2025/02/22 12:34:04 ET]
Table '3858857107 71' 8-max Seat #6 is the button
Seat 1: 578346 (26255 in chips, $2.45 bounty) 
Seat 2: IoannisVaios (24359 in chips, $2.45 bounty) 
Seat 3: SaLouTiGR (24575 in chips, $2.45 bounty) 
Seat 4: LvivskeBear (25515 in chips, $2.45 bounty) 
Seat 5: Kevin12345Mc (24273 in chips, $2.45 bounty) 
Seat 6: taluk_00 (24175 in chips, $2.45 bounty) 
Seat 7: Toppmoller (27175 in chips, $2.45 bounty) 
Seat 8: bereket31 (23673 in chips, $2.45 bounty) 
578346: posts the ante 25
IoannisVaios: posts the ante 25
SaLouTiGR: posts the ante 25
LvivskeBear: posts the ante 25
Kevin12345Mc: posts the ante 25
taluk_00: posts the ante 25
Toppmoller: posts the ante 25
bereket31: posts the ante 25
Toppmoller: posts small blind 100
bereket31: posts big blind 200
*** HOLE CARDS ***
Dealt to Kevin12345Mc [Kc Ah]
578346: folds 
IoannisVaios: folds 
SaLouTiGR: folds 
LvivskeBear: folds 
Kevin12345Mc: raises 260 to 460
taluk_00: folds 
Toppmoller: folds 
bereket31: folds 
Uncalled bet (260) returned to Kevin12345Mc
Kevin12345Mc collected 700 from pot
Kevin12345Mc: doesn't show hand 
*** SUMMARY ***
Total pot 700 | Rake 0 
Seat 1: 578346 folded before Flop (didn't bet)
Seat 2: IoannisVaios folded before Flop (didn't bet)
Seat 3: SaLouTiGR folded before Flop (didn't bet)
Seat 4: LvivskeBear folded before Flop (didn't bet)
Seat 5: Kevin12345Mc collected (700)
Seat 6: taluk_00 (button) folded before Flop (didn't bet)
Seat 7: Toppmoller (small blind) folded before Flop
Seat 8: bereket31 (big blind) folded before Flop



PokerStars Hand #254988207366: Tournament #3858857107, $2.45+$2.45+$0.60 USD Hold'em No Limit - Level I (100/200) - 2025/02/22 17:34:26 WET [2025/02/22 12:34:26 ET]
Table '3858857107 71' 8-max Seat #7 is the button
Seat 1: 578346 (26230 in chips, $2.45 bounty) 
Seat 2: IoannisVaios (24334 in chips, $2.45 bounty) 
Seat 3: SaLouTiGR (24550 in chips, $2.45 bounty) 
Seat 4: LvivskeBear (25490 in chips, $2.45 bounty) 
Seat 5: Kevin12345Mc (24748 in chips, $2.45 bounty) 
Seat 6: taluk_00 (24150 in chips, $2.45 bounty) 
Seat 7: Toppmoller (27050 in chips, $2.45 bounty) 
Seat 8: bereket31 (23448 in chips, $2.45 bounty) 
578346: posts the ante 25
IoannisVaios: posts the ante 25
SaLouTiGR: posts the ante 25
LvivskeBear: posts the ante 25
Kevin12345Mc: posts the ante 25
taluk_00: posts the ante 25
Toppmoller: posts the ante 25
bereket31: posts the ante 25
bereket31: posts small blind 100
578346: posts big blind 200
*** HOLE CARDS ***
Dealt to Kevin12345Mc [3d Th]
IoannisVaios: folds 
SaLouTiGR: folds 
LvivskeBear: raises 200 to 400
Kevin12345Mc: folds 
taluk_00: folds 
Toppmoller: calls 400
bereket31: calls 300
578346: folds 
*** FLOP *** [Qd Ks Qc]
bereket31: checks 
LvivskeBear: bets 528
Toppmoller: calls 528
bereket31: folds 
*** TURN *** [Qd Ks Qc] [6s]
LvivskeBear: bets 2045
Toppmoller: calls 2045
*** RIVER *** [Qd Ks Qc 6s] [2c]
LvivskeBear: checks 
Toppmoller: bets 5060
LvivskeBear: folds 
Uncalled bet (5060) returned to Toppmoller
Toppmoller collected 6746 from pot
Toppmoller: doesn't show hand 
*** SUMMARY ***
Total pot 6746 | Rake 0 
Board [Qd Ks Qc 6s 2c]
Seat 1: 578346 (big blind) folded before Flop
Seat 2: IoannisVaios folded before Flop (didn't bet)
Seat 3: SaLouTiGR folded before Flop (didn't bet)
Seat 4: LvivskeBear folded on the River
Seat 5: Kevin12345Mc folded before Flop (didn't bet)
Seat 6: taluk_00 folded before Flop (didn't bet)
Seat 7: Toppmoller (button) collected (6746)
Seat 8: bereket31 (small blind) folded on the Flop



PokerStars Hand #254988234337: Tournament #3858857107, $2.45+$2.45+$0.60 USD Hold'em No Limit - Level I (100/200) - 2025/02/22 17:36:13 WET [2025/02/22 12:36:13 ET]
Table '3858857107 71' 8-max Seat #8 is the button
Seat 1: 578346 (26005 in chips, $2.45 bounty) 
Seat 2: IoannisVaios (24309 in chips, $2.45 bounty) 
Seat 3: SaLouTiGR (24525 in chips, $2.45 bounty) 
Seat 4: LvivskeBear (22492 in chips, $2.45 bounty) 
Seat 5: Kevin12345Mc (24723 in chips, $2.45 bounty) 
Seat 6: taluk_00 (24125 in chips, $2.45 bounty) 
Seat 7: Toppmoller (30798 in chips, $2.45 bounty) 
Seat 8: bereket31 (23023 in chips, $2.45 bounty) 
578346: posts the ante 25
IoannisVaios: posts the ante 25
SaLouTiGR: posts the ante 25
LvivskeBear: posts the ante 25
Kevin12345Mc: posts the ante 25
taluk_00: posts the ante 25
Toppmoller: posts the ante 25
bereket31: posts the ante 25
578346: posts small blind 100
IoannisVaios: posts big blind 200
*** HOLE CARDS ***
Dealt to Kevin12345Mc [Js Kd]
SaLouTiGR: calls 200
LvivskeBear: folds 
Kevin12345Mc: raises 260 to 460
taluk_00: folds 
Toppmoller: folds 
bereket31: folds 
578346: folds 
IoannisVaios: calls 260
SaLouTiGR: calls 260
*** FLOP *** [9s 2h Jc]
IoannisVaios: checks 
SaLouTiGR: checks 
Kevin12345Mc: bets 554
IoannisVaios: calls 554
SaLouTiGR: raises 554 to 1108
Kevin12345Mc: calls 554
IoannisVaios: calls 554
*** TURN *** [9s 2h Jc] [Kh]
IoannisVaios: checks 
SaLouTiGR: bets 600
Kevin12345Mc: calls 600
IoannisVaios: calls 600
*** RIVER *** [9s 2h Jc Kh] [6c]
IoannisVaios: checks 
SaLouTiGR: checks 
Kevin12345Mc: bets 4491
IoannisVaios: folds 
SaLouTiGR: calls 4491
*** SHOW DOWN ***
Kevin12345Mc: shows [Js Kd] (two pair, Kings and Jacks)
SaLouTiGR: mucks hand 
Kevin12345Mc collected 15786 from pot
*** SUMMARY ***
Total pot 15786 | Rake 0 
Board [9s 2h Jc Kh 6c]
Seat 1: 578346 (small blind) folded before Flop
Seat 2: IoannisVaios (big blind) folded on the River
Seat 3: SaLouTiGR mucked [Jh Ah]
Seat 4: LvivskeBear folded before Flop (didn't bet)
Seat 5: Kevin12345Mc showed [Js Kd] and won (15786) with two pair, Kings and Jacks
Seat 6: taluk_00 folded before Flop (didn't bet)
Seat 7: Toppmoller folded before Flop (didn't bet)
Seat 8: bereket31 (button) folded before Flop (didn't bet)



PokerStars Hand #254988258690: Tournament #3858857107, $2.45+$2.45+$0.60 USD Hold'em No Limit - Level I (100/200) - 2025/02/22 17:37:48 WET [2025/02/22 12:37:48 ET]
Table '3858857107 71' 8-max Seat #1 is the button
Seat 1: 578346 (25880 in chips, $2.45 bounty) 
Seat 2: IoannisVaios (22116 in chips, $2.45 bounty) 
Seat 3: SaLouTiGR (17841 in chips, $2.45 bounty) 
Seat 4: LvivskeBear (22467 in chips, $2.45 bounty) 
Seat 5: Kevin12345Mc (33825 in chips, $2.45 bounty) 
Seat 6: taluk_00 (24100 in chips, $2.45 bounty) 
Seat 7: Toppmoller (30773 in chips, $2.45 bounty) 
Seat 8: bereket31 (22998 in chips, $2.45 bounty) 
578346: posts the ante 25
IoannisVaios: posts the ante 25
SaLouTiGR: posts the ante 25
LvivskeBear: posts the ante 25
Kevin12345Mc: posts the ante 25
taluk_00: posts the ante 25
Toppmoller: posts the ante 25
bereket31: posts the ante 25
IoannisVaios: posts small blind 100
SaLouTiGR: posts big blind 200
*** HOLE CARDS ***
Dealt to Kevin12345Mc [6c Qc]
LvivskeBear: folds 
Kevin12345Mc: folds 
taluk_00: folds 
bereket31 is disconnected 
Toppmoller: folds 
bereket31 has timed out while disconnected
bereket31: folds 
bereket31 is sitting out
578346: folds 
IoannisVaios: folds 
Uncalled bet (100) returned to SaLouTiGR
SaLouTiGR collected 400 from pot
SaLouTiGR: doesn't show hand 
*** SUMMARY ***
Total pot 400 | Rake 0 
Seat 1: 578346 (button) folded before Flop (didn't bet)
Seat 2: IoannisVaios (small blind) folded before Flop
Seat 3: SaLouTiGR (big blind) collected (400)
Seat 4: LvivskeBear folded before Flop (didn't bet)
Seat 5: Kevin12345Mc folded before Flop (didn't bet)
Seat 6: taluk_00 folded before Flop (didn't bet)
Seat 7: Toppmoller folded before Flop (didn't bet)
Seat 8: bereket31 folded before Flop (didn't bet)



PokerStars Hand #254988266627: Tournament #3858857107, $2.45+$2.45+$0.60 USD Hold'em No Limit - Level II (125/250) - 2025/02/22 17:38:19 WET [2025/02/22 12:38:19 ET]
Table '3858857107 71' 8-max Seat #2 is the button
Seat 1: 578346 (25855 in chips, $2.45 bounty) 
Seat 2: IoannisVaios (21991 in chips, $2.45 bounty) 
Seat 3: SaLouTiGR (18116 in chips, $2.45 bounty) 
Seat 4: LvivskeBear (22442 in chips, $2.45 bounty) 
Seat 5: Kevin12345Mc (33800 in chips, $2.45 bounty) 
Seat 6: taluk_00 (24075 in chips, $2.45 bounty) 
Seat 7: Toppmoller (30748 in chips, $2.45 bounty) 
Seat 8: bereket31 (22973 in chips, $2.45 bounty) is sitting out
578346: posts the ante 30
IoannisVaios: posts the ante 30
SaLouTiGR: posts the ante 30
LvivskeBear: posts the ante 30
Kevin12345Mc: posts the ante 30
taluk_00: posts the ante 30
Toppmoller: posts the ante 30
bereket31: posts the ante 30
SaLouTiGR: posts small blind 125
LvivskeBear: posts big blind 250
*** HOLE CARDS ***
Dealt to Kevin12345Mc [2d Ac]
Kevin12345Mc: folds 
bereket31 is disconnected 
bereket31 has returned
taluk_00: folds 
Toppmoller: folds 
bereket31: folds 
578346: raises 325 to 575
IoannisVaios: folds 
SaLouTiGR: calls 450
LvivskeBear: calls 325
*** FLOP *** [4d 9s Tc]
SaLouTiGR: bets 250
LvivskeBear: folds 
578346: calls 250
*** TURN *** [4d 9s Tc] [3h]
SaLouTiGR: bets 250
578346: calls 250
*** RIVER *** [4d 9s Tc 3h] [Ks]
SaLouTiGR: bets 500
578346: raises 1558 to 2058
SaLouTiGR: folds 
Uncalled bet (1558) returned to 578346
578346 collected 3965 from pot
578346: doesn't show hand 
*** SUMMARY ***
Total pot 3965 | Rake 0 
Board [4d 9s Tc 3h Ks]
Seat 1: 578346 collected (3965)
Seat 2: IoannisVaios (button) folded before Flop (didn't bet)
Seat 3: SaLouTiGR (small blind) folded on the River
Seat 4: LvivskeBear (big blind) folded on the Flop
Seat 5: Kevin12345Mc folded before Flop (didn't bet)
Seat 6: taluk_00 folded before Flop (didn't bet)
Seat 7: Toppmoller folded before Flop (didn't bet)
Seat 8: bereket31 folded before Flop (didn't bet)



PokerStars Hand #254988309773: Tournament #3858857107, $2.45+$2.45+$0.60 USD Hold'em No Limit - Level II (125/250) - 2025/02/22 17:41:09 WET [2025/02/22 12:41:09 ET]
Table '3858857107 71' 8-max Seat #3 is the button
Seat 1: 578346 (28215 in chips, $2.45 bounty) 
Seat 2: IoannisVaios (21961 in chips, $2.45 bounty) 
Seat 3: SaLouTiGR (16511 in chips, $2.45 bounty) 
Seat 4: LvivskeBear (21837 in chips, $2.45 bounty) 
Seat 5: Kevin12345Mc (33770 in chips, $2.45 bounty) 
Seat 6: taluk_00 (24045 in chips, $2.45 bounty) 
Seat 7: Toppmoller (30718 in chips, $2.45 bounty) 
Seat 8: bereket31 (22943 in chips, $2.45 bounty) 
578346: posts the ante 30
IoannisVaios: posts the ante 30
SaLouTiGR: posts the ante 30
LvivskeBear: posts the ante 30
Kevin12345Mc: posts the ante 30
taluk_00: posts the ante 30
Toppmoller: posts the ante 30
bereket31: posts the ante 30
LvivskeBear: posts small blind 125
Kevin12345Mc: posts big blind 250
*** HOLE CARDS ***
Dealt to Kevin12345Mc [Ah 8s]
taluk_00: folds 
Toppmoller: folds 
bereket31: calls 250
578346: raises 1000 to 1250
IoannisVaios: folds 
SaLouTiGR: folds 
LvivskeBear: folds 
Kevin12345Mc: folds 
bereket31: calls 1000
*** FLOP *** [Qd 8c 6s]
bereket31: checks 
578346: checks 
*** TURN *** [Qd 8c 6s] [8h]
bereket31: checks 
578346: bets 779
bereket31: folds 
Uncalled bet (779) returned to 578346
578346 collected 3115 from pot
578346: doesn't show hand 
*** SUMMARY ***
Total pot 3115 | Rake 0 
Board [Qd 8c 6s 8h]
Seat 1: 578346 collected (3115)
Seat 2: IoannisVaios folded before Flop (didn't bet)
Seat 3: SaLouTiGR (button) folded before Flop (didn't bet)
Seat 4: LvivskeBear (small blind) folded before Flop
Seat 5: Kevin12345Mc (big blind) folded before Flop
Seat 6: taluk_00 folded before Flop (didn't bet)
Seat 7: Toppmoller folded before Flop (didn't bet)
Seat 8: bereket31 folded on the Turn



PokerStars Hand #254988332176: Tournament #3858857107, $2.45+$2.45+$0.60 USD Hold'em No Limit - Level II (125/250) - 2025/02/22 17:42:38 WET [2025/02/22 12:42:38 ET]
Table '3858857107 71' 8-max Seat #4 is the button
Seat 1: 578346 (30050 in chips, $2.45 bounty) 
Seat 2: IoannisVaios (21931 in chips, $2.45 bounty) 
Seat 3: SaLouTiGR (16481 in chips, $2.45 bounty) 
Seat 4: LvivskeBear (21682 in chips, $2.45 bounty) 
Seat 5: Kevin12345Mc (33490 in chips, $2.45 bounty) 
Seat 6: taluk_00 (24015 in chips, $2.45 bounty) 
Seat 7: Toppmoller (30688 in chips, $2.45 bounty) 
Seat 8: bereket31 (21663 in chips, $2.45 bounty) 
578346: posts the ante 30
IoannisVaios: posts the ante 30
SaLouTiGR: posts the ante 30
LvivskeBear: posts the ante 30
Kevin12345Mc: posts the ante 30
taluk_00: posts the ante 30
Toppmoller: posts the ante 30
bereket31: posts the ante 30
Kevin12345Mc: posts small blind 125
taluk_00: posts big blind 250
*** HOLE CARDS ***
Dealt to Kevin12345Mc [3h 4c]
Toppmoller: folds 
bereket31: folds 
578346: folds 
IoannisVaios: folds 
SaLouTiGR: folds 
LvivskeBear: raises 250 to 500
Kevin12345Mc: folds 
taluk_00: folds 
Uncalled bet (250) returned to LvivskeBear
LvivskeBear collected 865 from pot
LvivskeBear: doesn't show hand 
*** SUMMARY ***
Total pot 865 | Rake 0 
Seat 1: 578346 folded before Flop (didn't bet)
Seat 2: IoannisVaios folded before Flop (didn't bet)
Seat 3: SaLouTiGR folded before Flop (didn't bet)
Seat 4: LvivskeBear (button) collected (865)
Seat 5: Kevin12345Mc (small blind) folded before Flop
Seat 6: taluk_00 (big blind) folded before Flop
Seat 7: Toppmoller folded before Flop (didn't bet)
Seat 8: bereket31 folded before Flop (didn't bet)



PokerStars Hand #254988338624: Tournament #3858857107, $2.45+$2.45+$0.60 USD Hold'em No Limit - Level II (125/250) - 2025/02/22 17:43:03 WET [2025/02/22 12:43:03 ET]
Table '3858857107 71' 8-max Seat #5 is the button
Seat 1: 578346 (30020 in chips, $2.45 bounty) 
Seat 2: IoannisVaios (21901 in chips, $2.45 bounty) 
Seat 3: SaLouTiGR (16451 in chips, $2.45 bounty) 
Seat 4: LvivskeBear (22267 in chips, $2.45 bounty) 
Seat 5: Kevin12345Mc (33335 in chips, $2.45 bounty) 
Seat 6: taluk_00 (23735 in chips, $2.45 bounty) 
Seat 7: Toppmoller (30658 in chips, $2.45 bounty) 
Seat 8: bereket31 (21633 in chips, $2.45 bounty) 
578346: posts the ante 30
IoannisVaios: posts the ante 30
SaLouTiGR: posts the ante 30
LvivskeBear: posts the ante 30
Kevin12345Mc: posts the ante 30
taluk_00: posts the ante 30
Toppmoller: posts the ante 30
bereket31: posts the ante 30
taluk_00: posts small blind 125
Toppmoller: posts big blind 250
*** HOLE CARDS ***
Dealt to Kevin12345Mc [9c 2h]
bereket31: folds 
578346: folds 
IoannisVaios: folds 
SaLouTiGR: folds 
LvivskeBear: folds 
Kevin12345Mc: folds 
taluk_00: folds 
Uncalled bet (125) returned to Toppmoller
Toppmoller collected 490 from pot
Toppmoller: doesn't show hand 
*** SUMMARY ***
Total pot 490 | Rake 0 
Seat 1: 578346 folded before Flop (didn't bet)
Seat 2: IoannisVaios folded before Flop (didn't bet)
Seat 3: SaLouTiGR folded before Flop (didn't bet)
Seat 4: LvivskeBear folded before Flop (didn't bet)
Seat 5: Kevin12345Mc (button) folded before Flop (didn't bet)
Seat 6: taluk_00 (small blind) folded before Flop
Seat 7: Toppmoller (big blind) collected (490)
Seat 8: bereket31 folded before Flop (didn't bet)



PokerStars Hand #254988340900: Tournament #3858857107, $2.45+$2.45+$0.60 USD Hold'em No Limit - Level II (125/250) - 2025/02/22 17:43:13 WET [2025/02/22 12:43:13 ET]
Table '3858857107 71' 8-max Seat #6 is the button
Seat 1: 578346 (29990 in chips, $2.45 bounty) 
Seat 2: IoannisVaios (21871 in chips, $2.45 bounty) 
Seat 3: SaLouTiGR (16421 in chips, $2.45 bounty) 
Seat 4: LvivskeBear (22237 in chips, $2.45 bounty) 
Seat 5: Kevin12345Mc (33305 in chips, $2.45 bounty) 
Seat 6: taluk_00 (23580 in chips, $2.45 bounty) 
Seat 7: Toppmoller (30993 in chips, $2.45 bounty) 
Seat 8: bereket31 (21603 in chips, $2.45 bounty) 
578346: posts the ante 30
IoannisVaios: posts the ante 30
SaLouTiGR: posts the ante 30
LvivskeBear: posts the ante 30
Kevin12345Mc: posts the ante 30
taluk_00: posts the ante 30
Toppmoller: posts the ante 30
bereket31: posts the ante 30
Toppmoller: posts small blind 125
bereket31: posts big blind 250
*** HOLE CARDS ***
Dealt to Kevin12345Mc [3h 5s]
578346: raises 325 to 575
IoannisVaios: raises 1515 to 2090
SaLouTiGR: folds 
LvivskeBear: folds 
Kevin12345Mc: folds 
taluk_00: folds 
Toppmoller: raises 3535 to 5625
bereket31: folds 
578346: folds 
IoannisVaios: raises 16216 to 21841 and is all-in
Toppmoller: calls 16216
*** FLOP *** [7h Qc Kh]
*** TURN *** [7h Qc Kh] [Qd]
*** RIVER *** [7h Qc Kh Qd] [2h]
*** SHOW DOWN ***
Toppmoller: shows [As Ah] (two pair, Aces and Queens)
IoannisVaios: shows [Kc Kd] (a full house, Kings full of Queens)
IoannisVaios collected 44747 from pot
*** SUMMARY ***
Total pot 44747 | Rake 0 
Board [7h Qc Kh Qd 2h]
Seat 1: 578346 folded before Flop
Seat 2: IoannisVaios showed [Kc Kd] and won (44747) with a full house, Kings full of Queens
Seat 3: SaLouTiGR folded before Flop (didn't bet)
Seat 4: LvivskeBear folded before Flop (didn't bet)
Seat 5: Kevin12345Mc folded before Flop (didn't bet)
Seat 6: taluk_00 (button) folded before Flop (didn't bet)
Seat 7: Toppmoller (small blind) showed [As Ah] and lost with two pair, Aces and Queens
Seat 8: bereket31 (big blind) folded before Flop



PokerStars Hand #254988358088: Tournament #3858857107, $2.45+$2.45+$0.60 USD Hold'em No Limit - Level II (125/250) - 2025/02/22 17:44:21 WET [2025/02/22 12:44:21 ET]
Table '3858857107 71' 8-max Seat #7 is the button
Seat 1: 578346 (29385 in chips, $2.45 bounty) 
Seat 2: IoannisVaios (44747 in chips, $2.45 bounty) 
Seat 3: SaLouTiGR (16391 in chips, $2.45 bounty) 
Seat 4: LvivskeBear (22207 in chips, $2.45 bounty) 
Seat 5: Kevin12345Mc (33275 in chips, $2.45 bounty) 
Seat 6: taluk_00 (23550 in chips, $2.45 bounty) 
Seat 7: Toppmoller (9122 in chips, $2.45 bounty) 
Seat 8: bereket31 (21323 in chips, $2.45 bounty) 
578346: posts the ante 30
IoannisVaios: posts the ante 30
SaLouTiGR: posts the ante 30
LvivskeBear: posts the ante 30
Kevin12345Mc: posts the ante 30
taluk_00: posts the ante 30
Toppmoller: posts the ante 30
bereket31: posts the ante 30
bereket31: posts small blind 125
578346: posts big blind 250
*** HOLE CARDS ***
Dealt to Kevin12345Mc [6c 8s]
IoannisVaios: folds 
SaLouTiGR: folds 
LvivskeBear: folds 
Kevin12345Mc: folds 
taluk_00: folds 
Toppmoller: raises 250 to 500
bereket31: folds 
578346: calls 250
*** FLOP *** [2d Kh Tc]
578346: checks 
Toppmoller: bets 341
578346: calls 341
*** TURN *** [2d Kh Tc] [4h]
578346: checks 
Toppmoller: bets 2000
578346: calls 2000
*** RIVER *** [2d Kh Tc 4h] [8c]
578346: checks 
Toppmoller: checks 
*** SHOW DOWN ***
578346: shows [Kc Jc] (a pair of Kings)
Toppmoller: mucks hand 
578346 collected 6047 from pot
*** SUMMARY ***
Total pot 6047 | Rake 0 
Board [2d Kh Tc 4h 8c]
Seat 1: 578346 (big blind) showed [Kc Jc] and won (6047) with a pair of Kings
Seat 2: IoannisVaios folded before Flop (didn't bet)
Seat 3: SaLouTiGR folded before Flop (didn't bet)
Seat 4: LvivskeBear folded before Flop (didn't bet)
Seat 5: Kevin12345Mc folded before Flop (didn't bet)
Seat 6: taluk_00 folded before Flop (didn't bet)
Seat 7: Toppmoller (button) mucked [Js Qd]
Seat 8: bereket31 (small blind) folded before Flop



PokerStars Hand #254988375203: Tournament #3858857107, $2.45+$2.45+$0.60 USD Hold'em No Limit - Level II (125/250) - 2025/02/22 17:45:29 WET [2025/02/22 12:45:29 ET]
Table '3858857107 71' 8-max Seat #8 is the button
Seat 1: 578346 (32561 in chips, $2.45 bounty) 
Seat 2: IoannisVaios (44717 in chips, $2.45 bounty) 
Seat 3: SaLouTiGR (16361 in chips, $2.45 bounty) 
Seat 4: LvivskeBear (22177 in chips, $2.45 bounty) 
Seat 5: Kevin12345Mc (33245 in chips, $2.45 bounty) 
Seat 6: taluk_00 (23520 in chips, $2.45 bounty) 
Seat 7: Toppmoller (6251 in chips, $2.45 bounty) 
Seat 8: bereket31 (21168 in chips, $2.45 bounty) 
578346: posts the ante 30
IoannisVaios: posts the ante 30
SaLouTiGR: posts the ante 30
LvivskeBear: posts the ante 30
Kevin12345Mc: posts the ante 30
taluk_00: posts the ante 30
Toppmoller: posts the ante 30
bereket31: posts the ante 30
578346: posts small blind 125
IoannisVaios: posts big blind 250
*** HOLE CARDS ***
Dealt to Kevin12345Mc [3d Jd]
SaLouTiGR: calls 250
LvivskeBear: folds 
Kevin12345Mc: folds 
taluk_00: folds 
Toppmoller: folds 
bereket31: folds 
578346: calls 125
IoannisVaios: checks 
*** FLOP *** [9h 5s 9s]
578346: checks 
IoannisVaios: checks 
SaLouTiGR: checks 
*** TURN *** [9h 5s 9s] [6d]
578346: checks 
IoannisVaios: checks 
SaLouTiGR: checks 
*** RIVER *** [9h 5s 9s 6d] [2d]
578346: checks 
IoannisVaios: bets 750
SaLouTiGR: folds 
578346: raises 1992 to 2742
IoannisVaios: raises 41695 to 44437 and is all-in
578346: calls 29539 and is all-in
Uncalled bet (12156) returned to IoannisVaios
*** SHOW DOWN ***
IoannisVaios: shows [2c 2s] (a full house, Deuces full of Nines)
578346: shows [5d 5c] (a full house, Fives full of Nines)
578346 collected 65552 from pot
*** SUMMARY ***
Total pot 65552 | Rake 0 
Board [9h 5s 9s 6d 2d]
Seat 1: 578346 (small blind) showed [5d 5c] and won (65552) with a full house, Fives full of Nines
Seat 2: IoannisVaios (big blind) showed [2c 2s] and lost with a full house, Deuces full of Nines
Seat 3: SaLouTiGR folded on the River
Seat 4: LvivskeBear folded before Flop (didn't bet)
Seat 5: Kevin12345Mc folded before Flop (didn't bet)
Seat 6: taluk_00 folded before Flop (didn't bet)
Seat 7: Toppmoller folded before Flop (didn't bet)
Seat 8: bereket31 (button) folded before Flop (didn't bet)



PokerStars Hand #254988402979: Tournament #3858857107, $2.45+$2.45+$0.60 USD Hold'em No Limit - Level III (150/300) - 2025/02/22 17:47:18 WET [2025/02/22 12:47:18 ET]
Table '3858857107 71' 8-max Seat #1 is the button
Seat 1: 578346 (65552 in chips, $2.45 bounty) 
Seat 2: IoannisVaios (12156 in chips, $2.45 bounty) 
Seat 3: SaLouTiGR (16081 in chips, $2.45 bounty) 
Seat 4: LvivskeBear (22147 in chips, $2.45 bounty) 
Seat 5: Kevin12345Mc (33215 in chips, $2.45 bounty) 
Seat 6: taluk_00 (23490 in chips, $2.45 bounty) 
Seat 7: Toppmoller (6221 in chips, $2.45 bounty) 
Seat 8: bereket31 (21138 in chips, $2.45 bounty) 
578346: posts the ante 40
IoannisVaios: posts the ante 40
SaLouTiGR: posts the ante 40
LvivskeBear: posts the ante 40
Kevin12345Mc: posts the ante 40
taluk_00: posts the ante 40
Toppmoller: posts the ante 40
bereket31: posts the ante 40
IoannisVaios: posts small blind 150
SaLouTiGR: posts big blind 300
*** HOLE CARDS ***
Dealt to Kevin12345Mc [Th 5s]
LvivskeBear: folds 
Kevin12345Mc: folds 
taluk_00: folds 
Toppmoller: folds 
bereket31: raises 600 to 900
578346: folds 
IoannisVaios: folds 
SaLouTiGR: folds 
Uncalled bet (600) returned to bereket31
bereket31 collected 1070 from pot
*** SUMMARY ***
Total pot 1070 | Rake 0 
Seat 1: 578346 (button) folded before Flop (didn't bet)
Seat 2: IoannisVaios (small blind) folded before Flop
Seat 3: SaLouTiGR (big blind) folded before Flop
Seat 4: LvivskeBear folded before Flop (didn't bet)
Seat 5: Kevin12345Mc folded before Flop (didn't bet)
Seat 6: taluk_00 folded before Flop (didn't bet)
Seat 7: Toppmoller folded before Flop (didn't bet)
Seat 8: bereket31 collected (1070)



PokerStars Hand #254988408745: Tournament #3858857107, $2.45+$2.45+$0.60 USD Hold'em No Limit - Level III (150/300) - 2025/02/22 17:47:41 WET [2025/02/22 12:47:41 ET]
Table '3858857107 71' 8-max Seat #2 is the button
Seat 1: 578346 (65512 in chips, $2.45 bounty) 
Seat 2: IoannisVaios (11966 in chips, $2.45 bounty) 
Seat 3: SaLouTiGR (15741 in chips, $2.45 bounty) 
Seat 4: LvivskeBear (22107 in chips, $2.45 bounty) 
Seat 5: Kevin12345Mc (33175 in chips, $2.45 bounty) 
Seat 6: taluk_00 (23450 in chips, $2.45 bounty) 
Seat 7: Toppmoller (6181 in chips, $2.45 bounty) 
Seat 8: bereket31 (21868 in chips, $2.45 bounty) 
578346: posts the ante 40
IoannisVaios: posts the ante 40
SaLouTiGR: posts the ante 40
LvivskeBear: posts the ante 40
Kevin12345Mc: posts the ante 40
taluk_00: posts the ante 40
Toppmoller: posts the ante 40
bereket31: posts the ante 40
SaLouTiGR: posts small blind 150
LvivskeBear: posts big blind 300
*** HOLE CARDS ***
Dealt to Kevin12345Mc [Qs Qh]
Kevin12345Mc: raises 390 to 690
taluk_00: folds 
Toppmoller: folds 
bereket31: folds 
578346: folds 
IoannisVaios: folds 
SaLouTiGR: folds 
LvivskeBear: raises 2310 to 3000
Kevin12345Mc: calls 2310
*** FLOP *** [Qd 6s 2s]
LvivskeBear: bets 2135
Kevin12345Mc: calls 2135
*** TURN *** [Qd 6s 2s] [5c]
LvivskeBear: bets 8270
Kevin12345Mc: calls 8270
*** RIVER *** [Qd 6s 2s 5c] [Js]
LvivskeBear: bets 8662 and is all-in
Kevin12345Mc: calls 8662
*** SHOW DOWN ***
LvivskeBear: shows [Kd Kc] (a pair of Kings)
Kevin12345Mc: shows [Qs Qh] (three of a kind, Queens)
Kevin12345Mc collected 44604 from pot
Kevin12345Mc wins $1.23 for eliminating LvivskeBear and their own bounty increases by $1.22 to $3.67
LvivskeBear finished the tournament
*** SUMMARY ***
Total pot 44604 | Rake 0 
Board [Qd 6s 2s 5c Js]
Seat 1: 578346 folded before Flop (didn't bet)
Seat 2: IoannisVaios (button) folded before Flop (didn't bet)
Seat 3: SaLouTiGR (small blind) folded before Flop
Seat 4: LvivskeBear (big blind) showed [Kd Kc] and lost with a pair of Kings
Seat 5: Kevin12345Mc showed [Qs Qh] and won (44604) with three of a kind, Queens
Seat 6: taluk_00 folded before Flop (didn't bet)
Seat 7: Toppmoller folded before Flop (didn't bet)
Seat 8: bereket31 folded before Flop (didn't bet)



PokerStars Hand #254988426713: Tournament #3858857107, $2.45+$2.45+$0.60 USD Hold'em No Limit - Level III (150/300) - 2025/02/22 17:48:51 WET [2025/02/22 12:48:51 ET]
Table '3858857107 71' 8-max Seat #3 is the button
Seat 1: 578346 (65472 in chips, $2.45 bounty) 
Seat 2: IoannisVaios (11926 in chips, $2.45 bounty) 
Seat 3: SaLouTiGR (15551 in chips, $2.45 bounty) 
Seat 5: Kevin12345Mc (55672 in chips, $3.67 bounty) 
Seat 6: taluk_00 (23410 in chips, $2.45 bounty) 
Seat 7: Toppmoller (6141 in chips, $2.45 bounty) 
Seat 8: bereket31 (21828 in chips, $2.45 bounty) 
578346: posts the ante 40
IoannisVaios: posts the ante 40
SaLouTiGR: posts the ante 40
Kevin12345Mc: posts the ante 40
taluk_00: posts the ante 40
Toppmoller: posts the ante 40
bereket31: posts the ante 40
Kevin12345Mc: posts small blind 150
taluk_00: posts big blind 300
*** HOLE CARDS ***
Dealt to Kevin12345Mc [8c 7h]
Toppmoller: folds 
bereket31: folds 
578346: folds 
IoannisVaios: folds 
SaLouTiGR: folds 
Kevin12345Mc: folds 
Uncalled bet (150) returned to taluk_00
taluk_00 collected 580 from pot
taluk_00: doesn't show hand 
*** SUMMARY ***
Total pot 580 | Rake 0 
Seat 1: 578346 folded before Flop (didn't bet)
Seat 2: IoannisVaios folded before Flop (didn't bet)
Seat 3: SaLouTiGR (button) folded before Flop (didn't bet)
Seat 5: Kevin12345Mc (small blind) folded before Flop
Seat 6: taluk_00 (big blind) collected (580)
Seat 7: Toppmoller folded before Flop (didn't bet)
Seat 8: bereket31 folded before Flop (didn't bet)



PokerStars Hand #254988432516: Tournament #3858857107, $2.45+$2.45+$0.60 USD Hold'em No Limit - Level III (150/300) - 2025/02/22 17:49:14 WET [2025/02/22 12:49:14 ET]
Table '3858857107 71' 8-max Seat #5 is the button
Seat 1: 578346 (65432 in chips, $2.45 bounty) 
Seat 2: IoannisVaios (11886 in chips, $2.45 bounty) 
Seat 3: SaLouTiGR (15511 in chips, $2.45 bounty) 
Seat 4: tabu33 (25000 in chips, $2.45 bounty) 
Seat 5: Kevin12345Mc (55482 in chips, $3.67 bounty) 
Seat 6: taluk_00 (23800 in chips, $2.45 bounty) 
Seat 7: Toppmoller (6101 in chips, $2.45 bounty) 
Seat 8: bereket31 (21788 in chips, $2.45 bounty) 
578346: posts the ante 40
IoannisVaios: posts the ante 40
SaLouTiGR: posts the ante 40
tabu33: posts the ante 40
Kevin12345Mc: posts the ante 40
taluk_00: posts the ante 40
Toppmoller: posts the ante 40
bereket31: posts the ante 40
taluk_00: posts small blind 150
Toppmoller: posts big blind 300
*** HOLE CARDS ***
Dealt to Kevin12345Mc [Kh Tc]
bereket31: folds 
578346: folds 
IoannisVaios: folds 
SaLouTiGR: folds 
tabu33: folds 
Kevin12345Mc: raises 390 to 690
taluk_00: folds 
Toppmoller: folds 
Uncalled bet (390) returned to Kevin12345Mc
Kevin12345Mc collected 1070 from pot
Kevin12345Mc: doesn't show hand 
*** SUMMARY ***
Total pot 1070 | Rake 0 
Seat 1: 578346 folded before Flop (didn't bet)
Seat 2: IoannisVaios folded before Flop (didn't bet)
Seat 3: SaLouTiGR folded before Flop (didn't bet)
Seat 4: tabu33 folded before Flop (didn't bet)
Seat 5: Kevin12345Mc (button) collected (1070)
Seat 6: taluk_00 (small blind) folded before Flop
Seat 7: Toppmoller (big blind) folded before Flop
Seat 8: bereket31 folded before Flop (didn't bet)



PokerStars Hand #254988442546: Tournament #3858857107, $2.45+$2.45+$0.60 USD Hold'em No Limit - Level III (150/300) - 2025/02/22 17:49:54 WET [2025/02/22 12:49:54 ET]
Table '3858857107 71' 8-max Seat #6 is the button
Seat 1: 578346 (65392 in chips, $2.45 bounty) 
Seat 2: IoannisVaios (11846 in chips, $2.45 bounty) 
Seat 3: SaLouTiGR (15471 in chips, $2.45 bounty) 
Seat 4: tabu33 (24960 in chips, $2.45 bounty) 
Seat 5: Kevin12345Mc (56212 in chips, $3.67 bounty) 
Seat 6: taluk_00 (23610 in chips, $2.45 bounty) 
Seat 7: Toppmoller (5761 in chips, $2.45 bounty) 
Seat 8: bereket31 (21748 in chips, $2.45 bounty) 
578346: posts the ante 40
IoannisVaios: posts the ante 40
SaLouTiGR: posts the ante 40
tabu33: posts the ante 40
Kevin12345Mc: posts the ante 40
taluk_00: posts the ante 40
Toppmoller: posts the ante 40
bereket31: posts the ante 40
Toppmoller: posts small blind 150
bereket31: posts big blind 300
*** HOLE CARDS ***
Dealt to Kevin12345Mc [Kd As]
578346: folds 
IoannisVaios: folds 
SaLouTiGR: calls 300
tabu33: folds 
Kevin12345Mc: raises 690 to 990
taluk_00: folds 
Toppmoller: folds 
bereket31: folds 
SaLouTiGR: calls 690
*** FLOP *** [5h Qd 8h]
SaLouTiGR: checks 
Kevin12345Mc: bets 908
SaLouTiGR: folds 
Uncalled bet (908) returned to Kevin12345Mc
Kevin12345Mc collected 2750 from pot
Kevin12345Mc: doesn't show hand 
*** SUMMARY ***
Total pot 2750 | Rake 0 
Board [5h Qd 8h]
Seat 1: 578346 folded before Flop (didn't bet)
Seat 2: IoannisVaios folded before Flop (didn't bet)
Seat 3: SaLouTiGR folded on the Flop
Seat 4: tabu33 folded before Flop (didn't bet)
Seat 5: Kevin12345Mc collected (2750)
Seat 6: taluk_00 (button) folded before Flop (didn't bet)
Seat 7: Toppmoller (small blind) folded before Flop
Seat 8: bereket31 (big blind) folded before Flop



PokerStars Hand #254988458363: Tournament #3858857107, $2.45+$2.45+$0.60 USD Hold'em No Limit - Level III (150/300) - 2025/02/22 17:50:56 WET [2025/02/22 12:50:56 ET]
Table '3858857107 71' 8-max Seat #7 is the button
Seat 1: 578346 (65352 in chips, $2.45 bounty) 
Seat 2: IoannisVaios (11806 in chips, $2.45 bounty) 
Seat 3: SaLouTiGR (14441 in chips, $2.45 bounty) 
Seat 4: tabu33 (24920 in chips, $2.45 bounty) 
Seat 5: Kevin12345Mc (57932 in chips, $3.67 bounty) 
Seat 6: taluk_00 (23570 in chips, $2.45 bounty) 
Seat 7: Toppmoller (5571 in chips, $2.45 bounty) 
Seat 8: bereket31 (21408 in chips, $2.45 bounty) 
578346: posts the ante 40
IoannisVaios: posts the ante 40
SaLouTiGR: posts the ante 40
tabu33: posts the ante 40
Kevin12345Mc: posts the ante 40
taluk_00: posts the ante 40
Toppmoller: posts the ante 40
bereket31: posts the ante 40
bereket31: posts small blind 150
578346: posts big blind 300
*** HOLE CARDS ***
Dealt to Kevin12345Mc [2c 9h]
IoannisVaios: raises 324 to 624
SaLouTiGR: folds 
tabu33: folds 
Kevin12345Mc: folds 
taluk_00: folds 
Toppmoller: folds 
bereket31: folds 
578346: calls 324
*** FLOP *** [As 9d 8c]
578346: checks 
IoannisVaios: checks 
*** TURN *** [As 9d 8c] [Ad]
578346: bets 1374
IoannisVaios: folds 
Uncalled bet (1374) returned to 578346
578346 collected 1718 from pot
578346: doesn't show hand 
*** SUMMARY ***
Total pot 1718 | Rake 0 
Board [As 9d 8c Ad]
Seat 1: 578346 (big blind) collected (1718)
Seat 2: IoannisVaios folded on the Turn
Seat 3: SaLouTiGR folded before Flop (didn't bet)
Seat 4: tabu33 folded before Flop (didn't bet)
Seat 5: Kevin12345Mc folded before Flop (didn't bet)
Seat 6: taluk_00 folded before Flop (didn't bet)
Seat 7: Toppmoller (button) folded before Flop (didn't bet)
Seat 8: bereket31 (small blind) folded before Flop



PokerStars Hand #254988474217: Tournament #3858857107, $2.45+$2.45+$0.60 USD Hold'em No Limit - Level III (150/300) - 2025/02/22 17:51:58 WET [2025/02/22 12:51:58 ET]
Table '3858857107 71' 8-max Seat #8 is the button
Seat 1: 578346 (66406 in chips, $2.45 bounty) 
Seat 2: IoannisVaios (11142 in chips, $2.45 bounty) 
Seat 3: SaLouTiGR (14401 in chips, $2.45 bounty) 
Seat 4: tabu33 (24880 in chips, $2.45 bounty) 
Seat 5: Kevin12345Mc (57892 in chips, $3.67 bounty) 
Seat 6: taluk_00 (23530 in chips, $2.45 bounty) 
Seat 7: Toppmoller (5531 in chips, $2.45 bounty) 
Seat 8: bereket31 (21218 in chips, $2.45 bounty) 
578346: posts the ante 40
IoannisVaios: posts the ante 40
SaLouTiGR: posts the ante 40
tabu33: posts the ante 40
Kevin12345Mc: posts the ante 40
taluk_00: posts the ante 40
Toppmoller: posts the ante 40
bereket31: posts the ante 40
578346: posts small blind 150
IoannisVaios: posts big blind 300
*** HOLE CARDS ***
Dealt to Kevin12345Mc [3h 5h]
SaLouTiGR: folds 
tabu33: folds 
Kevin12345Mc: folds 
taluk_00: raises 300 to 600
Toppmoller: folds 
bereket31: folds 
578346: folds 
IoannisVaios: folds 
Uncalled bet (300) returned to taluk_00
taluk_00 collected 1070 from pot
taluk_00: doesn't show hand 
*** SUMMARY ***
Total pot 1070 | Rake 0 
Seat 1: 578346 (small blind) folded before Flop
Seat 2: IoannisVaios (big blind) folded before Flop
Seat 3: SaLouTiGR folded before Flop (didn't bet)
Seat 4: tabu33 folded before Flop (didn't bet)
Seat 5: Kevin12345Mc folded before Flop (didn't bet)
Seat 6: taluk_00 collected (1070)
Seat 7: Toppmoller folded before Flop (didn't bet)
Seat 8: bereket31 (button) folded before Flop (didn't bet)



PokerStars Hand #254988478015: Tournament #3858857107, $2.45+$2.45+$0.60 USD Hold'em No Limit - Level III (150/300) - 2025/02/22 17:52:12 WET [2025/02/22 12:52:12 ET]
Table '3858857107 71' 8-max Seat #1 is the button
Seat 1: 578346 (66216 in chips, $2.45 bounty) 
Seat 2: IoannisVaios (10802 in chips, $2.45 bounty) 
Seat 3: SaLouTiGR (14361 in chips, $2.45 bounty) 
Seat 4: tabu33 (24840 in chips, $2.45 bounty) 
Seat 5: Kevin12345Mc (57852 in chips, $3.67 bounty) 
Seat 6: taluk_00 (24260 in chips, $2.45 bounty) 
Seat 7: Toppmoller (5491 in chips, $2.45 bounty) 
Seat 8: bereket31 (21178 in chips, $2.45 bounty) 
578346: posts the ante 40
IoannisVaios: posts the ante 40
SaLouTiGR: posts the ante 40
tabu33: posts the ante 40
Kevin12345Mc: posts the ante 40
taluk_00: posts the ante 40
Toppmoller: posts the ante 40
bereket31: posts the ante 40
IoannisVaios: posts small blind 150
SaLouTiGR: posts big blind 300
*** HOLE CARDS ***
Dealt to Kevin12345Mc [9s 7h]
tabu33: folds 
Kevin12345Mc: folds 
taluk_00: folds 
Toppmoller: folds 
bereket31: raises 600 to 900
578346: calls 900
IoannisVaios: folds 
SaLouTiGR: calls 600
*** FLOP *** [6d Ad Jh]
SaLouTiGR: checks 
bereket31: bets 1585
578346: calls 1585
SaLouTiGR: folds 
*** TURN *** [6d Ad Jh] [3c]
bereket31: bets 18653 and is all-in
578346: folds 
Uncalled bet (18653) returned to bereket31
bereket31 collected 6340 from pot
*** SUMMARY ***
Total pot 6340 | Rake 0 
Board [6d Ad Jh 3c]
Seat 1: 578346 (button) folded on the Turn
Seat 2: IoannisVaios (small blind) folded before Flop
Seat 3: SaLouTiGR (big blind) folded on the Flop
Seat 4: tabu33 folded before Flop (didn't bet)
Seat 5: Kevin12345Mc folded before Flop (didn't bet)
Seat 6: taluk_00 folded before Flop (didn't bet)
Seat 7: Toppmoller folded before Flop (didn't bet)
Seat 8: bereket31 collected (6340)



PokerStars Hand #254988506397: Tournament #3858857107, $2.45+$2.45+$0.60 USD Hold'em No Limit - Level IV (175/350) - 2025/02/22 17:54:03 WET [2025/02/22 12:54:03 ET]
Table '3858857107 71' 8-max Seat #2 is the button
Seat 1: 578346 (63691 in chips, $2.45 bounty) 
Seat 2: IoannisVaios (10612 in chips, $2.45 bounty) 
Seat 3: SaLouTiGR (13421 in chips, $2.45 bounty) 
Seat 4: tabu33 (24800 in chips, $2.45 bounty) 
Seat 5: Kevin12345Mc (57812 in chips, $3.67 bounty) 
Seat 6: taluk_00 (24220 in chips, $2.45 bounty) 
Seat 7: Toppmoller (5451 in chips, $2.45 bounty) 
Seat 8: bereket31 (24993 in chips, $2.45 bounty) 
578346: posts the ante 50
IoannisVaios: posts the ante 50
SaLouTiGR: posts the ante 50
tabu33: posts the ante 50
Kevin12345Mc: posts the ante 50
taluk_00: posts the ante 50
Toppmoller: posts the ante 50
bereket31: posts the ante 50
SaLouTiGR: posts small blind 175
tabu33: posts big blind 350
*** HOLE CARDS ***
Dealt to Kevin12345Mc [2h 8d]
Kevin12345Mc: folds 
taluk_00: folds 
Toppmoller: folds 
bereket31: folds 
578346: raises 455 to 805
IoannisVaios: folds 
SaLouTiGR: raises 12566 to 13371 and is all-in
tabu33: folds 
578346: folds 
Uncalled bet (12566) returned to SaLouTiGR
SaLouTiGR collected 2360 from pot
SaLouTiGR: doesn't show hand 
*** SUMMARY ***
Total pot 2360 | Rake 0 
Seat 1: 578346 folded before Flop
Seat 2: IoannisVaios (button) folded before Flop (didn't bet)
Seat 3: SaLouTiGR (small blind) collected (2360)
Seat 4: tabu33 (big blind) folded before Flop
Seat 5: Kevin12345Mc folded before Flop (didn't bet)
Seat 6: taluk_00 folded before Flop (didn't bet)
Seat 7: Toppmoller folded before Flop (didn't bet)
Seat 8: bereket31 folded before Flop (didn't bet)



PokerStars Hand #254988519206: Tournament #3858857107, $2.45+$2.45+$0.60 USD Hold'em No Limit - Level IV (175/350) - 2025/02/22 17:54:54 WET [2025/02/22 12:54:54 ET]
Table '3858857107 71' 8-max Seat #3 is the button
Seat 1: 578346 (62836 in chips, $2.45 bounty) 
Seat 2: IoannisVaios (10562 in chips, $2.45 bounty) 
Seat 3: SaLouTiGR (14926 in chips, $2.45 bounty) 
Seat 4: tabu33 (24400 in chips, $2.45 bounty) 
Seat 5: Kevin12345Mc (57762 in chips, $3.67 bounty) 
Seat 6: taluk_00 (24170 in chips, $2.45 bounty) 
Seat 7: Toppmoller (5401 in chips, $2.45 bounty) 
Seat 8: bereket31 (24943 in chips, $2.45 bounty) 
578346: posts the ante 50
IoannisVaios: posts the ante 50
SaLouTiGR: posts the ante 50
tabu33: posts the ante 50
Kevin12345Mc: posts the ante 50
taluk_00: posts the ante 50
Toppmoller: posts the ante 50
bereket31: posts the ante 50
tabu33: posts small blind 175
Kevin12345Mc: posts big blind 350
*** HOLE CARDS ***
Dealt to Kevin12345Mc [5d 9d]
taluk_00: folds 
Toppmoller: folds 
bereket31: folds 
578346: folds 
IoannisVaios: raises 378 to 728
SaLouTiGR: folds 
tabu33: folds 
Kevin12345Mc: calls 378
*** FLOP *** [Jd Jh Qs]
Kevin12345Mc: checks 
IoannisVaios: checks 
*** TURN *** [Jd Jh Qs] [2d]
Kevin12345Mc: checks 
IoannisVaios: checks 
*** RIVER *** [Jd Jh Qs 2d] [8d]
Kevin12345Mc: bets 670
IoannisVaios: raises 670 to 1340
Kevin12345Mc: calls 670
*** SHOW DOWN ***
IoannisVaios: shows [Ad Qc] (two pair, Queens and Jacks)
Kevin12345Mc: shows [5d 9d] (a flush, Jack high)
Kevin12345Mc collected 4711 from pot
*** SUMMARY ***
Total pot 4711 | Rake 0 
Board [Jd Jh Qs 2d 8d]
Seat 1: 578346 folded before Flop (didn't bet)
Seat 2: IoannisVaios showed [Ad Qc] and lost with two pair, Queens and Jacks
Seat 3: SaLouTiGR (button) folded before Flop (didn't bet)
Seat 4: tabu33 (small blind) folded before Flop
Seat 5: Kevin12345Mc (big blind) showed [5d 9d] and won (4711) with a flush, Jack high
Seat 6: taluk_00 folded before Flop (didn't bet)
Seat 7: Toppmoller folded before Flop (didn't bet)
Seat 8: bereket31 folded before Flop (didn't bet)



PokerStars Hand #254988632118: Tournament #3858857107, $2.45+$2.45+$0.60 USD Hold'em No Limit - Level IV (175/350) - 2025/02/22 18:04:04 WET [2025/02/22 13:04:04 ET]
Table '3858857107 71' 8-max Seat #4 is the button
Seat 1: 578346 (62786 in chips, $2.45 bounty) 
Seat 2: IoannisVaios (8444 in chips, $2.45 bounty) 
Seat 3: SaLouTiGR (14876 in chips, $2.45 bounty) 
Seat 4: tabu33 (24175 in chips, $2.45 bounty) 
Seat 5: Kevin12345Mc (60355 in chips, $3.67 bounty) 
Seat 6: taluk_00 (24120 in chips, $2.45 bounty) 
Seat 7: Toppmoller (5351 in chips, $2.45 bounty) 
Seat 8: bereket31 (24893 in chips, $2.45 bounty) 
578346: posts the ante 50
IoannisVaios: posts the ante 50
SaLouTiGR: posts the ante 50
tabu33: posts the ante 50
Kevin12345Mc: posts the ante 50
taluk_00: posts the ante 50
Toppmoller: posts the ante 50
bereket31: posts the ante 50
Kevin12345Mc: posts small blind 175
taluk_00: posts big blind 350
*** HOLE CARDS ***
Dealt to Kevin12345Mc [4h 7s]
Toppmoller: folds 
bereket31: folds 
578346: folds 
IoannisVaios: raises 8044 to 8394 and is all-in
SaLouTiGR: folds 
tabu33: folds 
Kevin12345Mc: folds 
taluk_00: folds 
Uncalled bet (8044) returned to IoannisVaios
IoannisVaios collected 1275 from pot
IoannisVaios: doesn't show hand 
*** SUMMARY ***
Total pot 1275 | Rake 0 
Seat 1: 578346 folded before Flop (didn't bet)
Seat 2: IoannisVaios collected (1275)
Seat 3: SaLouTiGR folded before Flop (didn't bet)
Seat 4: tabu33 (button) folded before Flop (didn't bet)
Seat 5: Kevin12345Mc (small blind) folded before Flop
Seat 6: taluk_00 (big blind) folded before Flop
Seat 7: Toppmoller folded before Flop (didn't bet)
Seat 8: bereket31 folded before Flop (didn't bet)



PokerStars Hand #254988639542: Tournament #3858857107, $2.45+$2.45+$0.60 USD Hold'em No Limit - Level IV (175/350) - 2025/02/22 18:04:33 WET [2025/02/22 13:04:33 ET]
Table '3858857107 71' 8-max Seat #5 is the button
Seat 1: 578346 (62736 in chips, $2.45 bounty) 
Seat 2: IoannisVaios (9319 in chips, $2.45 bounty) 
Seat 3: SaLouTiGR (14826 in chips, $2.45 bounty) 
Seat 4: tabu33 (24125 in chips, $2.45 bounty) 
Seat 5: Kevin12345Mc (60130 in chips, $3.67 bounty) 
Seat 6: taluk_00 (23720 in chips, $2.45 bounty) 
Seat 8: bereket31 (24843 in chips, $2.45 bounty) 
578346: posts the ante 50
IoannisVaios: posts the ante 50
SaLouTiGR: posts the ante 50
tabu33: posts the ante 50
Kevin12345Mc: posts the ante 50
taluk_00: posts the ante 50
bereket31: posts the ante 50
taluk_00: posts small blind 175
bereket31: posts big blind 350
*** HOLE CARDS ***
Dealt to Kevin12345Mc [7d Th]
578346: folds 
IoannisVaios: folds 
SaLouTiGR: calls 350
MahSandrs is disconnected 
tabu33: folds 
Kevin12345Mc: folds 
taluk_00: folds 
bereket31: checks 
*** FLOP *** [Qd Jc As]
bereket31: checks 
SaLouTiGR: checks 
*** TURN *** [Qd Jc As] [Kc]
bereket31: checks 
SaLouTiGR: bets 350
bereket31: folds 
Uncalled bet (350) returned to SaLouTiGR
SaLouTiGR collected 1225 from pot
SaLouTiGR: doesn't show hand 
*** SUMMARY ***
Total pot 1225 | Rake 0 
Board [Qd Jc As Kc]
Seat 1: 578346 folded before Flop (didn't bet)
Seat 2: IoannisVaios folded before Flop (didn't bet)
Seat 3: SaLouTiGR collected (1225)
Seat 4: tabu33 folded before Flop (didn't bet)
Seat 5: Kevin12345Mc (button) folded before Flop (didn't bet)
Seat 6: taluk_00 (small blind) folded before Flop
Seat 8: bereket31 (big blind) folded on the Turn



PokerStars Hand #254988647877: Tournament #3858857107, $2.45+$2.45+$0.60 USD Hold'em No Limit - Level IV (175/350) - 2025/02/22 18:05:04 WET [2025/02/22 13:05:04 ET]
Table '3858857107 71' 8-max Seat #6 is the button
Seat 1: 578346 (62686 in chips, $2.45 bounty) 
Seat 2: IoannisVaios (9269 in chips, $2.45 bounty) 
Seat 3: SaLouTiGR (15651 in chips, $2.45 bounty) 
Seat 4: tabu33 (24075 in chips, $2.45 bounty) 
Seat 5: Kevin12345Mc (60080 in chips, $3.67 bounty) 
Seat 6: taluk_00 (23495 in chips, $2.45 bounty) 
Seat 7: MahSandrs (25000 in chips) out of hand (moved from another table into small blind)
Seat 8: bereket31 (24443 in chips, $2.45 bounty) 
MahSandrs will be allowed to play after the button
578346: posts the ante 50
IoannisVaios: posts the ante 50
SaLouTiGR: posts the ante 50
tabu33: posts the ante 50
Kevin12345Mc: posts the ante 50
taluk_00: posts the ante 50
bereket31: posts the ante 50
bereket31: posts small blind 175
578346: posts big blind 350
*** HOLE CARDS ***
Dealt to Kevin12345Mc [Qc Ah]
IoannisVaios: folds 
SaLouTiGR: folds 
tabu33: calls 350
Kevin12345Mc: raises 455 to 805
taluk_00: folds 
bereket31: folds 
578346: calls 455
tabu33: folds 
*** FLOP *** [7s Kh 3c]
578346: checks 
Kevin12345Mc: bets 820
578346: calls 820
*** TURN *** [7s Kh 3c] [8h]
578346: checks 
Kevin12345Mc: checks 
*** RIVER *** [7s Kh 3c 8h] [9h]
578346: bets 3300
Kevin12345Mc: folds 
Uncalled bet (3300) returned to 578346
578346 collected 4125 from pot
578346: doesn't show hand 
*** SUMMARY ***
Total pot 4125 | Rake 0 
Board [7s Kh 3c 8h 9h]
Seat 1: 578346 (big blind) collected (4125)
Seat 2: IoannisVaios folded before Flop (didn't bet)
Seat 3: SaLouTiGR folded before Flop (didn't bet)
Seat 4: tabu33 folded before Flop
Seat 5: Kevin12345Mc folded on the River
Seat 6: taluk_00 (button) folded before Flop (didn't bet)
Seat 8: bereket31 (small blind) folded before Flop



PokerStars Hand #254988669351: Tournament #3858857107, $2.45+$2.45+$0.60 USD Hold'em No Limit - Level IV (175/350) - 2025/02/22 18:06:27 WET [2025/02/22 13:06:27 ET]
Table '3858857107 71' 8-max Seat #8 is the button
Seat 1: 578346 (65136 in chips, $2.45 bounty) 
Seat 2: IoannisVaios (9219 in chips, $2.45 bounty) 
Seat 3: SaLouTiGR (15601 in chips, $2.45 bounty) 
Seat 4: tabu33 (23675 in chips, $2.45 bounty) 
Seat 5: Kevin12345Mc (58405 in chips, $3.67 bounty) 
Seat 6: taluk_00 (23445 in chips, $2.45 bounty) 
Seat 7: MahSandrs (25000 in chips, $2.45 bounty) 
Seat 8: bereket31 (24218 in chips, $2.45 bounty) 
578346: posts the ante 50
IoannisVaios: posts the ante 50
SaLouTiGR: posts the ante 50
tabu33: posts the ante 50
Kevin12345Mc: posts the ante 50
taluk_00: posts the ante 50
MahSandrs: posts the ante 50
bereket31: posts the ante 50
578346: posts small blind 175
IoannisVaios: posts big blind 350
*** HOLE CARDS ***
Dealt to Kevin12345Mc [9c Kh]
SaLouTiGR: folds 
tabu33: folds 
Kevin12345Mc: folds 
taluk_00: folds 
MahSandrs: raises 350 to 700
bereket31: calls 700
578346: folds 
IoannisVaios: folds 
*** FLOP *** [7s 3s 2h]
MahSandrs: checks 
bereket31: checks 
*** TURN *** [7s 3s 2h] [Td]
MahSandrs: checks 
bereket31: checks 
*** RIVER *** [7s 3s 2h Td] [4s]
MahSandrs: bets 3486
bereket31: folds 
Uncalled bet (3486) returned to MahSandrs
MahSandrs collected 2325 from pot
MahSandrs: doesn't show hand 
*** SUMMARY ***
Total pot 2325 | Rake 0 
Board [7s 3s 2h Td 4s]
Seat 1: 578346 (small blind) folded before Flop
Seat 2: IoannisVaios (big blind) folded before Flop
Seat 3: SaLouTiGR folded before Flop (didn't bet)
Seat 4: tabu33 folded before Flop (didn't bet)
Seat 5: Kevin12345Mc folded before Flop (didn't bet)
Seat 6: taluk_00 folded before Flop (didn't bet)
Seat 7: MahSandrs collected (2325)
Seat 8: bereket31 (button) folded on the River



PokerStars Hand #254988693418: Tournament #3858857107, $2.45+$2.45+$0.60 USD Hold'em No Limit - Level IV (175/350) - 2025/02/22 18:08:00 WET [2025/02/22 13:08:00 ET]
Table '3858857107 71' 8-max Seat #1 is the button
Seat 1: 578346 (64911 in chips, $2.45 bounty) 
Seat 2: IoannisVaios (8819 in chips, $2.45 bounty) 
Seat 3: SaLouTiGR (15551 in chips, $2.45 bounty) 
Seat 4: tabu33 (23625 in chips, $2.45 bounty) 
Seat 5: Kevin12345Mc (58355 in chips, $3.67 bounty) 
Seat 6: taluk_00 (23395 in chips, $2.45 bounty) 
Seat 7: MahSandrs (26575 in chips, $2.45 bounty) 
Seat 8: bereket31 (23468 in chips, $2.45 bounty) 
578346: posts the ante 50
IoannisVaios: posts the ante 50
SaLouTiGR: posts the ante 50
tabu33: posts the ante 50
Kevin12345Mc: posts the ante 50
taluk_00: posts the ante 50
MahSandrs: posts the ante 50
bereket31: posts the ante 50
IoannisVaios: posts small blind 175
SaLouTiGR: posts big blind 350
*** HOLE CARDS ***
Dealt to Kevin12345Mc [Tc 3c]
tabu33: folds 
Kevin12345Mc: folds 
taluk_00: folds 
MahSandrs: folds 
bereket31: raises 700 to 1050
578346: folds 
IoannisVaios: calls 875
SaLouTiGR: folds 
*** FLOP *** [5d As 7s]
IoannisVaios: checks 
bereket31: checks 
*** TURN *** [5d As 7s] [Jh]
IoannisVaios: checks 
bereket31: bets 1425
IoannisVaios: calls 1425
*** RIVER *** [5d As 7s Jh] [4d]
IoannisVaios: checks 
bereket31: checks 
*** SHOW DOWN ***
IoannisVaios: shows [8d Jd] (a pair of Jacks)
bereket31: mucks hand 
IoannisVaios collected 5700 from pot
*** SUMMARY ***
Total pot 5700 | Rake 0 
Board [5d As 7s Jh 4d]
Seat 1: 578346 (button) folded before Flop (didn't bet)
Seat 2: IoannisVaios (small blind) showed [8d Jd] and won (5700) with a pair of Jacks
Seat 3: SaLouTiGR (big blind) folded before Flop
Seat 4: tabu33 folded before Flop (didn't bet)
Seat 5: Kevin12345Mc folded before Flop (didn't bet)
Seat 6: taluk_00 folded before Flop (didn't bet)
Seat 7: MahSandrs folded before Flop (didn't bet)
Seat 8: bereket31 mucked [9s 9d]



PokerStars Hand #254988709332: Tournament #3858857107, $2.45+$2.45+$0.60 USD Hold'em No Limit - Level IV (175/350) - 2025/02/22 18:09:02 WET [2025/02/22 13:09:02 ET]
Table '3858857107 71' 8-max Seat #2 is the button
Seat 1: 578346 (64861 in chips, $2.45 bounty) 
Seat 2: IoannisVaios (11994 in chips, $2.45 bounty) 
Seat 3: SaLouTiGR (15151 in chips, $2.45 bounty) 
Seat 4: tabu33 (23575 in chips, $2.45 bounty) 
Seat 5: Kevin12345Mc (58305 in chips, $3.67 bounty) 
Seat 6: taluk_00 (23345 in chips, $2.45 bounty) 
Seat 7: MahSandrs (26525 in chips, $2.45 bounty) 
Seat 8: bereket31 (20943 in chips, $2.45 bounty) 
578346: posts the ante 50
IoannisVaios: posts the ante 50
SaLouTiGR: posts the ante 50
tabu33: posts the ante 50
Kevin12345Mc: posts the ante 50
taluk_00: posts the ante 50
MahSandrs: posts the ante 50
bereket31: posts the ante 50
SaLouTiGR: posts small blind 175
tabu33: posts big blind 350
*** HOLE CARDS ***
Dealt to Kevin12345Mc [Jd 6h]
Kevin12345Mc: folds 
taluk_00: folds 
MahSandrs: folds 
bereket31: folds 
578346: raises 700 to 1050
IoannisVaios: calls 1050
SaLouTiGR: calls 875
tabu33: folds 
*** FLOP *** [9c 7s 6c]
SaLouTiGR: bets 350
578346: calls 350
IoannisVaios: calls 350
*** TURN *** [9c 7s 6c] [Kd]
SaLouTiGR: bets 350
578346: calls 350
IoannisVaios: raises 3850 to 4200
SaLouTiGR: calls 3850
578346: folds 
*** RIVER *** [9c 7s 6c Kd] [Ts]
SaLouTiGR: checks 
IoannisVaios: bets 6344 and is all-in
SaLouTiGR: folds 
Uncalled bet (6344) returned to IoannisVaios
IoannisVaios collected 13700 from pot
IoannisVaios: doesn't show hand 
*** SUMMARY ***
Total pot 13700 | Rake 0 
Board [9c 7s 6c Kd Ts]
Seat 1: 578346 folded on the Turn
Seat 2: IoannisVaios (button) collected (13700)
Seat 3: SaLouTiGR (small blind) folded on the River
Seat 4: tabu33 (big blind) folded before Flop
Seat 5: Kevin12345Mc folded before Flop (didn't bet)
Seat 6: taluk_00 folded before Flop (didn't bet)
Seat 7: MahSandrs folded before Flop (didn't bet)
Seat 8: bereket31 folded before Flop (didn't bet)



PokerStars Hand #254988729506: Tournament #3858857107, $2.45+$2.45+$0.60 USD Hold'em No Limit - Level IV (175/350) - 2025/02/22 18:10:19 WET [2025/02/22 13:10:19 ET]
Table '3858857107 71' 8-max Seat #3 is the button
Seat 1: 578346 (63061 in chips, $2.45 bounty) 
Seat 2: IoannisVaios (20044 in chips, $2.45 bounty) 
Seat 3: SaLouTiGR (9501 in chips, $2.45 bounty) 
Seat 4: tabu33 (23175 in chips, $2.45 bounty) 
Seat 5: Kevin12345Mc (58255 in chips, $3.67 bounty) 
Seat 6: taluk_00 (23295 in chips, $2.45 bounty) 
Seat 7: MahSandrs (26475 in chips, $2.45 bounty) 
Seat 8: bereket31 (20893 in chips, $2.45 bounty) 
578346: posts the ante 50
IoannisVaios: posts the ante 50
SaLouTiGR: posts the ante 50
tabu33: posts the ante 50
Kevin12345Mc: posts the ante 50
taluk_00: posts the ante 50
MahSandrs: posts the ante 50
bereket31: posts the ante 50
tabu33: posts small blind 175
Kevin12345Mc: posts big blind 350
*** HOLE CARDS ***
Dealt to Kevin12345Mc [8h Kd]
taluk_00: folds 
MahSandrs: folds 
bereket31: folds 
578346: folds 
IoannisVaios: folds 
SaLouTiGR: calls 350
tabu33: folds 
Kevin12345Mc: checks 
*** FLOP *** [2h Th Ah]
Kevin12345Mc: checks 
SaLouTiGR: bets 1050
Kevin12345Mc: calls 1050
*** TURN *** [2h Th Ah] [5s]
Kevin12345Mc: checks 
SaLouTiGR: checks 
*** RIVER *** [2h Th Ah 5s] [Kc]
Kevin12345Mc: checks 
SaLouTiGR: checks 
*** SHOW DOWN ***
Kevin12345Mc: shows [8h Kd] (a pair of Kings)
SaLouTiGR: mucks hand 
Kevin12345Mc collected 3375 from pot
*** SUMMARY ***
Total pot 3375 | Rake 0 
Board [2h Th Ah 5s Kc]
Seat 1: 578346 folded before Flop (didn't bet)
Seat 2: IoannisVaios folded before Flop (didn't bet)
Seat 3: SaLouTiGR (button) mucked [7d Td]
Seat 4: tabu33 (small blind) folded before Flop
Seat 5: Kevin12345Mc (big blind) showed [8h Kd] and won (3375) with a pair of Kings
Seat 6: taluk_00 folded before Flop (didn't bet)
Seat 7: MahSandrs folded before Flop (didn't bet)
Seat 8: bereket31 folded before Flop (didn't bet)



PokerStars Hand #254988744406: Tournament #3858857107, $2.45+$2.45+$0.60 USD Hold'em No Limit - Level V (200/400) - 2025/02/22 18:11:16 WET [2025/02/22 13:11:16 ET]
Table '3858857107 71' 8-max Seat #4 is the button
Seat 1: 578346 (63011 in chips, $2.45 bounty) 
Seat 2: IoannisVaios (19994 in chips, $2.45 bounty) 
Seat 3: SaLouTiGR (8051 in chips, $2.45 bounty) 
Seat 4: tabu33 (22950 in chips, $2.45 bounty) 
Seat 5: Kevin12345Mc (60180 in chips, $3.67 bounty) 
Seat 6: taluk_00 (23245 in chips, $2.45 bounty) 
Seat 7: MahSandrs (26425 in chips, $2.45 bounty) 
Seat 8: bereket31 (20843 in chips, $2.45 bounty) 
578346: posts the ante 60
IoannisVaios: posts the ante 60
SaLouTiGR: posts the ante 60
tabu33: posts the ante 60
Kevin12345Mc: posts the ante 60
taluk_00: posts the ante 60
MahSandrs: posts the ante 60
bereket31: posts the ante 60
Kevin12345Mc: posts small blind 200
taluk_00: posts big blind 400
*** HOLE CARDS ***
Dealt to Kevin12345Mc [9s 3h]
MahSandrs: folds 
bereket31: calls 400
578346: folds 
IoannisVaios: raises 800 to 1200
SaLouTiGR: raises 6791 to 7991 and is all-in
tabu33: folds 
Kevin12345Mc: folds 
taluk_00: folds 
bereket31: folds 
IoannisVaios: folds 
Uncalled bet (6791) returned to SaLouTiGR
SaLouTiGR collected 3880 from pot
SaLouTiGR: doesn't show hand 
*** SUMMARY ***
Total pot 3880 | Rake 0 
Seat 1: 578346 folded before Flop (didn't bet)
Seat 2: IoannisVaios folded before Flop
Seat 3: SaLouTiGR collected (3880)
Seat 4: tabu33 (button) folded before Flop (didn't bet)
Seat 5: Kevin12345Mc (small blind) folded before Flop
Seat 6: taluk_00 (big blind) folded before Flop
Seat 7: MahSandrs folded before Flop (didn't bet)
Seat 8: bereket31 folded before Flop



PokerStars Hand #254988753425: Tournament #3858857107, $2.45+$2.45+$0.60 USD Hold'em No Limit - Level V (200/400) - 2025/02/22 18:11:49 WET [2025/02/22 13:11:49 ET]
Table '3858857107 71' 8-max Seat #5 is the button
Seat 1: 578346 (62951 in chips, $2.45 bounty) 
Seat 2: IoannisVaios (18734 in chips, $2.45 bounty) 
Seat 3: SaLouTiGR (10671 in chips, $2.45 bounty) 
Seat 4: tabu33 (22890 in chips, $2.45 bounty) 
Seat 5: Kevin12345Mc (59920 in chips, $3.67 bounty) 
Seat 6: taluk_00 (22785 in chips, $2.45 bounty) 
Seat 7: MahSandrs (26365 in chips, $2.45 bounty) 
Seat 8: bereket31 (20383 in chips, $2.45 bounty) 
578346: posts the ante 60
IoannisVaios: posts the ante 60
SaLouTiGR: posts the ante 60
tabu33: posts the ante 60
Kevin12345Mc: posts the ante 60
taluk_00: posts the ante 60
MahSandrs: posts the ante 60
bereket31: posts the ante 60
taluk_00: posts small blind 200
MahSandrs: posts big blind 400
*** HOLE CARDS ***
Dealt to Kevin12345Mc [7h Qc]
bereket31: folds 
578346: folds 
IoannisVaios: folds 
SaLouTiGR: folds 
tabu33: raises 400 to 800
Kevin12345Mc: folds 
taluk_00: folds 
MahSandrs: calls 400
*** FLOP *** [Tc 4s Jh]
MahSandrs: checks 
tabu33: checks 
*** TURN *** [Tc 4s Jh] [9c]
MahSandrs: checks 
tabu33: checks 
*** RIVER *** [Tc 4s Jh 9c] [3d]
MahSandrs: bets 752
tabu33: folds 
Uncalled bet (752) returned to MahSandrs
MahSandrs collected 2280 from pot
MahSandrs: doesn't show hand 
*** SUMMARY ***
Total pot 2280 | Rake 0 
Board [Tc 4s Jh 9c 3d]
Seat 1: 578346 folded before Flop (didn't bet)
Seat 2: IoannisVaios folded before Flop (didn't bet)
Seat 3: SaLouTiGR folded before Flop (didn't bet)
Seat 4: tabu33 folded on the River
Seat 5: Kevin12345Mc (button) folded before Flop (didn't bet)
Seat 6: taluk_00 (small blind) folded before Flop
Seat 7: MahSandrs (big blind) collected (2280)
Seat 8: bereket31 folded before Flop (didn't bet)



PokerStars Hand #254988773913: Tournament #3858857107, $2.45+$2.45+$0.60 USD Hold'em No Limit - Level V (200/400) - 2025/02/22 18:13:08 WET [2025/02/22 13:13:08 ET]
Table '3858857107 71' 8-max Seat #6 is the button
Seat 1: 578346 (62891 in chips, $2.45 bounty) 
Seat 2: IoannisVaios (18674 in chips, $2.45 bounty) 
Seat 3: SaLouTiGR (10611 in chips, $2.45 bounty) 
Seat 4: tabu33 (22030 in chips, $2.45 bounty) 
Seat 5: Kevin12345Mc (59860 in chips, $3.67 bounty) 
Seat 6: taluk_00 (22525 in chips, $2.45 bounty) 
Seat 7: MahSandrs (27785 in chips, $2.45 bounty) 
Seat 8: bereket31 (20323 in chips, $2.45 bounty) 
578346: posts the ante 60
IoannisVaios: posts the ante 60
SaLouTiGR: posts the ante 60
tabu33: posts the ante 60
Kevin12345Mc: posts the ante 60
taluk_00: posts the ante 60
MahSandrs: posts the ante 60
bereket31: posts the ante 60
MahSandrs: posts small blind 200
bereket31: posts big blind 400
*** HOLE CARDS ***
Dealt to Kevin12345Mc [2c 9d]
578346: folds 
IoannisVaios: folds 
SaLouTiGR: folds 
tabu33: raises 400 to 800
Kevin12345Mc: folds 
taluk_00: folds 
MahSandrs: folds 
bereket31: folds 
Uncalled bet (400) returned to tabu33
tabu33 collected 1480 from pot
tabu33: doesn't show hand 
*** SUMMARY ***
Total pot 1480 | Rake 0 
Seat 1: 578346 folded before Flop (didn't bet)
Seat 2: IoannisVaios folded before Flop (didn't bet)
Seat 3: SaLouTiGR folded before Flop (didn't bet)
Seat 4: tabu33 collected (1480)
Seat 5: Kevin12345Mc folded before Flop (didn't bet)
Seat 6: taluk_00 (button) folded before Flop (didn't bet)
Seat 7: MahSandrs (small blind) folded before Flop
Seat 8: bereket31 (big blind) folded before Flop



PokerStars Hand #254988779432: Tournament #3858857107, $2.45+$2.45+$0.60 USD Hold'em No Limit - Level V (200/400) - 2025/02/22 18:13:29 WET [2025/02/22 13:13:29 ET]
Table '3858857107 71' 8-max Seat #7 is the button
Seat 1: 578346 (62831 in chips, $2.45 bounty) 
Seat 2: IoannisVaios (18614 in chips, $2.45 bounty) 
Seat 3: SaLouTiGR (10551 in chips, $2.45 bounty) 
Seat 4: tabu33 (23050 in chips, $2.45 bounty) 
Seat 5: Kevin12345Mc (59800 in chips, $3.67 bounty) 
Seat 6: taluk_00 (22465 in chips, $2.45 bounty) 
Seat 7: MahSandrs (27525 in chips, $2.45 bounty) 
Seat 8: bereket31 (19863 in chips, $2.45 bounty) 
578346: posts the ante 60
IoannisVaios: posts the ante 60
SaLouTiGR: posts the ante 60
tabu33: posts the ante 60
Kevin12345Mc: posts the ante 60
taluk_00: posts the ante 60
MahSandrs: posts the ante 60
bereket31: posts the ante 60
bereket31: posts small blind 200
578346: posts big blind 400
*** HOLE CARDS ***
Dealt to Kevin12345Mc [2s 7s]
IoannisVaios: folds 
SaLouTiGR: calls 400
tabu33: folds 
Kevin12345Mc: folds 
taluk_00: calls 400
MahSandrs: folds 
bereket31: calls 200
578346: raises 1600 to 2000
SaLouTiGR: calls 1600
taluk_00: calls 1600
bereket31: folds 
*** FLOP *** [3h 6s Ts]
578346: checks 
SaLouTiGR: checks 
taluk_00: checks 
*** TURN *** [3h 6s Ts] [Qh]
578346: checks 
SaLouTiGR: checks 
taluk_00: checks 
*** RIVER *** [3h 6s Ts Qh] [Qd]
578346: bets 1200
SaLouTiGR: folds 
taluk_00: calls 1200
*** SHOW DOWN ***
578346: shows [9h 9d] (two pair, Queens and Nines)
taluk_00: mucks hand 
578346 collected 9280 from pot
*** SUMMARY ***
Total pot 9280 | Rake 0 
Board [3h 6s Ts Qh Qd]
Seat 1: 578346 (big blind) showed [9h 9d] and won (9280) with two pair, Queens and Nines
Seat 2: IoannisVaios folded before Flop (didn't bet)
Seat 3: SaLouTiGR folded on the River
Seat 4: tabu33 folded before Flop (didn't bet)
Seat 5: Kevin12345Mc folded before Flop (didn't bet)
Seat 6: taluk_00 mucked [5h 5d]
Seat 7: MahSandrs (button) folded before Flop (didn't bet)
Seat 8: bereket31 (small blind) folded before Flop



PokerStars Hand #254988798323: Tournament #3858857107, $2.45+$2.45+$0.60 USD Hold'em No Limit - Level V (200/400) - 2025/02/22 18:14:41 WET [2025/02/22 13:14:41 ET]
Table '3858857107 71' 8-max Seat #8 is the button
Seat 1: 578346 (68851 in chips, $2.45 bounty) 
Seat 2: IoannisVaios (18554 in chips, $2.45 bounty) 
Seat 3: SaLouTiGR (8491 in chips, $2.45 bounty) 
Seat 4: tabu33 (22990 in chips, $2.45 bounty) 
Seat 5: Kevin12345Mc (59740 in chips, $3.67 bounty) 
Seat 6: taluk_00 (19205 in chips, $2.45 bounty) 
Seat 7: MahSandrs (27465 in chips, $2.45 bounty) 
Seat 8: bereket31 (19403 in chips, $2.45 bounty) 
578346: posts the ante 60
IoannisVaios: posts the ante 60
SaLouTiGR: posts the ante 60
tabu33: posts the ante 60
Kevin12345Mc: posts the ante 60
taluk_00: posts the ante 60
MahSandrs: posts the ante 60
bereket31: posts the ante 60
578346: posts small blind 200
IoannisVaios: posts big blind 400
*** HOLE CARDS ***
Dealt to Kevin12345Mc [Ad 4h]
SaLouTiGR: folds 
tabu33: folds 
Kevin12345Mc: folds 
taluk_00: raises 400 to 800
MahSandrs: folds 
bereket31: calls 800
578346: calls 600
IoannisVaios: folds 
*** FLOP *** [6h 2h Jc]
578346: checks 
taluk_00: bets 1082
bereket31: folds 
578346: folds 
Uncalled bet (1082) returned to taluk_00
taluk_00 collected 3280 from pot
taluk_00: doesn't show hand 
*** SUMMARY ***
Total pot 3280 | Rake 0 
Board [6h 2h Jc]
Seat 1: 578346 (small blind) folded on the Flop
Seat 2: IoannisVaios (big blind) folded before Flop
Seat 3: SaLouTiGR folded before Flop (didn't bet)
Seat 4: tabu33 folded before Flop (didn't bet)
Seat 5: Kevin12345Mc folded before Flop (didn't bet)
Seat 6: taluk_00 collected (3280)
Seat 7: MahSandrs folded before Flop (didn't bet)
Seat 8: bereket31 (button) folded on the Flop



PokerStars Hand #254988817395: Tournament #3858857107, $2.45+$2.45+$0.60 USD Hold'em No Limit - Level V (200/400) - 2025/02/22 18:15:50 WET [2025/02/22 13:15:50 ET]
Table '3858857107 71' 8-max Seat #1 is the button
Seat 1: 578346 (67991 in chips, $2.45 bounty) 
Seat 2: IoannisVaios (18094 in chips, $2.45 bounty) 
Seat 3: SaLouTiGR (8431 in chips, $2.45 bounty) 
Seat 4: tabu33 (22930 in chips, $2.45 bounty) 
Seat 5: Kevin12345Mc (59680 in chips, $3.67 bounty) 
Seat 6: taluk_00 (21625 in chips, $2.45 bounty) 
Seat 7: MahSandrs (27405 in chips, $2.45 bounty) 
Seat 8: bereket31 (18543 in chips, $2.45 bounty) 
578346: posts the ante 60
IoannisVaios: posts the ante 60
SaLouTiGR: posts the ante 60
tabu33: posts the ante 60
Kevin12345Mc: posts the ante 60
taluk_00: posts the ante 60
MahSandrs: posts the ante 60
bereket31: posts the ante 60
IoannisVaios: posts small blind 200
SaLouTiGR: posts big blind 400
*** HOLE CARDS ***
Dealt to Kevin12345Mc [Qh 4d]
tabu33: folds 
Kevin12345Mc: folds 
taluk_00: folds 
MahSandrs: raises 600 to 1000
bereket31: calls 1000
578346: folds 
IoannisVaios: folds 
SaLouTiGR: calls 600
*** FLOP *** [9s Kh Jc]
SaLouTiGR: checks 
MahSandrs: bets 1216
bereket31: folds 
SaLouTiGR: folds 
Uncalled bet (1216) returned to MahSandrs
MahSandrs collected 3680 from pot
MahSandrs: doesn't show hand 
*** SUMMARY ***
Total pot 3680 | Rake 0 
Board [9s Kh Jc]
Seat 1: 578346 (button) folded before Flop (didn't bet)
Seat 2: IoannisVaios (small blind) folded before Flop
Seat 3: SaLouTiGR (big blind) folded on the Flop
Seat 4: tabu33 folded before Flop (didn't bet)
Seat 5: Kevin12345Mc folded before Flop (didn't bet)
Seat 6: taluk_00 folded before Flop (didn't bet)
Seat 7: MahSandrs collected (3680)
Seat 8: bereket31 folded on the Flop



PokerStars Hand #254988830753: Tournament #3858857107, $2.45+$2.45+$0.60 USD Hold'em No Limit - Level V (200/400) - 2025/02/22 18:16:38 WET [2025/02/22 13:16:38 ET]
Table '3858857107 71' 8-max Seat #2 is the button
Seat 1: 578346 (67931 in chips, $2.45 bounty) 
Seat 2: IoannisVaios (17834 in chips, $2.45 bounty) 
Seat 3: SaLouTiGR (7371 in chips, $2.45 bounty) 
Seat 4: tabu33 (22870 in chips, $2.45 bounty) 
Seat 5: Kevin12345Mc (59620 in chips, $3.67 bounty) 
Seat 6: taluk_00 (21565 in chips, $2.45 bounty) 
Seat 7: MahSandrs (30025 in chips, $2.45 bounty) 
Seat 8: bereket31 (17483 in chips, $2.45 bounty) 
578346: posts the ante 60
IoannisVaios: posts the ante 60
SaLouTiGR: posts the ante 60
tabu33: posts the ante 60
Kevin12345Mc: posts the ante 60
taluk_00: posts the ante 60
MahSandrs: posts the ante 60
bereket31: posts the ante 60
SaLouTiGR: posts small blind 200
tabu33: posts big blind 400
*** HOLE CARDS ***
Dealt to Kevin12345Mc [6c Kc]
Kevin12345Mc: folds 
taluk_00: folds 
MahSandrs: folds 
bereket31: folds 
578346: folds 
IoannisVaios: folds 
SaLouTiGR: raises 6911 to 7311 and is all-in
tabu33: folds 
Uncalled bet (6911) returned to SaLouTiGR
SaLouTiGR collected 1280 from pot
SaLouTiGR: doesn't show hand 
*** SUMMARY ***
Total pot 1280 | Rake 0 
Seat 1: 578346 folded before Flop (didn't bet)
Seat 2: IoannisVaios (button) folded before Flop (didn't bet)
Seat 3: SaLouTiGR (small blind) collected (1280)
Seat 4: tabu33 (big blind) folded before Flop
Seat 5: Kevin12345Mc folded before Flop (didn't bet)
Seat 6: taluk_00 folded before Flop (didn't bet)
Seat 7: MahSandrs folded before Flop (didn't bet)
Seat 8: bereket31 folded before Flop (didn't bet)



PokerStars Hand #254988838587: Tournament #3858857107, $2.45+$2.45+$0.60 USD Hold'em No Limit - Level V (200/400) - 2025/02/22 18:17:06 WET [2025/02/22 13:17:06 ET]
Table '3858857107 71' 8-max Seat #3 is the button
Seat 1: 578346 (67871 in chips, $2.45 bounty) 
Seat 2: IoannisVaios (17774 in chips, $2.45 bounty) 
Seat 3: SaLouTiGR (8191 in chips, $2.45 bounty) 
Seat 4: tabu33 (22410 in chips, $2.45 bounty) 
Seat 5: Kevin12345Mc (59560 in chips, $3.67 bounty) 
Seat 6: taluk_00 (21505 in chips, $2.45 bounty) 
Seat 7: MahSandrs (29965 in chips, $2.45 bounty) 
Seat 8: bereket31 (17423 in chips, $2.45 bounty) 
578346: posts the ante 60
IoannisVaios: posts the ante 60
SaLouTiGR: posts the ante 60
tabu33: posts the ante 60
Kevin12345Mc: posts the ante 60
taluk_00: posts the ante 60
MahSandrs: posts the ante 60
bereket31: posts the ante 60
tabu33: posts small blind 200
Kevin12345Mc: posts big blind 400
*** HOLE CARDS ***
Dealt to Kevin12345Mc [9h Jd]
taluk_00: folds 
MahSandrs: folds 
bereket31: folds 
578346: raises 520 to 920
IoannisVaios: folds 
SaLouTiGR: folds 
tabu33: folds 
Kevin12345Mc: calls 520
*** FLOP *** [3s 2d 4h]
Kevin12345Mc: checks 
578346: checks 
*** TURN *** [3s 2d 4h] [Kd]
Kevin12345Mc: checks 
578346: bets 2016
Kevin12345Mc: folds 
Uncalled bet (2016) returned to 578346
578346 collected 2520 from pot
578346: doesn't show hand 
*** SUMMARY ***
Total pot 2520 | Rake 0 
Board [3s 2d 4h Kd]
Seat 1: 578346 collected (2520)
Seat 2: IoannisVaios folded before Flop (didn't bet)
Seat 3: SaLouTiGR (button) folded before Flop (didn't bet)
Seat 4: tabu33 (small blind) folded before Flop
Seat 5: Kevin12345Mc (big blind) folded on the Turn
Seat 6: taluk_00 folded before Flop (didn't bet)
Seat 7: MahSandrs folded before Flop (didn't bet)
Seat 8: bereket31 folded before Flop (didn't bet)



PokerStars Hand #254988848617: Tournament #3858857107, $2.45+$2.45+$0.60 USD Hold'em No Limit - Level V (200/400) - 2025/02/22 18:17:42 WET [2025/02/22 13:17:42 ET]
Table '3858857107 71' 8-max Seat #4 is the button
Seat 1: 578346 (69411 in chips, $2.45 bounty) 
Seat 2: IoannisVaios (17714 in chips, $2.45 bounty) 
Seat 3: SaLouTiGR (8131 in chips, $2.45 bounty) 
Seat 4: tabu33 (22150 in chips, $2.45 bounty) 
Seat 5: Kevin12345Mc (58580 in chips, $3.67 bounty) 
Seat 6: taluk_00 (21445 in chips, $2.45 bounty) 
Seat 7: MahSandrs (29905 in chips, $2.45 bounty) 
Seat 8: bereket31 (17363 in chips, $2.45 bounty) 
578346: posts the ante 60
IoannisVaios: posts the ante 60
SaLouTiGR: posts the ante 60
tabu33: posts the ante 60
Kevin12345Mc: posts the ante 60
taluk_00: posts the ante 60
MahSandrs: posts the ante 60
bereket31: posts the ante 60
Kevin12345Mc: posts small blind 200
taluk_00: posts big blind 400
*** HOLE CARDS ***
Dealt to Kevin12345Mc [8h 7d]
MahSandrs: folds 
bereket31: folds 
578346: folds 
IoannisVaios: folds 
SaLouTiGR: calls 400
tabu33: folds 
Kevin12345Mc: folds 
taluk_00: checks 
*** FLOP *** [7h 5c Ac]
taluk_00: checks 
SaLouTiGR: checks 
*** TURN *** [7h 5c Ac] [Ts]
taluk_00: checks 
SaLouTiGR: checks 
*** RIVER *** [7h 5c Ac Ts] [Th]
taluk_00: checks 
SaLouTiGR: checks 
*** SHOW DOWN ***
taluk_00: shows [4c 7s] (two pair, Tens and Sevens)
SaLouTiGR: mucks hand 
taluk_00 collected 1480 from pot
*** SUMMARY ***
Total pot 1480 | Rake 0 
Board [7h 5c Ac Ts Th]
Seat 1: 578346 folded before Flop (didn't bet)
Seat 2: IoannisVaios folded before Flop (didn't bet)
Seat 3: SaLouTiGR mucked [9h Kh]
Seat 4: tabu33 (button) folded before Flop (didn't bet)
Seat 5: Kevin12345Mc (small blind) folded before Flop
Seat 6: taluk_00 (big blind) showed [4c 7s] and won (1480) with two pair, Tens and Sevens
Seat 7: MahSandrs folded before Flop (didn't bet)
Seat 8: bereket31 folded before Flop (didn't bet)



PokerStars Hand #254988858187: Tournament #3858857107, $2.45+$2.45+$0.60 USD Hold'em No Limit - Level V (200/400) - 2025/02/22 18:18:16 WET [2025/02/22 13:18:16 ET]
Table '3858857107 71' 8-max Seat #5 is the button
Seat 1: 578346 (69351 in chips, $2.45 bounty) 
Seat 2: IoannisVaios (17654 in chips, $2.45 bounty) 
Seat 3: SaLouTiGR (7671 in chips, $2.45 bounty) 
Seat 4: tabu33 (22090 in chips, $2.45 bounty) 
Seat 5: Kevin12345Mc (58320 in chips, $3.67 bounty) 
Seat 6: taluk_00 (22465 in chips, $2.45 bounty) 
Seat 7: MahSandrs (29845 in chips, $2.45 bounty) 
Seat 8: bereket31 (17303 in chips, $2.45 bounty) 
578346: posts the ante 60
IoannisVaios: posts the ante 60
SaLouTiGR: posts the ante 60
tabu33: posts the ante 60
Kevin12345Mc: posts the ante 60
taluk_00: posts the ante 60
MahSandrs: posts the ante 60
bereket31: posts the ante 60
taluk_00: posts small blind 200
MahSandrs: posts big blind 400
*** HOLE CARDS ***
Dealt to Kevin12345Mc [6s 3h]
bereket31: folds 
578346: raises 520 to 920
IoannisVaios: folds 
SaLouTiGR: folds 
tabu33: folds 
Kevin12345Mc: folds 
taluk_00: folds 
MahSandrs: calls 520
*** FLOP *** [4s Ac Ah]
MahSandrs: checks 
578346: bets 630
MahSandrs: calls 630
*** TURN *** [4s Ac Ah] [3d]
MahSandrs: checks 
578346: checks 
*** RIVER *** [4s Ac Ah 3d] [Qc]
MahSandrs: bets 1248
578346: folds 
Uncalled bet (1248) returned to MahSandrs
MahSandrs collected 3780 from pot
MahSandrs: doesn't show hand 
*** SUMMARY ***
Total pot 3780 | Rake 0 
Board [4s Ac Ah 3d Qc]
Seat 1: 578346 folded on the River
Seat 2: IoannisVaios folded before Flop (didn't bet)
Seat 3: SaLouTiGR folded before Flop (didn't bet)
Seat 4: tabu33 folded before Flop (didn't bet)
Seat 5: Kevin12345Mc (button) folded before Flop (didn't bet)
Seat 6: taluk_00 (small blind) folded before Flop
Seat 7: MahSandrs (big blind) collected (3780)
Seat 8: bereket31 folded before Flop (didn't bet)



PokerStars Hand #254988879567: Tournament #3858857107, $2.45+$2.45+$0.60 USD Hold'em No Limit - Level VI (250/500) - 2025/02/22 18:19:32 WET [2025/02/22 13:19:32 ET]
Table '3858857107 71' 8-max Seat #6 is the button
Seat 1: 578346 (67741 in chips, $2.45 bounty) 
Seat 2: IoannisVaios (17594 in chips, $2.45 bounty) 
Seat 3: SaLouTiGR (7611 in chips, $2.45 bounty) 
Seat 4: tabu33 (22030 in chips, $2.45 bounty) 
Seat 5: Kevin12345Mc (58260 in chips, $3.67 bounty) 
Seat 6: taluk_00 (22205 in chips, $2.45 bounty) 
Seat 7: MahSandrs (32015 in chips, $2.45 bounty) 
Seat 8: bereket31 (17243 in chips, $2.45 bounty) 
578346: posts the ante 70
IoannisVaios: posts the ante 70
SaLouTiGR: posts the ante 70
tabu33: posts the ante 70
Kevin12345Mc: posts the ante 70
taluk_00: posts the ante 70
MahSandrs: posts the ante 70
bereket31: posts the ante 70
MahSandrs: posts small blind 250
bereket31: posts big blind 500
*** HOLE CARDS ***
Dealt to Kevin12345Mc [8h Th]
578346: raises 1000 to 1500
IoannisVaios: folds 
SaLouTiGR: folds 
tabu33: folds 
Kevin12345Mc: folds 
taluk_00: folds 
MahSandrs: calls 1250
bereket31: folds 
*** FLOP *** [Qd 3d Td]
MahSandrs: checks 
578346: checks 
*** TURN *** [Qd 3d Td] [6d]
MahSandrs: bets 1340
578346: folds 
Uncalled bet (1340) returned to MahSandrs
MahSandrs collected 4060 from pot
MahSandrs: doesn't show hand 
*** SUMMARY ***
Total pot 4060 | Rake 0 
Board [Qd 3d Td 6d]
Seat 1: 578346 folded on the Turn
Seat 2: IoannisVaios folded before Flop (didn't bet)
Seat 3: SaLouTiGR folded before Flop (didn't bet)
Seat 4: tabu33 folded before Flop (didn't bet)
Seat 5: Kevin12345Mc folded before Flop (didn't bet)
Seat 6: taluk_00 (button) folded before Flop (didn't bet)
Seat 7: MahSandrs (small blind) collected (4060)
Seat 8: bereket31 (big blind) folded before Flop



PokerStars Hand #254988896277: Tournament #3858857107, $2.45+$2.45+$0.60 USD Hold'em No Limit - Level VI (250/500) - 2025/02/22 18:20:31 WET [2025/02/22 13:20:31 ET]
Table '3858857107 71' 8-max Seat #7 is the button
Seat 1: 578346 (66171 in chips, $2.45 bounty) 
Seat 2: IoannisVaios (17524 in chips, $2.45 bounty) 
Seat 3: SaLouTiGR (7541 in chips, $2.45 bounty) 
Seat 4: tabu33 (21960 in chips, $2.45 bounty) 
Seat 5: Kevin12345Mc (58190 in chips, $3.67 bounty) 
Seat 6: taluk_00 (22135 in chips, $2.45 bounty) 
Seat 7: MahSandrs (34505 in chips, $2.45 bounty) 
Seat 8: bereket31 (16673 in chips, $2.45 bounty) 
578346: posts the ante 70
IoannisVaios: posts the ante 70
SaLouTiGR: posts the ante 70
tabu33: posts the ante 70
Kevin12345Mc: posts the ante 70
taluk_00: posts the ante 70
MahSandrs: posts the ante 70
bereket31: posts the ante 70
bereket31: posts small blind 250
578346: posts big blind 500
*** HOLE CARDS ***
Dealt to Kevin12345Mc [9s 9h]
IoannisVaios: folds 
SaLouTiGR: calls 500
tabu33: folds 
Kevin12345Mc: raises 650 to 1150
taluk_00: folds 
MahSandrs: folds 
bereket31: folds 
578346: folds 
SaLouTiGR: raises 6321 to 7471 and is all-in
Kevin12345Mc: calls 6321
*** FLOP *** [Kc 7s 8c]
*** TURN *** [Kc 7s 8c] [6s]
*** RIVER *** [Kc 7s 8c 6s] [2h]
*** SHOW DOWN ***
SaLouTiGR: shows [As Ks] (a pair of Kings)
Kevin12345Mc: shows [9s 9h] (a pair of Nines)
SaLouTiGR collected 16252 from pot
*** SUMMARY ***
Total pot 16252 | Rake 0 
Board [Kc 7s 8c 6s 2h]
Seat 1: 578346 (big blind) folded before Flop
Seat 2: IoannisVaios folded before Flop (didn't bet)
Seat 3: SaLouTiGR showed [As Ks] and won (16252) with a pair of Kings
Seat 4: tabu33 folded before Flop (didn't bet)
Seat 5: Kevin12345Mc showed [9s 9h] and lost with a pair of Nines
Seat 6: taluk_00 folded before Flop (didn't bet)
Seat 7: MahSandrs (button) folded before Flop (didn't bet)
Seat 8: bereket31 (small blind) folded before Flop



PokerStars Hand #254988910520: Tournament #3858857107, $2.45+$2.45+$0.60 USD Hold'em No Limit - Level VI (250/500) - 2025/02/22 18:21:21 WET [2025/02/22 13:21:21 ET]
Table '3858857107 71' 8-max Seat #8 is the button
Seat 1: 578346 (65601 in chips, $2.45 bounty) 
Seat 2: IoannisVaios (17454 in chips, $2.45 bounty) 
Seat 3: SaLouTiGR (16252 in chips, $2.45 bounty) 
Seat 4: tabu33 (21890 in chips, $2.45 bounty) 
Seat 5: Kevin12345Mc (50649 in chips, $3.67 bounty) 
Seat 6: taluk_00 (22065 in chips, $2.45 bounty) 
Seat 7: MahSandrs (34435 in chips, $2.45 bounty) 
Seat 8: bereket31 (16353 in chips, $2.45 bounty) 
578346: posts the ante 70
IoannisVaios: posts the ante 70
SaLouTiGR: posts the ante 70
tabu33: posts the ante 70
Kevin12345Mc: posts the ante 70
taluk_00: posts the ante 70
MahSandrs: posts the ante 70
bereket31: posts the ante 70
578346: posts small blind 250
IoannisVaios: posts big blind 500
*** HOLE CARDS ***
Dealt to Kevin12345Mc [4c 9c]
SaLouTiGR: folds 
tabu33: folds 
Kevin12345Mc: folds 
taluk_00: folds 
MahSandrs: raises 750 to 1250
bereket31: folds 
578346: calls 1000
IoannisVaios: folds 
*** FLOP *** [3h Ts Qh]
578346: checks 
MahSandrs: bets 1175
578346: folds 
Uncalled bet (1175) returned to MahSandrs
MahSandrs collected 3560 from pot
MahSandrs: doesn't show hand 
*** SUMMARY ***
Total pot 3560 | Rake 0 
Board [3h Ts Qh]
Seat 1: 578346 (small blind) folded on the Flop
Seat 2: IoannisVaios (big blind) folded before Flop
Seat 3: SaLouTiGR folded before Flop (didn't bet)
Seat 4: tabu33 folded before Flop (didn't bet)
Seat 5: Kevin12345Mc folded before Flop (didn't bet)
Seat 6: taluk_00 folded before Flop (didn't bet)
Seat 7: MahSandrs collected (3560)
Seat 8: bereket31 (button) folded before Flop (didn't bet)



PokerStars Hand #254988924327: Tournament #3858857107, $2.45+$2.45+$0.60 USD Hold'em No Limit - Level VI (250/500) - 2025/02/22 18:22:11 WET [2025/02/22 13:22:11 ET]
Table '3858857107 71' 8-max Seat #1 is the button
Seat 1: 578346 (64281 in chips, $2.45 bounty) 
Seat 2: IoannisVaios (16884 in chips, $2.45 bounty) 
Seat 3: SaLouTiGR (16182 in chips, $2.45 bounty) 
Seat 4: tabu33 (21820 in chips, $2.45 bounty) 
Seat 5: Kevin12345Mc (50579 in chips, $3.67 bounty) 
Seat 6: taluk_00 (21995 in chips, $2.45 bounty) 
Seat 7: MahSandrs (36675 in chips, $2.45 bounty) 
Seat 8: bereket31 (16283 in chips, $2.45 bounty) 
578346: posts the ante 70
IoannisVaios: posts the ante 70
SaLouTiGR: posts the ante 70
tabu33: posts the ante 70
Kevin12345Mc: posts the ante 70
taluk_00: posts the ante 70
MahSandrs: posts the ante 70
bereket31: posts the ante 70
IoannisVaios: posts small blind 250
SaLouTiGR: posts big blind 500
*** HOLE CARDS ***
Dealt to Kevin12345Mc [Js 5d]
tabu33: folds 
Kevin12345Mc: folds 
taluk_00: folds 
MahSandrs: folds 
bereket31: raises 15713 to 16213 and is all-in
578346: folds 
IoannisVaios: folds 
SaLouTiGR: folds 
Uncalled bet (15713) returned to bereket31
bereket31 collected 1810 from pot
*** SUMMARY ***
Total pot 1810 | Rake 0 
Seat 1: 578346 (button) folded before Flop (didn't bet)
Seat 2: IoannisVaios (small blind) folded before Flop
Seat 3: SaLouTiGR (big blind) folded before Flop
Seat 4: tabu33 folded before Flop (didn't bet)
Seat 5: Kevin12345Mc folded before Flop (didn't bet)
Seat 6: taluk_00 folded before Flop (didn't bet)
Seat 7: MahSandrs folded before Flop (didn't bet)
Seat 8: bereket31 collected (1810)



PokerStars Hand #254988932803: Tournament #3858857107, $2.45+$2.45+$0.60 USD Hold'em No Limit - Level VI (250/500) - 2025/02/22 18:22:41 WET [2025/02/22 13:22:41 ET]
Table '3858857107 71' 8-max Seat #2 is the button
Seat 1: 578346 (64211 in chips, $2.45 bounty) 
Seat 2: IoannisVaios (16564 in chips, $2.45 bounty) 
Seat 3: SaLouTiGR (15612 in chips, $2.45 bounty) 
Seat 4: tabu33 (21750 in chips, $2.45 bounty) 
Seat 5: Kevin12345Mc (50509 in chips, $3.67 bounty) 
Seat 6: taluk_00 (21925 in chips, $2.45 bounty) 
Seat 7: MahSandrs (36605 in chips, $2.45 bounty) 
Seat 8: bereket31 (17523 in chips, $2.45 bounty) 
578346: posts the ante 70
IoannisVaios: posts the ante 70
SaLouTiGR: posts the ante 70
tabu33: posts the ante 70
Kevin12345Mc: posts the ante 70
taluk_00: posts the ante 70
MahSandrs: posts the ante 70
bereket31: posts the ante 70
SaLouTiGR: posts small blind 250
tabu33: posts big blind 500
*** HOLE CARDS ***
Dealt to Kevin12345Mc [Qh 9s]
Kevin12345Mc: folds 
taluk_00: raises 500 to 1000
MahSandrs: folds 
bereket31: folds 
578346: calls 1000
IoannisVaios: folds 
SaLouTiGR: folds 
tabu33: folds 
*** FLOP *** [7h 4h 9h]
taluk_00: checks 
578346: checks 
*** TURN *** [7h 4h 9h] [Js]
taluk_00: checks 
578346: checks 
*** RIVER *** [7h 4h 9h Js] [Ah]
taluk_00: bets 2185
578346: folds 
Uncalled bet (2185) returned to taluk_00
taluk_00 collected 3310 from pot
taluk_00: doesn't show hand 
*** SUMMARY ***
Total pot 3310 | Rake 0 
Board [7h 4h 9h Js Ah]
Seat 1: 578346 folded on the River
Seat 2: IoannisVaios (button) folded before Flop (didn't bet)
Seat 3: SaLouTiGR (small blind) folded before Flop
Seat 4: tabu33 (big blind) folded before Flop
Seat 5: Kevin12345Mc folded before Flop (didn't bet)
Seat 6: taluk_00 collected (3310)
Seat 7: MahSandrs folded before Flop (didn't bet)
Seat 8: bereket31 folded before Flop (didn't bet)



PokerStars Hand #254988955359: Tournament #3858857107, $2.45+$2.45+$0.60 USD Hold'em No Limit - Level VI (250/500) - 2025/02/22 18:24:03 WET [2025/02/22 13:24:03 ET]
Table '3858857107 71' 8-max Seat #3 is the button
Seat 1: 578346 (63141 in chips, $2.45 bounty) 
Seat 2: IoannisVaios (16494 in chips, $2.45 bounty) 
Seat 3: SaLouTiGR (15292 in chips, $2.45 bounty) 
Seat 4: tabu33 (21180 in chips, $2.45 bounty) 
Seat 5: Kevin12345Mc (50439 in chips, $3.67 bounty) 
Seat 6: taluk_00 (24165 in chips, $2.45 bounty) 
Seat 7: MahSandrs (36535 in chips, $2.45 bounty) 
Seat 8: bereket31 (17453 in chips, $2.45 bounty) 
578346: posts the ante 70
IoannisVaios: posts the ante 70
SaLouTiGR: posts the ante 70
tabu33: posts the ante 70
Kevin12345Mc: posts the ante 70
taluk_00: posts the ante 70
MahSandrs: posts the ante 70
bereket31: posts the ante 70
tabu33: posts small blind 250
Kevin12345Mc: posts big blind 500
*** HOLE CARDS ***
Dealt to Kevin12345Mc [9h 2c]
taluk_00: folds 
MahSandrs: folds 
bereket31: folds 
578346: raises 650 to 1150
IoannisVaios: raises 15274 to 16424 and is all-in
SaLouTiGR: folds 
tabu33: folds 
Kevin12345Mc: folds 
578346: folds 
Uncalled bet (15274) returned to IoannisVaios
IoannisVaios collected 3610 from pot
IoannisVaios: doesn't show hand 
*** SUMMARY ***
Total pot 3610 | Rake 0 
Seat 1: 578346 folded before Flop
Seat 2: IoannisVaios collected (3610)
Seat 3: SaLouTiGR (button) folded before Flop (didn't bet)
Seat 4: tabu33 (small blind) folded before Flop
Seat 5: Kevin12345Mc (big blind) folded before Flop
Seat 6: taluk_00 folded before Flop (didn't bet)
Seat 7: MahSandrs folded before Flop (didn't bet)
Seat 8: bereket31 folded before Flop (didn't bet)



PokerStars Hand #254988972192: Tournament #3858857107, $2.45+$2.45+$0.60 USD Hold'em No Limit - Level VI (250/500) - 2025/02/22 18:25:03 WET [2025/02/22 13:25:03 ET]
Table '3858857107 71' 8-max Seat #4 is the button
Seat 1: 578346 (61921 in chips, $2.45 bounty) 
Seat 2: IoannisVaios (18884 in chips, $2.45 bounty) 
Seat 3: SaLouTiGR (15222 in chips, $2.45 bounty) 
Seat 4: tabu33 (20860 in chips, $2.45 bounty) 
Seat 5: Kevin12345Mc (49869 in chips, $3.67 bounty) 
Seat 6: taluk_00 (24095 in chips, $2.45 bounty) 
Seat 7: MahSandrs (36465 in chips, $2.45 bounty) 
Seat 8: bereket31 (17383 in chips, $2.45 bounty) 
578346: posts the ante 70
IoannisVaios: posts the ante 70
SaLouTiGR: posts the ante 70
tabu33: posts the ante 70
Kevin12345Mc: posts the ante 70
taluk_00: posts the ante 70
MahSandrs: posts the ante 70
bereket31: posts the ante 70
Kevin12345Mc: posts small blind 250
taluk_00: posts big blind 500
*** HOLE CARDS ***
Dealt to Kevin12345Mc [Kc 3d]
MahSandrs: folds 
bereket31: folds 
578346: folds 
IoannisVaios: raises 540 to 1040
SaLouTiGR: folds 
tabu33: folds 
Kevin12345Mc: folds 
taluk_00: raises 2960 to 4000
IoannisVaios: folds 
Uncalled bet (2960) returned to taluk_00
taluk_00 collected 2890 from pot
taluk_00: doesn't show hand 
*** SUMMARY ***
Total pot 2890 | Rake 0 
Seat 1: 578346 folded before Flop (didn't bet)
Seat 2: IoannisVaios folded before Flop
Seat 3: SaLouTiGR folded before Flop (didn't bet)
Seat 4: tabu33 (button) folded before Flop (didn't bet)
Seat 5: Kevin12345Mc (small blind) folded before Flop
Seat 6: taluk_00 (big blind) collected (2890)
Seat 7: MahSandrs folded before Flop (didn't bet)
Seat 8: bereket31 folded before Flop (didn't bet)



PokerStars Hand #254988983973: Tournament #3858857107, $2.45+$2.45+$0.60 USD Hold'em No Limit - Level VI (250/500) - 2025/02/22 18:25:45 WET [2025/02/22 13:25:45 ET]
Table '3858857107 71' 8-max Seat #5 is the button
Seat 1: 578346 (61851 in chips, $2.45 bounty) 
Seat 2: IoannisVaios (17774 in chips, $2.45 bounty) 
Seat 3: SaLouTiGR (15152 in chips, $2.45 bounty) 
Seat 4: tabu33 (20790 in chips, $2.45 bounty) 
Seat 5: Kevin12345Mc (49549 in chips, $3.67 bounty) 
Seat 6: taluk_00 (25875 in chips, $2.45 bounty) 
Seat 7: MahSandrs (36395 in chips, $2.45 bounty) 
Seat 8: bereket31 (17313 in chips, $2.45 bounty) 
578346: posts the ante 70
IoannisVaios: posts the ante 70
SaLouTiGR: posts the ante 70
tabu33: posts the ante 70
Kevin12345Mc: posts the ante 70
taluk_00: posts the ante 70
MahSandrs: posts the ante 70
bereket31: posts the ante 70
taluk_00: posts small blind 250
MahSandrs: posts big blind 500
*** HOLE CARDS ***
Dealt to Kevin12345Mc [3h 6s]
bereket31: folds 
578346: folds 
IoannisVaios: folds 
SaLouTiGR: folds 
tabu33: folds 
Kevin12345Mc: folds 
taluk_00: calls 250
MahSandrs: raises 1250 to 1750
taluk_00: calls 1250
*** FLOP *** [2h 4c 6d]
taluk_00: checks 
MahSandrs: checks 
*** TURN *** [2h 4c 6d] [Kd]
taluk_00: checks 
MahSandrs: bets 1340
taluk_00: folds 
Uncalled bet (1340) returned to MahSandrs
MahSandrs collected 4060 from pot
MahSandrs: doesn't show hand 
*** SUMMARY ***
Total pot 4060 | Rake 0 
Board [2h 4c 6d Kd]
Seat 1: 578346 folded before Flop (didn't bet)
Seat 2: IoannisVaios folded before Flop (didn't bet)
Seat 3: SaLouTiGR folded before Flop (didn't bet)
Seat 4: tabu33 folded before Flop (didn't bet)
Seat 5: Kevin12345Mc (button) folded before Flop (didn't bet)
Seat 6: taluk_00 (small blind) folded on the Turn
Seat 7: MahSandrs (big blind) collected (4060)
Seat 8: bereket31 folded before Flop (didn't bet)



PokerStars Hand #254989006033: Tournament #3858857107, $2.45+$2.45+$0.60 USD Hold'em No Limit - Level VII (300/600) - 2025/02/22 18:27:04 WET [2025/02/22 13:27:04 ET]
Table '3858857107 71' 8-max Seat #6 is the button
Seat 1: 578346 (61781 in chips, $2.45 bounty) 
Seat 2: IoannisVaios (17704 in chips, $2.45 bounty) 
Seat 3: SaLouTiGR (15082 in chips, $2.45 bounty) 
Seat 4: tabu33 (20720 in chips, $2.45 bounty) 
Seat 5: Kevin12345Mc (49479 in chips, $3.67 bounty) 
Seat 6: taluk_00 (24055 in chips, $2.45 bounty) 
Seat 7: MahSandrs (38635 in chips, $2.45 bounty) 
Seat 8: bereket31 (17243 in chips, $2.45 bounty) 
578346: posts the ante 80
IoannisVaios: posts the ante 80
SaLouTiGR: posts the ante 80
tabu33: posts the ante 80
Kevin12345Mc: posts the ante 80
taluk_00: posts the ante 80
MahSandrs: posts the ante 80
bereket31: posts the ante 80
MahSandrs: posts small blind 300
bereket31: posts big blind 600
*** HOLE CARDS ***
Dealt to Kevin12345Mc [Kh 2s]
578346: folds 
IoannisVaios: raises 648 to 1248
SaLouTiGR: folds 
tabu33: folds 
Kevin12345Mc: folds 
taluk_00: folds 
MahSandrs: folds 
bereket31: folds 
Uncalled bet (648) returned to IoannisVaios
IoannisVaios collected 2140 from pot
IoannisVaios: doesn't show hand 
*** SUMMARY ***
Total pot 2140 | Rake 0 
Seat 1: 578346 folded before Flop (didn't bet)
Seat 2: IoannisVaios collected (2140)
Seat 3: SaLouTiGR folded before Flop (didn't bet)
Seat 4: tabu33 folded before Flop (didn't bet)
Seat 5: Kevin12345Mc folded before Flop (didn't bet)
Seat 6: taluk_00 (button) folded before Flop (didn't bet)
Seat 7: MahSandrs (small blind) folded before Flop
Seat 8: bereket31 (big blind) folded before Flop



PokerStars Hand #254989011203: Tournament #3858857107, $2.45+$2.45+$0.60 USD Hold'em No Limit - Level VII (300/600) - 2025/02/22 18:27:22 WET [2025/02/22 13:27:22 ET]
Table '3858857107 71' 8-max Seat #7 is the button
Seat 1: 578346 (61701 in chips, $2.45 bounty) 
Seat 2: IoannisVaios (19164 in chips, $2.45 bounty) 
Seat 3: SaLouTiGR (15002 in chips, $2.45 bounty) 
Seat 4: tabu33 (20640 in chips, $2.45 bounty) 
Seat 5: Kevin12345Mc (49399 in chips, $3.67 bounty) 
Seat 6: taluk_00 (23975 in chips, $2.45 bounty) 
Seat 7: MahSandrs (38255 in chips, $2.45 bounty) 
Seat 8: bereket31 (16563 in chips, $2.45 bounty) 
578346: posts the ante 80
IoannisVaios: posts the ante 80
SaLouTiGR: posts the ante 80
tabu33: posts the ante 80
Kevin12345Mc: posts the ante 80
taluk_00: posts the ante 80
MahSandrs: posts the ante 80
bereket31: posts the ante 80
bereket31: posts small blind 300
578346: posts big blind 600
*** HOLE CARDS ***
Dealt to Kevin12345Mc [Js As]
IoannisVaios: folds 
SaLouTiGR: folds 
tabu33: folds 
Kevin12345Mc: raises 780 to 1380
taluk_00: folds 
MahSandrs: folds 
bereket31: folds 
578346: calls 780
*** FLOP *** [Qh 6d 4s]
578346: checks 
Kevin12345Mc: bets 1221
578346: folds 
Uncalled bet (1221) returned to Kevin12345Mc
Kevin12345Mc collected 3700 from pot
Kevin12345Mc: doesn't show hand 
*** SUMMARY ***
Total pot 3700 | Rake 0 
Board [Qh 6d 4s]
Seat 1: 578346 (big blind) folded on the Flop
Seat 2: IoannisVaios folded before Flop (didn't bet)
Seat 3: SaLouTiGR folded before Flop (didn't bet)
Seat 4: tabu33 folded before Flop (didn't bet)
Seat 5: Kevin12345Mc collected (3700)
Seat 6: taluk_00 folded before Flop (didn't bet)
Seat 7: MahSandrs (button) folded before Flop (didn't bet)
Seat 8: bereket31 (small blind) folded before Flop



PokerStars Hand #254989023270: Tournament #3858857107, $2.45+$2.45+$0.60 USD Hold'em No Limit - Level VII (300/600) - 2025/02/22 18:28:05 WET [2025/02/22 13:28:05 ET]
Table '3858857107 71' 8-max Seat #8 is the button
Seat 1: 578346 (60241 in chips, $2.45 bounty) 
Seat 2: IoannisVaios (19084 in chips, $2.45 bounty) 
Seat 3: SaLouTiGR (14922 in chips, $2.45 bounty) 
Seat 4: tabu33 (20560 in chips, $2.45 bounty) 
Seat 5: Kevin12345Mc (51639 in chips, $3.67 bounty) 
Seat 6: taluk_00 (23895 in chips, $2.45 bounty) 
Seat 7: MahSandrs (38175 in chips, $2.45 bounty) 
Seat 8: bereket31 (16183 in chips, $2.45 bounty) 
578346: posts the ante 80
IoannisVaios: posts the ante 80
SaLouTiGR: posts the ante 80
tabu33: posts the ante 80
Kevin12345Mc: posts the ante 80
taluk_00: posts the ante 80
MahSandrs: posts the ante 80
bereket31: posts the ante 80
578346: posts small blind 300
IoannisVaios: posts big blind 600
*** HOLE CARDS ***
Dealt to Kevin12345Mc [Th 6s]
SaLouTiGR: calls 600
tabu33: folds 
Kevin12345Mc: folds 
taluk_00: folds 
MahSandrs: raises 2400 to 3000
bereket31: folds 
578346: folds 
IoannisVaios: folds 
SaLouTiGR: calls 2400
*** FLOP *** [4d Jc 3c]
SaLouTiGR: checks 
MahSandrs: bets 2496
SaLouTiGR: folds 
Uncalled bet (2496) returned to MahSandrs
MahSandrs collected 7540 from pot
MahSandrs: doesn't show hand 
*** SUMMARY ***
Total pot 7540 | Rake 0 
Board [4d Jc 3c]
Seat 1: 578346 (small blind) folded before Flop
Seat 2: IoannisVaios (big blind) folded before Flop
Seat 3: SaLouTiGR folded on the Flop
Seat 4: tabu33 folded before Flop (didn't bet)
Seat 5: Kevin12345Mc folded before Flop (didn't bet)
Seat 6: taluk_00 folded before Flop (didn't bet)
Seat 7: MahSandrs collected (7540)
Seat 8: bereket31 (button) folded before Flop (didn't bet)



PokerStars Hand #254989038071: Tournament #3858857107, $2.45+$2.45+$0.60 USD Hold'em No Limit - Level VII (300/600) - 2025/02/22 18:28:58 WET [2025/02/22 13:28:58 ET]
Table '3858857107 71' 8-max Seat #1 is the button
Seat 1: 578346 (59861 in chips, $2.45 bounty) 
Seat 2: IoannisVaios (18404 in chips, $2.45 bounty) 
Seat 3: SaLouTiGR (11842 in chips, $2.45 bounty) 
Seat 4: tabu33 (20480 in chips, $2.45 bounty) 
Seat 5: Kevin12345Mc (51559 in chips, $3.67 bounty) 
Seat 6: taluk_00 (23815 in chips, $2.45 bounty) 
Seat 7: MahSandrs (42635 in chips, $2.45 bounty) 
Seat 8: bereket31 (16103 in chips, $2.45 bounty) 
578346: posts the ante 80
IoannisVaios: posts the ante 80
SaLouTiGR: posts the ante 80
tabu33: posts the ante 80
Kevin12345Mc: posts the ante 80
taluk_00: posts the ante 80
MahSandrs: posts the ante 80
bereket31: posts the ante 80
IoannisVaios: posts small blind 300
SaLouTiGR: posts big blind 600
*** HOLE CARDS ***
Dealt to Kevin12345Mc [8h 9c]
tabu33: calls 600
Kevin12345Mc: folds 
taluk_00: folds 
MahSandrs: folds 
bereket31: folds 
578346: folds 
IoannisVaios: folds 
SaLouTiGR: checks 
*** FLOP *** [Jh Th Td]
SaLouTiGR: checks 
tabu33: checks 
*** TURN *** [Jh Th Td] [5s]
SaLouTiGR: checks 
tabu33: checks 
*** RIVER *** [Jh Th Td 5s] [6s]
SaLouTiGR: checks 
tabu33: checks 
*** SHOW DOWN ***
SaLouTiGR: shows [2d 6h] (two pair, Tens and Sixes)
tabu33: mucks hand 
SaLouTiGR collected 2140 from pot
*** SUMMARY ***
Total pot 2140 | Rake 0 
Board [Jh Th Td 5s 6s]
Seat 1: 578346 (button) folded before Flop (didn't bet)
Seat 2: IoannisVaios (small blind) folded before Flop
Seat 3: SaLouTiGR (big blind) showed [2d 6h] and won (2140) with two pair, Tens and Sixes
Seat 4: tabu33 mucked [Kd Qs]
Seat 5: Kevin12345Mc folded before Flop (didn't bet)
Seat 6: taluk_00 folded before Flop (didn't bet)
Seat 7: MahSandrs folded before Flop (didn't bet)
Seat 8: bereket31 folded before Flop (didn't bet)



PokerStars Hand #254989059793: Tournament #3858857107, $2.45+$2.45+$0.60 USD Hold'em No Limit - Level VII (300/600) - 2025/02/22 18:30:13 WET [2025/02/22 13:30:13 ET]
Table '3858857107 71' 8-max Seat #2 is the button
Seat 1: 578346 (59781 in chips, $2.45 bounty) 
Seat 2: IoannisVaios (18024 in chips, $2.45 bounty) 
Seat 3: SaLouTiGR (13302 in chips, $2.45 bounty) 
Seat 4: tabu33 (19800 in chips, $2.45 bounty) 
Seat 5: Kevin12345Mc (51479 in chips, $3.67 bounty) 
Seat 6: taluk_00 (23735 in chips, $2.45 bounty) 
Seat 7: MahSandrs (42555 in chips, $2.45 bounty) 
Seat 8: bereket31 (16023 in chips, $2.45 bounty) 
578346: posts the ante 80
IoannisVaios: posts the ante 80
SaLouTiGR: posts the ante 80
tabu33: posts the ante 80
Kevin12345Mc: posts the ante 80
taluk_00: posts the ante 80
MahSandrs: posts the ante 80
bereket31: posts the ante 80
SaLouTiGR: posts small blind 300
tabu33: posts big blind 600
*** HOLE CARDS ***
Dealt to Kevin12345Mc [Ad 6h]
Kevin12345Mc: folds 
taluk_00: folds 
MahSandrs: folds 
bereket31: folds 
578346: folds 
IoannisVaios: folds 
SaLouTiGR: folds 
Uncalled bet (300) returned to tabu33
tabu33 collected 1240 from pot
tabu33: doesn't show hand 
*** SUMMARY ***
Total pot 1240 | Rake 0 
Seat 1: 578346 folded before Flop (didn't bet)
Seat 2: IoannisVaios (button) folded before Flop (didn't bet)
Seat 3: SaLouTiGR (small blind) folded before Flop
Seat 4: tabu33 (big blind) collected (1240)
Seat 5: Kevin12345Mc folded before Flop (didn't bet)
Seat 6: taluk_00 folded before Flop (didn't bet)
Seat 7: MahSandrs folded before Flop (didn't bet)
Seat 8: bereket31 folded before Flop (didn't bet)



PokerStars Hand #254989070434: Tournament #3858857107, $2.45+$2.45+$0.60 USD Hold'em No Limit - Level VII (300/600) - 2025/02/22 18:30:50 WET [2025/02/22 13:30:50 ET]
Table '3858857107 71' 8-max Seat #3 is the button
Seat 1: 578346 (59701 in chips, $2.45 bounty) 
Seat 2: IoannisVaios (17944 in chips, $2.45 bounty) 
Seat 3: SaLouTiGR (12922 in chips, $2.45 bounty) 
Seat 4: tabu33 (20660 in chips, $2.45 bounty) 
Seat 5: Kevin12345Mc (51399 in chips, $3.67 bounty) 
Seat 6: taluk_00 (23655 in chips, $2.45 bounty) 
Seat 7: MahSandrs (42475 in chips, $2.45 bounty) 
Seat 8: bereket31 (15943 in chips, $2.45 bounty) 
578346: posts the ante 80
IoannisVaios: posts the ante 80
SaLouTiGR: posts the ante 80
tabu33: posts the ante 80
Kevin12345Mc: posts the ante 80
taluk_00: posts the ante 80
MahSandrs: posts the ante 80
bereket31: posts the ante 80
tabu33: posts small blind 300
Kevin12345Mc: posts big blind 600
*** HOLE CARDS ***
Dealt to Kevin12345Mc [Td 8h]
taluk_00: folds 
MahSandrs: folds 
bereket31: folds 
578346: folds 
IoannisVaios: raises 648 to 1248
SaLouTiGR: folds 
tabu33: folds 
Kevin12345Mc: calls 648
*** FLOP *** [Kc Jc Ac]
Kevin12345Mc: checks 
IoannisVaios: checks 
*** TURN *** [Kc Jc Ac] [9h]
Kevin12345Mc: checks 
IoannisVaios: checks 
*** RIVER *** [Kc Jc Ac 9h] [5s]
Kevin12345Mc: bets 4036
IoannisVaios: calls 4036
*** SHOW DOWN ***
Kevin12345Mc: shows [Td 8h] (high card Ace)
IoannisVaios: shows [4s As] (a pair of Aces)
IoannisVaios collected 11508 from pot
*** SUMMARY ***
Total pot 11508 | Rake 0 
Board [Kc Jc Ac 9h 5s]
Seat 1: 578346 folded before Flop (didn't bet)
Seat 2: IoannisVaios showed [4s As] and won (11508) with a pair of Aces
Seat 3: SaLouTiGR (button) folded before Flop (didn't bet)
Seat 4: tabu33 (small blind) folded before Flop
Seat 5: Kevin12345Mc (big blind) showed [Td 8h] and lost with high card Ace
Seat 6: taluk_00 folded before Flop (didn't bet)
Seat 7: MahSandrs folded before Flop (didn't bet)
Seat 8: bereket31 folded before Flop (didn't bet)



PokerStars Hand #254989085452: Tournament #3858857107, $2.45+$2.45+$0.60 USD Hold'em No Limit - Level VII (300/600) - 2025/02/22 18:31:42 WET [2025/02/22 13:31:42 ET]
Table '3858857107 71' 8-max Seat #4 is the button
Seat 1: 578346 (59621 in chips, $2.45 bounty) 
Seat 2: IoannisVaios (24088 in chips, $2.45 bounty) 
Seat 3: SaLouTiGR (12842 in chips, $2.45 bounty) 
Seat 4: tabu33 (20280 in chips, $2.45 bounty) 
Seat 5: Kevin12345Mc (46035 in chips, $3.67 bounty) 
Seat 6: taluk_00 (23575 in chips, $2.45 bounty) 
Seat 7: MahSandrs (42395 in chips, $2.45 bounty) 
Seat 8: bereket31 (15863 in chips, $2.45 bounty) 
578346: posts the ante 80
IoannisVaios: posts the ante 80
SaLouTiGR: posts the ante 80
tabu33: posts the ante 80
Kevin12345Mc: posts the ante 80
taluk_00: posts the ante 80
MahSandrs: posts the ante 80
bereket31: posts the ante 80
Kevin12345Mc: posts small blind 300
taluk_00: posts big blind 600
*** HOLE CARDS ***
Dealt to Kevin12345Mc [8c 9h]
MahSandrs: folds 
bereket31: folds 
578346: folds 
IoannisVaios: folds 
SaLouTiGR: folds 
tabu33: folds 
Kevin12345Mc: folds 
Uncalled bet (300) returned to taluk_00
taluk_00 collected 1240 from pot
taluk_00: doesn't show hand 
*** SUMMARY ***
Total pot 1240 | Rake 0 
Seat 1: 578346 folded before Flop (didn't bet)
Seat 2: IoannisVaios folded before Flop (didn't bet)
Seat 3: SaLouTiGR folded before Flop (didn't bet)
Seat 4: tabu33 (button) folded before Flop (didn't bet)
Seat 5: Kevin12345Mc (small blind) folded before Flop
Seat 6: taluk_00 (big blind) collected (1240)
Seat 7: MahSandrs folded before Flop (didn't bet)
Seat 8: bereket31 folded before Flop (didn't bet)



PokerStars Hand #254989089376: Tournament #3858857107, $2.45+$2.45+$0.60 USD Hold'em No Limit - Level VII (300/600) - 2025/02/22 18:31:56 WET [2025/02/22 13:31:56 ET]
Table '3858857107 71' 8-max Seat #5 is the button
Seat 1: 578346 (59541 in chips, $2.45 bounty) 
Seat 2: IoannisVaios (24008 in chips, $2.45 bounty) 
Seat 3: SaLouTiGR (12762 in chips, $2.45 bounty) 
Seat 4: tabu33 (20200 in chips, $2.45 bounty) 
Seat 5: Kevin12345Mc (45655 in chips, $3.67 bounty) 
Seat 6: taluk_00 (24435 in chips, $2.45 bounty) 
Seat 7: MahSandrs (42315 in chips, $2.45 bounty) 
Seat 8: bereket31 (15783 in chips, $2.45 bounty) 
578346: posts the ante 80
IoannisVaios: posts the ante 80
SaLouTiGR: posts the ante 80
tabu33: posts the ante 80
Kevin12345Mc: posts the ante 80
taluk_00: posts the ante 80
MahSandrs: posts the ante 80
bereket31: posts the ante 80
taluk_00: posts small blind 300
MahSandrs: posts big blind 600
*** HOLE CARDS ***
Dealt to Kevin12345Mc [As 6d]
bereket31: folds 
578346: folds 
IoannisVaios: folds 
SaLouTiGR: folds 
tabu33: raises 600 to 1200
Kevin12345Mc: folds 
taluk_00: folds 
MahSandrs: calls 600
*** FLOP *** [2h 8s 5d]
MahSandrs: checks 
tabu33: bets 1800
MahSandrs: folds 
Uncalled bet (1800) returned to tabu33
tabu33 collected 3340 from pot
tabu33: doesn't show hand 
*** SUMMARY ***
Total pot 3340 | Rake 0 
Board [2h 8s 5d]
Seat 1: 578346 folded before Flop (didn't bet)
Seat 2: IoannisVaios folded before Flop (didn't bet)
Seat 3: SaLouTiGR folded before Flop (didn't bet)
Seat 4: tabu33 collected (3340)
Seat 5: Kevin12345Mc (button) folded before Flop (didn't bet)
Seat 6: taluk_00 (small blind) folded before Flop
Seat 7: MahSandrs (big blind) folded on the Flop
Seat 8: bereket31 folded before Flop (didn't bet)



PokerStars Hand #254989107984: Tournament #3858857107, $2.45+$2.45+$0.60 USD Hold'em No Limit - Level VII (300/600) - 2025/02/22 18:33:00 WET [2025/02/22 13:33:00 ET]
Table '3858857107 71' 8-max Seat #6 is the button
Seat 1: 578346 (59461 in chips, $2.45 bounty) 
Seat 2: IoannisVaios (23928 in chips, $2.45 bounty) 
Seat 3: SaLouTiGR (12682 in chips, $2.45 bounty) 
Seat 4: tabu33 (22260 in chips, $2.45 bounty) 
Seat 5: Kevin12345Mc (45575 in chips, $3.67 bounty) 
Seat 6: taluk_00 (24055 in chips, $2.45 bounty) 
Seat 7: MahSandrs (41035 in chips, $2.45 bounty) 
Seat 8: bereket31 (15703 in chips, $2.45 bounty) 
578346: posts the ante 80
IoannisVaios: posts the ante 80
SaLouTiGR: posts the ante 80
tabu33: posts the ante 80
Kevin12345Mc: posts the ante 80
taluk_00: posts the ante 80
MahSandrs: posts the ante 80
bereket31: posts the ante 80
MahSandrs: posts small blind 300
bereket31: posts big blind 600
*** HOLE CARDS ***
Dealt to Kevin12345Mc [Ts 3c]
578346: folds 
IoannisVaios: raises 648 to 1248
SaLouTiGR: folds 
tabu33: folds 
Kevin12345Mc: folds 
taluk_00: folds 
MahSandrs: folds 
bereket31: folds 
Uncalled bet (648) returned to IoannisVaios
IoannisVaios collected 2140 from pot
IoannisVaios: doesn't show hand 
*** SUMMARY ***
Total pot 2140 | Rake 0 
Seat 1: 578346 folded before Flop (didn't bet)
Seat 2: IoannisVaios collected (2140)
Seat 3: SaLouTiGR folded before Flop (didn't bet)
Seat 4: tabu33 folded before Flop (didn't bet)
Seat 5: Kevin12345Mc folded before Flop (didn't bet)
Seat 6: taluk_00 (button) folded before Flop (didn't bet)
Seat 7: MahSandrs (small blind) folded before Flop
Seat 8: bereket31 (big blind) folded before Flop



PokerStars Hand #254989115911: Tournament #3858857107, $2.45+$2.45+$0.60 USD Hold'em No Limit - Level VII (300/600) - 2025/02/22 18:33:27 WET [2025/02/22 13:33:27 ET]
Table '3858857107 71' 8-max Seat #7 is the button
Seat 1: 578346 (59381 in chips, $2.45 bounty) 
Seat 2: IoannisVaios (25388 in chips, $2.45 bounty) 
Seat 3: SaLouTiGR (12602 in chips, $2.45 bounty) 
Seat 4: tabu33 (22180 in chips, $2.45 bounty) 
Seat 5: Kevin12345Mc (45495 in chips, $3.67 bounty) 
Seat 6: taluk_00 (23975 in chips, $2.45 bounty) 
Seat 7: MahSandrs (40655 in chips, $2.45 bounty) 
Seat 8: bereket31 (15023 in chips, $2.45 bounty) 
578346: posts the ante 80
IoannisVaios: posts the ante 80
SaLouTiGR: posts the ante 80
tabu33: posts the ante 80
Kevin12345Mc: posts the ante 80
taluk_00: posts the ante 80
MahSandrs: posts the ante 80
bereket31: posts the ante 80
bereket31: posts small blind 300
578346: posts big blind 600
*** HOLE CARDS ***
Dealt to Kevin12345Mc [Qh 6h]
IoannisVaios: folds 
SaLouTiGR: folds 
tabu33: raises 600 to 1200
Kevin12345Mc: folds 
taluk_00: folds 
MahSandrs: folds 
bereket31: folds 
578346: calls 600
*** FLOP *** [Jd Kc Ah]
578346: checks 
tabu33: bets 1070
578346: calls 1070
*** TURN *** [Jd Kc Ah] [Qs]
578346: checks 
tabu33: checks 
*** RIVER *** [Jd Kc Ah Qs] [6d]
578346: bets 3008
tabu33: calls 3008
*** SHOW DOWN ***
578346: shows [Jh Qc] (two pair, Queens and Jacks)
tabu33: shows [Ks Qd] (two pair, Kings and Queens)
tabu33 collected 11496 from pot
*** SUMMARY ***
Total pot 11496 | Rake 0 
Board [Jd Kc Ah Qs 6d]
Seat 1: 578346 (big blind) showed [Jh Qc] and lost with two pair, Queens and Jacks
Seat 2: IoannisVaios folded before Flop (didn't bet)
Seat 3: SaLouTiGR folded before Flop (didn't bet)
Seat 4: tabu33 showed [Ks Qd] and won (11496) with two pair, Kings and Queens
Seat 5: Kevin12345Mc folded before Flop (didn't bet)
Seat 6: taluk_00 folded before Flop (didn't bet)
Seat 7: MahSandrs (button) folded before Flop (didn't bet)
Seat 8: bereket31 (small blind) folded before Flop



PokerStars Hand #254989148849: Tournament #3858857107, $2.45+$2.45+$0.60 USD Hold'em No Limit - Level VIII (350/700) - 2025/02/22 18:35:23 WET [2025/02/22 13:35:23 ET]
Table '3858857107 71' 8-max Seat #8 is the button
Seat 1: 578346 (54023 in chips, $2.45 bounty) 
Seat 2: IoannisVaios (25308 in chips, $2.45 bounty) 
Seat 3: SaLouTiGR (12522 in chips, $2.45 bounty) 
Seat 4: tabu33 (28318 in chips, $2.45 bounty) 
Seat 5: Kevin12345Mc (45415 in chips, $3.67 bounty) 
Seat 6: taluk_00 (23895 in chips, $2.45 bounty) 
Seat 7: MahSandrs (40575 in chips, $2.45 bounty) 
Seat 8: bereket31 (14643 in chips, $2.45 bounty) 
578346: posts the ante 90
IoannisVaios: posts the ante 90
SaLouTiGR: posts the ante 90
tabu33: posts the ante 90
Kevin12345Mc: posts the ante 90
taluk_00: posts the ante 90
MahSandrs: posts the ante 90
bereket31: posts the ante 90
578346: posts small blind 350
IoannisVaios: posts big blind 700
*** HOLE CARDS ***
Dealt to Kevin12345Mc [8c 7c]
SaLouTiGR: folds 
tabu33: calls 700
Kevin12345Mc: folds 
taluk_00: folds 
MahSandrs: raises 2100 to 2800
bereket31: folds 
578346: folds 
IoannisVaios: folds 
tabu33: folds 
Uncalled bet (2100) returned to MahSandrs
MahSandrs collected 3170 from pot
MahSandrs: doesn't show hand 
*** SUMMARY ***
Total pot 3170 | Rake 0 
Seat 1: 578346 (small blind) folded before Flop
Seat 2: IoannisVaios (big blind) folded before Flop
Seat 3: SaLouTiGR folded before Flop (didn't bet)
Seat 4: tabu33 folded before Flop
Seat 5: Kevin12345Mc folded before Flop (didn't bet)
Seat 6: taluk_00 folded before Flop (didn't bet)
Seat 7: MahSandrs collected (3170)
Seat 8: bereket31 (button) folded before Flop (didn't bet)



PokerStars Hand #254989159427: Tournament #3858857107, $2.45+$2.45+$0.60 USD Hold'em No Limit - Level VIII (350/700) - 2025/02/22 18:36:00 WET [2025/02/22 13:36:00 ET]
Table '3858857107 71' 8-max Seat #1 is the button
Seat 1: 578346 (53583 in chips, $2.45 bounty) 
Seat 2: IoannisVaios (24518 in chips, $2.45 bounty) 
Seat 3: SaLouTiGR (12432 in chips, $2.45 bounty) 
Seat 4: tabu33 (27528 in chips, $2.45 bounty) 
Seat 5: Kevin12345Mc (45325 in chips, $3.67 bounty) 
Seat 6: taluk_00 (23805 in chips, $2.45 bounty) 
Seat 7: MahSandrs (42955 in chips, $2.45 bounty) 
Seat 8: bereket31 (14553 in chips, $2.45 bounty) 
578346: posts the ante 90
IoannisVaios: posts the ante 90
SaLouTiGR: posts the ante 90
tabu33: posts the ante 90
Kevin12345Mc: posts the ante 90
taluk_00: posts the ante 90
MahSandrs: posts the ante 90
bereket31: posts the ante 90
IoannisVaios: posts small blind 350
SaLouTiGR: posts big blind 700
*** HOLE CARDS ***
Dealt to Kevin12345Mc [Qd 5h]
tabu33: folds 
Kevin12345Mc: folds 
taluk_00: folds 
MahSandrs: folds 
bereket31: folds 
578346: folds 
IoannisVaios: folds 
Uncalled bet (350) returned to SaLouTiGR
SaLouTiGR collected 1420 from pot
SaLouTiGR: doesn't show hand 
*** SUMMARY ***
Total pot 1420 | Rake 0 
Seat 1: 578346 (button) folded before Flop (didn't bet)
Seat 2: IoannisVaios (small blind) folded before Flop
Seat 3: SaLouTiGR (big blind) collected (1420)
Seat 4: tabu33 folded before Flop (didn't bet)
Seat 5: Kevin12345Mc folded before Flop (didn't bet)
Seat 6: taluk_00 folded before Flop (didn't bet)
Seat 7: MahSandrs folded before Flop (didn't bet)
Seat 8: bereket31 folded before Flop (didn't bet)



PokerStars Hand #254989167079: Tournament #3858857107, $2.45+$2.45+$0.60 USD Hold'em No Limit - Level VIII (350/700) - 2025/02/22 18:36:26 WET [2025/02/22 13:36:26 ET]
Table '3858857107 71' 8-max Seat #2 is the button
Seat 1: 578346 (53493 in chips, $2.45 bounty) 
Seat 2: IoannisVaios (24078 in chips, $2.45 bounty) 
Seat 3: SaLouTiGR (13412 in chips, $2.45 bounty) 
Seat 4: tabu33 (27438 in chips, $2.45 bounty) 
Seat 5: Kevin12345Mc (45235 in chips, $3.67 bounty) 
Seat 6: taluk_00 (23715 in chips, $2.45 bounty) 
Seat 7: MahSandrs (42865 in chips, $2.45 bounty) 
Seat 8: bereket31 (14463 in chips, $2.45 bounty) 
578346: posts the ante 90
IoannisVaios: posts the ante 90
SaLouTiGR: posts the ante 90
tabu33: posts the ante 90
Kevin12345Mc: posts the ante 90
taluk_00: posts the ante 90
MahSandrs: posts the ante 90
bereket31: posts the ante 90
SaLouTiGR: posts small blind 350
tabu33: posts big blind 700
*** HOLE CARDS ***
Dealt to Kevin12345Mc [2d 3h]
Kevin12345Mc: folds 
taluk_00: folds 
MahSandrs: folds 
bereket31: calls 700
578346: folds 
IoannisVaios: folds 
SaLouTiGR: folds 
tabu33: checks 
*** FLOP *** [Jh 2h Qd]
tabu33: checks 
bereket31: checks 
*** TURN *** [Jh 2h Qd] [9c]
tabu33: bets 700
bereket31: folds 
Uncalled bet (700) returned to tabu33
tabu33 collected 2470 from pot
tabu33: doesn't show hand 
*** SUMMARY ***
Total pot 2470 | Rake 0 
Board [Jh 2h Qd 9c]
Seat 1: 578346 folded before Flop (didn't bet)
Seat 2: IoannisVaios (button) folded before Flop (didn't bet)
Seat 3: SaLouTiGR (small blind) folded before Flop
Seat 4: tabu33 (big blind) collected (2470)
Seat 5: Kevin12345Mc folded before Flop (didn't bet)
Seat 6: taluk_00 folded before Flop (didn't bet)
Seat 7: MahSandrs folded before Flop (didn't bet)
Seat 8: bereket31 folded on the Turn



PokerStars Hand #254989177907: Tournament #3858857107, $2.45+$2.45+$0.60 USD Hold'em No Limit - Level VIII (350/700) - 2025/02/22 18:37:03 WET [2025/02/22 13:37:03 ET]
Table '3858857107 71' 8-max Seat #3 is the button
Seat 1: 578346 (53403 in chips, $2.45 bounty) 
Seat 2: IoannisVaios (23988 in chips, $2.45 bounty) 
Seat 3: SaLouTiGR (12972 in chips, $2.45 bounty) 
Seat 4: tabu33 (29118 in chips, $2.45 bounty) 
Seat 5: Kevin12345Mc (45145 in chips, $3.67 bounty) 
Seat 6: taluk_00 (23625 in chips, $2.45 bounty) 
Seat 7: MahSandrs (42775 in chips, $2.45 bounty) 
Seat 8: bereket31 (13673 in chips, $2.45 bounty) 
578346: posts the ante 90
IoannisVaios: posts the ante 90
SaLouTiGR: posts the ante 90
tabu33: posts the ante 90
Kevin12345Mc: posts the ante 90
taluk_00: posts the ante 90
MahSandrs: posts the ante 90
bereket31: posts the ante 90
tabu33: posts small blind 350
Kevin12345Mc: posts big blind 700
*** HOLE CARDS ***
Dealt to Kevin12345Mc [9s Ks]
taluk_00: folds 
MahSandrs: raises 700 to 1400
bereket31: folds 
578346: calls 1400
IoannisVaios: folds 
SaLouTiGR: folds 
tabu33: calls 1050
Kevin12345Mc: calls 700
*** FLOP *** [4d 4c 8c]
tabu33: checks 
Kevin12345Mc: checks 
MahSandrs: bets 2086
578346: calls 2086
tabu33: folds 
Kevin12345Mc: folds 
*** TURN *** [4d 4c 8c] [8d]
MahSandrs: checks 
578346: checks 
*** RIVER *** [4d 4c 8c 8d] [Jh]
MahSandrs: bets 10500
578346: folds 
Uncalled bet (10500) returned to MahSandrs
MahSandrs collected 10492 from pot
MahSandrs: doesn't show hand 
*** SUMMARY ***
Total pot 10492 | Rake 0 
Board [4d 4c 8c 8d Jh]
Seat 1: 578346 folded on the River
Seat 2: IoannisVaios folded before Flop (didn't bet)
Seat 3: SaLouTiGR (button) folded before Flop (didn't bet)
Seat 4: tabu33 (small blind) folded on the Flop
Seat 5: Kevin12345Mc (big blind) folded on the Flop
Seat 6: taluk_00 folded before Flop (didn't bet)
Seat 7: MahSandrs collected (10492)
Seat 8: bereket31 folded before Flop (didn't bet)



PokerStars Hand #254989208497: Tournament #3858857107, $2.45+$2.45+$0.60 USD Hold'em No Limit - Level VIII (350/700) - 2025/02/22 18:38:50 WET [2025/02/22 13:38:50 ET]
Table '3858857107 71' 8-max Seat #4 is the button
Seat 1: 578346 (49827 in chips, $2.45 bounty) 
Seat 2: IoannisVaios (23898 in chips, $2.45 bounty) 
Seat 3: SaLouTiGR (12882 in chips, $2.45 bounty) 
Seat 4: tabu33 (27628 in chips, $2.45 bounty) 
Seat 5: Kevin12345Mc (43655 in chips, $3.67 bounty) 
Seat 6: taluk_00 (23535 in chips, $2.45 bounty) 
Seat 7: MahSandrs (49691 in chips, $2.45 bounty) 
Seat 8: bereket31 (13583 in chips, $2.45 bounty) 
578346: posts the ante 90
IoannisVaios: posts the ante 90
SaLouTiGR: posts the ante 90
tabu33: posts the ante 90
Kevin12345Mc: posts the ante 90
taluk_00: posts the ante 90
MahSandrs: posts the ante 90
bereket31: posts the ante 90
Kevin12345Mc: posts small blind 350
taluk_00: posts big blind 700
*** HOLE CARDS ***
Dealt to Kevin12345Mc [7h 5h]
MahSandrs: raises 700 to 1400
bereket31: folds 
578346: folds 
IoannisVaios: folds 
SaLouTiGR: folds 
tabu33: folds 
Kevin12345Mc: folds 
taluk_00: calls 700
*** FLOP *** [5s 2d 8d]
taluk_00: checks 
MahSandrs: bets 1974
taluk_00: folds 
Uncalled bet (1974) returned to MahSandrs
MahSandrs collected 3870 from pot
MahSandrs: doesn't show hand 
*** SUMMARY ***
Total pot 3870 | Rake 0 
Board [5s 2d 8d]
Seat 1: 578346 folded before Flop (didn't bet)
Seat 2: IoannisVaios folded before Flop (didn't bet)
Seat 3: SaLouTiGR folded before Flop (didn't bet)
Seat 4: tabu33 (button) folded before Flop (didn't bet)
Seat 5: Kevin12345Mc (small blind) folded before Flop
Seat 6: taluk_00 (big blind) folded on the Flop
Seat 7: MahSandrs collected (3870)
Seat 8: bereket31 folded before Flop (didn't bet)



PokerStars Hand #254989220798: Tournament #3858857107, $2.45+$2.45+$0.60 USD Hold'em No Limit - Level VIII (350/700) - 2025/02/22 18:39:32 WET [2025/02/22 13:39:32 ET]
Table '3858857107 71' 8-max Seat #5 is the button
Seat 1: 578346 (49737 in chips, $2.45 bounty) 
Seat 2: IoannisVaios (23808 in chips, $2.45 bounty) 
Seat 3: SaLouTiGR (12792 in chips, $2.45 bounty) 
Seat 4: tabu33 (27538 in chips, $2.45 bounty) 
Seat 5: Kevin12345Mc (43215 in chips, $3.67 bounty) 
Seat 6: taluk_00 (22045 in chips, $2.45 bounty) 
Seat 7: MahSandrs (52071 in chips, $2.45 bounty) 
Seat 8: bereket31 (13493 in chips, $2.45 bounty) 
578346: posts the ante 90
IoannisVaios: posts the ante 90
SaLouTiGR: posts the ante 90
tabu33: posts the ante 90
Kevin12345Mc: posts the ante 90
taluk_00: posts the ante 90
MahSandrs: posts the ante 90
bereket31: posts the ante 90
taluk_00: posts small blind 350
MahSandrs: posts big blind 700
*** HOLE CARDS ***
Dealt to Kevin12345Mc [Ah 3c]
bereket31: folds 
578346: folds 
IoannisVaios: folds 
SaLouTiGR: folds 
tabu33: folds 
Kevin12345Mc: raises 910 to 1610
taluk_00: raises 3290 to 4900
MahSandrs: folds 
Kevin12345Mc: folds 
Uncalled bet (3290) returned to taluk_00
taluk_00 collected 4640 from pot
taluk_00: doesn't show hand 
*** SUMMARY ***
Total pot 4640 | Rake 0 
Seat 1: 578346 folded before Flop (didn't bet)
Seat 2: IoannisVaios folded before Flop (didn't bet)
Seat 3: SaLouTiGR folded before Flop (didn't bet)
Seat 4: tabu33 folded before Flop (didn't bet)
Seat 5: Kevin12345Mc (button) folded before Flop
Seat 6: taluk_00 (small blind) collected (4640)
Seat 7: MahSandrs (big blind) folded before Flop
Seat 8: bereket31 folded before Flop (didn't bet)



PokerStars Hand #254989231011: Tournament #3858857107, $2.45+$2.45+$0.60 USD Hold'em No Limit - Level VIII (350/700) - 2025/02/22 18:40:08 WET [2025/02/22 13:40:08 ET]
Table '3858857107 71' 8-max Seat #6 is the button
Seat 1: 578346 (49647 in chips, $2.45 bounty) 
Seat 2: IoannisVaios (23718 in chips, $2.45 bounty) 
Seat 3: SaLouTiGR (12702 in chips, $2.45 bounty) 
Seat 4: tabu33 (27448 in chips, $2.45 bounty) 
Seat 5: Kevin12345Mc (41515 in chips, $3.67 bounty) 
Seat 6: taluk_00 (24985 in chips, $2.45 bounty) 
Seat 7: MahSandrs (51281 in chips, $2.45 bounty) 
Seat 8: bereket31 (13403 in chips, $2.45 bounty) 
578346: posts the ante 90
IoannisVaios: posts the ante 90
SaLouTiGR: posts the ante 90
tabu33: posts the ante 90
Kevin12345Mc: posts the ante 90
taluk_00: posts the ante 90
MahSandrs: posts the ante 90
bereket31: posts the ante 90
MahSandrs: posts small blind 350
bereket31: posts big blind 700
*** HOLE CARDS ***
Dealt to Kevin12345Mc [5d Ad]
578346: folds 
IoannisVaios: folds 
SaLouTiGR has timed out
SaLouTiGR: folds 
SaLouTiGR is sitting out
tabu33: folds 
Kevin12345Mc: raises 910 to 1610
taluk_00: folds 
MahSandrs: folds 
bereket31: folds 
Uncalled bet (910) returned to Kevin12345Mc
Kevin12345Mc collected 2470 from pot
Kevin12345Mc: doesn't show hand 
*** SUMMARY ***
Total pot 2470 | Rake 0 
Seat 1: 578346 folded before Flop (didn't bet)
Seat 2: IoannisVaios folded before Flop (didn't bet)
Seat 3: SaLouTiGR folded before Flop (didn't bet)
Seat 4: tabu33 folded before Flop (didn't bet)
Seat 5: Kevin12345Mc collected (2470)
Seat 6: taluk_00 (button) folded before Flop (didn't bet)
Seat 7: MahSandrs (small blind) folded before Flop
Seat 8: bereket31 (big blind) folded before Flop



PokerStars Hand #254989251820: Tournament #3858857107, $2.45+$2.45+$0.60 USD Hold'em No Limit - Level VIII (350/700) - 2025/02/22 18:41:20 WET [2025/02/22 13:41:20 ET]
Table '3858857107 71' 8-max Seat #7 is the button
Seat 1: 578346 (49557 in chips, $2.45 bounty) 
Seat 2: IoannisVaios (23628 in chips, $2.45 bounty) 
Seat 3: SaLouTiGR (12612 in chips, $2.45 bounty) is sitting out
Seat 4: tabu33 (27358 in chips, $2.45 bounty) 
Seat 5: Kevin12345Mc (43195 in chips, $3.67 bounty) 
Seat 6: taluk_00 (24895 in chips, $2.45 bounty) 
Seat 7: MahSandrs (50841 in chips, $2.45 bounty) 
Seat 8: bereket31 (12613 in chips, $2.45 bounty) 
578346: posts the ante 90
IoannisVaios: posts the ante 90
SaLouTiGR: posts the ante 90
tabu33: posts the ante 90
Kevin12345Mc: posts the ante 90
taluk_00: posts the ante 90
MahSandrs: posts the ante 90
bereket31: posts the ante 90
bereket31: posts small blind 350
578346: posts big blind 700
*** HOLE CARDS ***
Dealt to Kevin12345Mc [7c 8d]
IoannisVaios: folds 
SaLouTiGR: folds 
tabu33: folds 
Kevin12345Mc: folds 
taluk_00: folds 
MahSandrs: raises 700 to 1400
bereket31: folds 
578346: calls 700
*** FLOP *** [3d 9h Ah]
578346: checks 
MahSandrs: bets 1274
578346: folds 
Uncalled bet (1274) returned to MahSandrs
MahSandrs collected 3870 from pot
MahSandrs: doesn't show hand 
*** SUMMARY ***
Total pot 3870 | Rake 0 
Board [3d 9h Ah]
Seat 1: 578346 (big blind) folded on the Flop
Seat 2: IoannisVaios folded before Flop (didn't bet)
Seat 3: SaLouTiGR folded before Flop (didn't bet)
Seat 4: tabu33 folded before Flop (didn't bet)
Seat 5: Kevin12345Mc folded before Flop (didn't bet)
Seat 6: taluk_00 folded before Flop (didn't bet)
Seat 7: MahSandrs (button) collected (3870)
Seat 8: bereket31 (small blind) folded before Flop



PokerStars Hand #254989264567: Tournament #3858857107, $2.45+$2.45+$0.60 USD Hold'em No Limit - Level VIII (350/700) - 2025/02/22 18:42:05 WET [2025/02/22 13:42:05 ET]
Table '3858857107 71' 8-max Seat #8 is the button
Seat 1: 578346 (48067 in chips, $2.45 bounty) 
Seat 2: IoannisVaios (23538 in chips, $2.45 bounty) 
Seat 3: SaLouTiGR (12522 in chips, $2.45 bounty) is sitting out
Seat 4: tabu33 (27268 in chips, $2.45 bounty) 
Seat 5: Kevin12345Mc (43105 in chips, $3.67 bounty) 
Seat 6: taluk_00 (24805 in chips, $2.45 bounty) 
Seat 7: MahSandrs (53221 in chips, $2.45 bounty) 
Seat 8: bereket31 (12173 in chips, $2.45 bounty) 
578346: posts the ante 90
IoannisVaios: posts the ante 90
SaLouTiGR: posts the ante 90
tabu33: posts the ante 90
Kevin12345Mc: posts the ante 90
taluk_00: posts the ante 90
MahSandrs: posts the ante 90
bereket31: posts the ante 90
578346: posts small blind 350
IoannisVaios: posts big blind 700
*** HOLE CARDS ***
Dealt to Kevin12345Mc [Qs Ad]
SaLouTiGR: folds 
SaLouTiGR has returned
tabu33: folds 
Kevin12345Mc: raises 910 to 1610
taluk_00: raises 2590 to 4200
MahSandrs: folds 
bereket31: folds 
578346: folds 
IoannisVaios: folds 
Kevin12345Mc: calls 2590
*** FLOP *** [5h 3d 8c]
Kevin12345Mc: checks 
taluk_00: bets 4200
Kevin12345Mc: folds 
Uncalled bet (4200) returned to taluk_00
taluk_00 collected 10170 from pot
taluk_00: doesn't show hand 
*** SUMMARY ***
Total pot 10170 | Rake 0 
Board [5h 3d 8c]
Seat 1: 578346 (small blind) folded before Flop
Seat 2: IoannisVaios (big blind) folded before Flop
Seat 3: SaLouTiGR folded before Flop (didn't bet)
Seat 4: tabu33 folded before Flop (didn't bet)
Seat 5: Kevin12345Mc folded on the Flop
Seat 6: taluk_00 collected (10170)
Seat 7: MahSandrs folded before Flop (didn't bet)
Seat 8: bereket31 (button) folded before Flop (didn't bet)



PokerStars Hand #254989276981: Tournament #3858857107, $2.45+$2.45+$0.60 USD Hold'em No Limit - Level IX (400/800) - 2025/02/22 18:42:48 WET [2025/02/22 13:42:48 ET]
Table '3858857107 71' 8-max Seat #1 is the button
Seat 1: 578346 (47627 in chips, $2.45 bounty) 
Seat 2: IoannisVaios (22748 in chips, $2.45 bounty) 
Seat 3: SaLouTiGR (12432 in chips, $2.45 bounty) 
Seat 4: tabu33 (27178 in chips, $2.45 bounty) 
Seat 5: Kevin12345Mc (38815 in chips, $3.67 bounty) 
Seat 6: taluk_00 (30685 in chips, $2.45 bounty) 
Seat 7: MahSandrs (53131 in chips, $2.45 bounty) 
Seat 8: bereket31 (12083 in chips, $2.45 bounty) 
578346: posts the ante 100
IoannisVaios: posts the ante 100
SaLouTiGR: posts the ante 100
tabu33: posts the ante 100
Kevin12345Mc: posts the ante 100
taluk_00: posts the ante 100
MahSandrs: posts the ante 100
bereket31: posts the ante 100
IoannisVaios: posts small blind 400
SaLouTiGR: posts big blind 800
*** HOLE CARDS ***
Dealt to Kevin12345Mc [8h 6h]
tabu33: folds 
Kevin12345Mc: folds 
taluk_00: folds 
MahSandrs: raises 800 to 1600
bereket31: folds 
578346: calls 1600
IoannisVaios: folds 
SaLouTiGR: folds 
*** FLOP *** [3s 8d 9h]
MahSandrs: checks 
578346: checks 
*** TURN *** [3s 8d 9h] [3h]
MahSandrs: bets 2656
578346: calls 2656
*** RIVER *** [3s 8d 9h 3h] [Jh]
MahSandrs: bets 5344
578346: folds 
Uncalled bet (5344) returned to MahSandrs
MahSandrs collected 10512 from pot
MahSandrs: doesn't show hand 
*** SUMMARY ***
Total pot 10512 | Rake 0 
Board [3s 8d 9h 3h Jh]
Seat 1: 578346 (button) folded on the River
Seat 2: IoannisVaios (small blind) folded before Flop
Seat 3: SaLouTiGR (big blind) folded before Flop
Seat 4: tabu33 folded before Flop (didn't bet)
Seat 5: Kevin12345Mc folded before Flop (didn't bet)
Seat 6: taluk_00 folded before Flop (didn't bet)
Seat 7: MahSandrs collected (10512)
Seat 8: bereket31 folded before Flop (didn't bet)



PokerStars Hand #254989292672: Tournament #3858857107, $2.45+$2.45+$0.60 USD Hold'em No Limit - Level IX (400/800) - 2025/02/22 18:43:43 WET [2025/02/22 13:43:43 ET]
Table '3858857107 71' 8-max Seat #2 is the button
Seat 1: 578346 (43271 in chips, $2.45 bounty) 
Seat 2: IoannisVaios (22248 in chips, $2.45 bounty) 
Seat 3: SaLouTiGR (11532 in chips, $2.45 bounty) 
Seat 4: tabu33 (27078 in chips, $2.45 bounty) 
Seat 5: Kevin12345Mc (38715 in chips, $3.67 bounty) 
Seat 6: taluk_00 (30585 in chips, $2.45 bounty) 
Seat 7: MahSandrs (59287 in chips, $2.45 bounty) 
Seat 8: bereket31 (11983 in chips, $2.45 bounty) 
578346: posts the ante 100
IoannisVaios: posts the ante 100
SaLouTiGR: posts the ante 100
tabu33: posts the ante 100
Kevin12345Mc: posts the ante 100
taluk_00: posts the ante 100
MahSandrs: posts the ante 100
bereket31: posts the ante 100
SaLouTiGR: posts small blind 400
tabu33: posts big blind 800
*** HOLE CARDS ***
Dealt to Kevin12345Mc [Td Jc]
Kevin12345Mc: folds 
taluk_00: folds 
MahSandrs: raises 800 to 1600
bereket31: folds 
578346: calls 1600
IoannisVaios: folds 
SaLouTiGR: folds 
tabu33: calls 800
*** FLOP *** [3d 7h Kd]
tabu33: checks 
MahSandrs: bets 1984
578346: calls 1984
tabu33: folds 
*** TURN *** [3d 7h Kd] [4s]
MahSandrs: bets 5104
578346: folds 
Uncalled bet (5104) returned to MahSandrs
MahSandrs collected 9968 from pot
MahSandrs: doesn't show hand 
*** SUMMARY ***
Total pot 9968 | Rake 0 
Board [3d 7h Kd 4s]
Seat 1: 578346 folded on the Turn
Seat 2: IoannisVaios (button) folded before Flop (didn't bet)
Seat 3: SaLouTiGR (small blind) folded before Flop
Seat 4: tabu33 (big blind) folded on the Flop
Seat 5: Kevin12345Mc folded before Flop (didn't bet)
Seat 6: taluk_00 folded before Flop (didn't bet)
Seat 7: MahSandrs collected (9968)
Seat 8: bereket31 folded before Flop (didn't bet)



PokerStars Hand #254989321840: Tournament #3858857107, $2.45+$2.45+$0.60 USD Hold'em No Limit - Level IX (400/800) - 2025/02/22 18:45:26 WET [2025/02/22 13:45:26 ET]
Table '3858857107 71' 8-max Seat #3 is the button
Seat 1: 578346 (39587 in chips, $2.45 bounty) 
Seat 2: IoannisVaios (22148 in chips, $2.45 bounty) 
Seat 3: SaLouTiGR (11032 in chips, $2.45 bounty) 
Seat 4: tabu33 (25378 in chips, $2.45 bounty) 
Seat 5: Kevin12345Mc (38615 in chips, $3.67 bounty) 
Seat 6: taluk_00 (30485 in chips, $2.45 bounty) 
Seat 7: MahSandrs (65571 in chips, $2.45 bounty) 
Seat 8: bereket31 (11883 in chips, $2.45 bounty) 
578346: posts the ante 100
IoannisVaios: posts the ante 100
SaLouTiGR: posts the ante 100
tabu33: posts the ante 100
Kevin12345Mc: posts the ante 100
taluk_00: posts the ante 100
MahSandrs: posts the ante 100
bereket31: posts the ante 100
tabu33: posts small blind 400
Kevin12345Mc: posts big blind 800
*** HOLE CARDS ***
Dealt to Kevin12345Mc [5c 9d]
taluk_00: folds 
MahSandrs: raises 1040 to 1840
bereket31: folds 
578346: folds 
IoannisVaios: folds 
SaLouTiGR: raises 9092 to 10932 and is all-in
tabu33: folds 
Kevin12345Mc: folds 
MahSandrs: calls 9092
*** FLOP *** [4h 5s Kh]
*** TURN *** [4h 5s Kh] [Ts]
*** RIVER *** [4h 5s Kh Ts] [9h]
*** SHOW DOWN ***
MahSandrs: shows [Ad 8d] (high card Ace)
SaLouTiGR: shows [9s Ah] (a pair of Nines)
SaLouTiGR collected 23864 from pot
*** SUMMARY ***
Total pot 23864 | Rake 0 
Board [4h 5s Kh Ts 9h]
Seat 1: 578346 folded before Flop (didn't bet)
Seat 2: IoannisVaios folded before Flop (didn't bet)
Seat 3: SaLouTiGR (button) showed [9s Ah] and won (23864) with a pair of Nines
Seat 4: tabu33 (small blind) folded before Flop
Seat 5: Kevin12345Mc (big blind) folded before Flop
Seat 6: taluk_00 folded before Flop (didn't bet)
Seat 7: MahSandrs showed [Ad 8d] and lost with high card Ace
Seat 8: bereket31 folded before Flop (didn't bet)



PokerStars Hand #254989335619: Tournament #3858857107, $2.45+$2.45+$0.60 USD Hold'em No Limit - Level IX (400/800) - 2025/02/22 18:46:15 WET [2025/02/22 13:46:15 ET]
Table '3858857107 71' 8-max Seat #4 is the button
Seat 1: 578346 (39487 in chips, $2.45 bounty) 
Seat 2: IoannisVaios (22048 in chips, $2.45 bounty) 
Seat 3: SaLouTiGR (23864 in chips, $2.45 bounty) 
Seat 4: tabu33 (24878 in chips, $2.45 bounty) 
Seat 5: Kevin12345Mc (37715 in chips, $3.67 bounty) 
Seat 6: taluk_00 (30385 in chips, $2.45 bounty) 
Seat 7: MahSandrs (54539 in chips, $2.45 bounty) 
Seat 8: bereket31 (11783 in chips, $2.45 bounty) 
578346: posts the ante 100
IoannisVaios: posts the ante 100
SaLouTiGR: posts the ante 100
tabu33: posts the ante 100
Kevin12345Mc: posts the ante 100
taluk_00: posts the ante 100
MahSandrs: posts the ante 100
bereket31: posts the ante 100
Kevin12345Mc: posts small blind 400
taluk_00: posts big blind 800
*** HOLE CARDS ***
Dealt to Kevin12345Mc [9c 6s]
MahSandrs: folds 
bereket31: folds 
578346: folds 
IoannisVaios: raises 864 to 1664
SaLouTiGR: folds 
tabu33: folds 
Kevin12345Mc: folds 
taluk_00: folds 
Uncalled bet (864) returned to IoannisVaios
IoannisVaios collected 2800 from pot
IoannisVaios: doesn't show hand 
*** SUMMARY ***
Total pot 2800 | Rake 0 
Seat 1: 578346 folded before Flop (didn't bet)
Seat 2: IoannisVaios collected (2800)
Seat 3: SaLouTiGR folded before Flop (didn't bet)
Seat 4: tabu33 (button) folded before Flop (didn't bet)
Seat 5: Kevin12345Mc (small blind) folded before Flop
Seat 6: taluk_00 (big blind) folded before Flop
Seat 7: MahSandrs folded before Flop (didn't bet)
Seat 8: bereket31 folded before Flop (didn't bet)



PokerStars Hand #254989343174: Tournament #3858857107, $2.45+$2.45+$0.60 USD Hold'em No Limit - Level IX (400/800) - 2025/02/22 18:46:41 WET [2025/02/22 13:46:41 ET]
Table '3858857107 71' 8-max Seat #5 is the button
Seat 1: 578346 (39387 in chips, $2.45 bounty) 
Seat 2: IoannisVaios (23948 in chips, $2.45 bounty) 
Seat 3: SaLouTiGR (23764 in chips, $2.45 bounty) 
Seat 4: tabu33 (24778 in chips, $2.45 bounty) 
Seat 5: Kevin12345Mc (37215 in chips, $3.67 bounty) 
Seat 6: taluk_00 (29485 in chips, $2.45 bounty) 
Seat 7: MahSandrs (54439 in chips, $2.45 bounty) 
Seat 8: bereket31 (11683 in chips, $2.45 bounty) 
578346: posts the ante 100
IoannisVaios: posts the ante 100
SaLouTiGR: posts the ante 100
tabu33: posts the ante 100
Kevin12345Mc: posts the ante 100
taluk_00: posts the ante 100
MahSandrs: posts the ante 100
bereket31: posts the ante 100
taluk_00: posts small blind 400
MahSandrs: posts big blind 800
*** HOLE CARDS ***
Dealt to Kevin12345Mc [5c 8c]
bereket31: folds 
578346: folds 
IoannisVaios: folds 
SaLouTiGR: folds 
tabu33: folds 
Kevin12345Mc: folds 
taluk_00: raises 1600 to 2400
MahSandrs: calls 1600
*** FLOP *** [4c 7s 9s]
taluk_00: bets 1848
MahSandrs: calls 1848
*** TURN *** [4c 7s 9s] [7d]
taluk_00: checks 
MahSandrs: bets 4736
taluk_00: folds 
Uncalled bet (4736) returned to MahSandrs
MahSandrs collected 9296 from pot
MahSandrs: doesn't show hand 
*** SUMMARY ***
Total pot 9296 | Rake 0 
Board [4c 7s 9s 7d]
Seat 1: 578346 folded before Flop (didn't bet)
Seat 2: IoannisVaios folded before Flop (didn't bet)
Seat 3: SaLouTiGR folded before Flop (didn't bet)
Seat 4: tabu33 folded before Flop (didn't bet)
Seat 5: Kevin12345Mc (button) folded before Flop (didn't bet)
Seat 6: taluk_00 (small blind) folded on the Turn
Seat 7: MahSandrs (big blind) collected (9296)
Seat 8: bereket31 folded before Flop (didn't bet)



PokerStars Hand #254989356779: Tournament #3858857107, $2.45+$2.45+$0.60 USD Hold'em No Limit - Level IX (400/800) - 2025/02/22 18:47:30 WET [2025/02/22 13:47:30 ET]
Table '3858857107 71' 8-max Seat #6 is the button
Seat 1: 578346 (39287 in chips, $2.45 bounty) 
Seat 2: IoannisVaios (23848 in chips, $2.45 bounty) 
Seat 3: SaLouTiGR (23664 in chips, $2.45 bounty) 
Seat 4: tabu33 (24678 in chips, $2.45 bounty) 
Seat 5: Kevin12345Mc (37115 in chips, $3.67 bounty) 
Seat 6: taluk_00 (25137 in chips, $2.45 bounty) 
Seat 7: MahSandrs (59387 in chips, $2.45 bounty) 
Seat 8: bereket31 (11583 in chips, $2.45 bounty) 
578346: posts the ante 100
IoannisVaios: posts the ante 100
SaLouTiGR: posts the ante 100
tabu33: posts the ante 100
Kevin12345Mc: posts the ante 100
taluk_00: posts the ante 100
MahSandrs: posts the ante 100
bereket31: posts the ante 100
MahSandrs: posts small blind 400
bereket31: posts big blind 800
*** HOLE CARDS ***
Dealt to Kevin12345Mc [Js Jc]
578346: folds 
IoannisVaios: folds 
SaLouTiGR: calls 800
tabu33: folds 
Kevin12345Mc: raises 1040 to 1840
taluk_00: folds 
MahSandrs: calls 1440
bereket31: raises 9643 to 11483 and is all-in
SaLouTiGR: folds 
Kevin12345Mc: raises 25532 to 37015 and is all-in
MahSandrs: calls 35175
*** FLOP *** [5d 2h 6h]
*** TURN *** [5d 2h 6h] [8h]
*** RIVER *** [5d 2h 6h 8h] [8c]
*** SHOW DOWN ***
MahSandrs: shows [Ad 6d] (two pair, Eights and Sixes)
Kevin12345Mc: shows [Js Jc] (two pair, Jacks and Eights)
Kevin12345Mc collected 51064 from side pot
bereket31: shows [As Qd] (a pair of Eights)
Kevin12345Mc collected 36049 from main pot
Kevin12345Mc wins $1.23 for eliminating bereket31 and their own bounty increases by $1.22 to $4.89
bereket31 finished the tournament
*** SUMMARY ***
Total pot 87113 Main pot 36049. Side pot 51064. | Rake 0 
Board [5d 2h 6h 8h 8c]
Seat 1: 578346 folded before Flop (didn't bet)
Seat 2: IoannisVaios folded before Flop (didn't bet)
Seat 3: SaLouTiGR folded before Flop
Seat 4: tabu33 folded before Flop (didn't bet)
Seat 5: Kevin12345Mc showed [Js Jc] and won (87113) with two pair, Jacks and Eights
Seat 6: taluk_00 (button) folded before Flop (didn't bet)
Seat 7: MahSandrs (small blind) showed [Ad 6d] and lost with two pair, Eights and Sixes
Seat 8: bereket31 (big blind) showed [As Qd] and lost with a pair of Eights



PokerStars Hand #254989372204: Tournament #3858857107, $2.45+$2.45+$0.60 USD Hold'em No Limit - Level IX (400/800) - 2025/02/22 18:48:24 WET [2025/02/22 13:48:24 ET]
Table '3858857107 71' 8-max Seat #7 is the button
Seat 1: 578346 (39187 in chips, $2.45 bounty) 
Seat 2: IoannisVaios (23748 in chips, $2.45 bounty) 
Seat 3: SaLouTiGR (22764 in chips, $2.45 bounty) 
Seat 4: tabu33 (24578 in chips, $2.45 bounty) 
Seat 5: Kevin12345Mc (87113 in chips, $4.89 bounty) 
Seat 6: taluk_00 (25037 in chips, $2.45 bounty) 
Seat 7: MahSandrs (22272 in chips, $2.45 bounty) 
578346: posts the ante 100
IoannisVaios: posts the ante 100
SaLouTiGR: posts the ante 100
tabu33: posts the ante 100
Kevin12345Mc: posts the ante 100
taluk_00: posts the ante 100
MahSandrs: posts the ante 100
578346: posts small blind 400
IoannisVaios: posts big blind 800
*** HOLE CARDS ***
Dealt to Kevin12345Mc [9h Ah]
Lunxspy is disconnected 
SaLouTiGR: calls 800
tabu33: folds 
Kevin12345Mc: raises 1040 to 1840
taluk_00: folds 
MahSandrs: folds 
578346: folds 
IoannisVaios: folds 
SaLouTiGR: raises 20824 to 22664 and is all-in
Kevin12345Mc: folds 
Uncalled bet (20824) returned to SaLouTiGR
SaLouTiGR collected 5580 from pot
SaLouTiGR: doesn't show hand 
*** SUMMARY ***
Total pot 5580 | Rake 0 
Seat 1: 578346 (small blind) folded before Flop
Seat 2: IoannisVaios (big blind) folded before Flop
Seat 3: SaLouTiGR collected (5580)
Seat 4: tabu33 folded before Flop (didn't bet)
Seat 5: Kevin12345Mc folded before Flop
Seat 6: taluk_00 folded before Flop (didn't bet)
Seat 7: MahSandrs (button) folded before Flop (didn't bet)



PokerStars Hand #254989391766: Tournament #3858857107, $2.45+$2.45+$0.60 USD Hold'em No Limit - Level IX (400/800) - 2025/02/22 18:49:33 WET [2025/02/22 13:49:33 ET]
Table '3858857107 71' 8-max Seat #1 is the button
Seat 1: 578346 (38687 in chips, $2.45 bounty) 
Seat 2: IoannisVaios (22848 in chips, $2.45 bounty) 
Seat 3: SaLouTiGR (26404 in chips, $2.45 bounty) 
Seat 4: tabu33 (24478 in chips, $2.45 bounty) 
Seat 5: Kevin12345Mc (85173 in chips, $4.89 bounty) 
Seat 6: taluk_00 (24937 in chips, $2.45 bounty) 
Seat 7: MahSandrs (22172 in chips, $2.45 bounty) 
Seat 8: Lunxspy (25000 in chips, $2.45 bounty) 
578346: posts the ante 100
IoannisVaios: posts the ante 100
SaLouTiGR: posts the ante 100
tabu33: posts the ante 100
Kevin12345Mc: posts the ante 100
taluk_00: posts the ante 100
MahSandrs: posts the ante 100
Lunxspy: posts the ante 100
IoannisVaios: posts small blind 400
SaLouTiGR: posts big blind 800
*** HOLE CARDS ***
Dealt to Kevin12345Mc [Qs 5s]
tabu33: raises 800 to 1600
Kevin12345Mc: folds 
taluk_00: folds 
MahSandrs: folds 
Lunxspy: raises 3464 to 5064
578346: folds 
IoannisVaios: folds 
SaLouTiGR: folds 
tabu33: calls 3464
*** FLOP *** [9c 2c 4d]
tabu33: checks 
Lunxspy: bets 5215
tabu33: folds 
Uncalled bet (5215) returned to Lunxspy
Lunxspy collected 12128 from pot
*** SUMMARY ***
Total pot 12128 | Rake 0 
Board [9c 2c 4d]
Seat 1: 578346 (button) folded before Flop (didn't bet)
Seat 2: IoannisVaios (small blind) folded before Flop
Seat 3: SaLouTiGR (big blind) folded before Flop
Seat 4: tabu33 folded on the Flop
Seat 5: Kevin12345Mc folded before Flop (didn't bet)
Seat 6: taluk_00 folded before Flop (didn't bet)
Seat 7: MahSandrs folded before Flop (didn't bet)
Seat 8: Lunxspy collected (12128)



PokerStars Hand #254989415917: Tournament #3858857107, $2.45+$2.45+$0.60 USD Hold'em No Limit - Level X (450/900) - 2025/02/22 18:50:59 WET [2025/02/22 13:50:59 ET]
Table '3858857107 71' 8-max Seat #2 is the button
Seat 1: 578346 (38587 in chips, $2.45 bounty) 
Seat 2: IoannisVaios (22348 in chips, $2.45 bounty) 
Seat 3: SaLouTiGR (25504 in chips, $2.45 bounty) 
Seat 4: tabu33 (19314 in chips, $2.45 bounty) 
Seat 5: Kevin12345Mc (85073 in chips, $4.89 bounty) 
Seat 6: taluk_00 (24837 in chips, $2.45 bounty) 
Seat 7: MahSandrs (22072 in chips, $2.45 bounty) 
Seat 8: Lunxspy (31964 in chips, $2.45 bounty) 
578346: posts the ante 125
IoannisVaios: posts the ante 125
SaLouTiGR: posts the ante 125
tabu33: posts the ante 125
Kevin12345Mc: posts the ante 125
taluk_00: posts the ante 125
MahSandrs: posts the ante 125
Lunxspy: posts the ante 125
SaLouTiGR: posts small blind 450
tabu33: posts big blind 900
*** HOLE CARDS ***
Dealt to Kevin12345Mc [Kd 7c]
Kevin12345Mc: folds 
taluk_00: folds 
MahSandrs: folds 
Lunxspy: raises 1683 to 2583
578346: calls 2583
IoannisVaios: folds 
SaLouTiGR: calls 2133
tabu33: folds 
*** FLOP *** [Th 8c Qs]
SaLouTiGR: bets 900
Lunxspy: raises 3778 to 4678
578346: folds 
SaLouTiGR: calls 3778
*** TURN *** [Th 8c Qs] [4h]
SaLouTiGR: checks 
Lunxspy: bets 4500
SaLouTiGR: folds 
Uncalled bet (4500) returned to Lunxspy
Lunxspy collected 19005 from pot
*** SUMMARY ***
Total pot 19005 | Rake 0 
Board [Th 8c Qs 4h]
Seat 1: 578346 folded on the Flop
Seat 2: IoannisVaios (button) folded before Flop (didn't bet)
Seat 3: SaLouTiGR (small blind) folded on the Turn
Seat 4: tabu33 (big blind) folded before Flop
Seat 5: Kevin12345Mc folded before Flop (didn't bet)
Seat 6: taluk_00 folded before Flop (didn't bet)
Seat 7: MahSandrs folded before Flop (didn't bet)
Seat 8: Lunxspy collected (19005)



PokerStars Hand #254989433079: Tournament #3858857107, $2.45+$2.45+$0.60 USD Hold'em No Limit - Level X (450/900) - 2025/02/22 18:52:00 WET [2025/02/22 13:52:00 ET]
Table '3858857107 71' 8-max Seat #3 is the button
Seat 1: 578346 (35879 in chips, $2.45 bounty) 
Seat 2: IoannisVaios (22223 in chips, $2.45 bounty) 
Seat 3: SaLouTiGR (18118 in chips, $2.45 bounty) 
Seat 4: tabu33 (18289 in chips, $2.45 bounty) 
Seat 5: Kevin12345Mc (84948 in chips, $4.89 bounty) 
Seat 6: taluk_00 (24712 in chips, $2.45 bounty) 
Seat 7: MahSandrs (21947 in chips, $2.45 bounty) 
Seat 8: Lunxspy (43583 in chips, $2.45 bounty) 
578346: posts the ante 125
IoannisVaios: posts the ante 125
SaLouTiGR: posts the ante 125
tabu33: posts the ante 125
Kevin12345Mc: posts the ante 125
taluk_00: posts the ante 125
MahSandrs: posts the ante 125
Lunxspy: posts the ante 125
tabu33: posts small blind 450
Kevin12345Mc: posts big blind 900
*** HOLE CARDS ***
Dealt to Kevin12345Mc [3s 3h]
taluk_00: raises 900 to 1800
MahSandrs: folds 
Lunxspy: calls 1800
578346: folds 
IoannisVaios: folds 
SaLouTiGR: folds 
tabu33: folds 
Kevin12345Mc: calls 900
*** FLOP *** [5d 2c 8c]
Kevin12345Mc: checks 
taluk_00: checks 
Lunxspy: checks 
*** TURN *** [5d 2c 8c] [Jd]
Kevin12345Mc: checks 
taluk_00: bets 3600
Lunxspy: folds 
Kevin12345Mc: folds 
Uncalled bet (3600) returned to taluk_00
taluk_00 collected 6850 from pot
taluk_00: doesn't show hand 
*** SUMMARY ***
Total pot 6850 | Rake 0 
Board [5d 2c 8c Jd]
Seat 1: 578346 folded before Flop (didn't bet)
Seat 2: IoannisVaios folded before Flop (didn't bet)
Seat 3: SaLouTiGR (button) folded before Flop (didn't bet)
Seat 4: tabu33 (small blind) folded before Flop
Seat 5: Kevin12345Mc (big blind) folded on the Turn
Seat 6: taluk_00 collected (6850)
Seat 7: MahSandrs folded before Flop (didn't bet)
Seat 8: Lunxspy folded on the Turn



PokerStars Hand #254989453610: Tournament #3858857107, $2.45+$2.45+$0.60 USD Hold'em No Limit - Level X (450/900) - 2025/02/22 18:53:13 WET [2025/02/22 13:53:13 ET]
Table '3858857107 71' 8-max Seat #4 is the button
Seat 1: 578346 (35754 in chips, $2.45 bounty) 
Seat 2: IoannisVaios (22098 in chips, $2.45 bounty) 
Seat 3: SaLouTiGR (17993 in chips, $2.45 bounty) 
Seat 4: tabu33 (17714 in chips, $2.45 bounty) 
Seat 5: Kevin12345Mc (83023 in chips, $4.89 bounty) 
Seat 6: taluk_00 (29637 in chips, $2.45 bounty) 
Seat 7: MahSandrs (21822 in chips, $2.45 bounty) 
Seat 8: Lunxspy (41658 in chips, $2.45 bounty) 
578346: posts the ante 125
IoannisVaios: posts the ante 125
SaLouTiGR: posts the ante 125
tabu33: posts the ante 125
Kevin12345Mc: posts the ante 125
taluk_00: posts the ante 125
MahSandrs: posts the ante 125
Lunxspy: posts the ante 125
Kevin12345Mc: posts small blind 450
taluk_00: posts big blind 900
*** HOLE CARDS ***
Dealt to Kevin12345Mc [Js 9s]
MahSandrs: folds 
Lunxspy: folds 
578346: folds 
IoannisVaios: folds 
SaLouTiGR: folds 
tabu33: raises 1800 to 2700
Kevin12345Mc: calls 2250
taluk_00: calls 1800
*** FLOP *** [Ah 9c Td]
Kevin12345Mc: checks 
taluk_00: checks 
tabu33: checks 
*** TURN *** [Ah 9c Td] [Ks]
Kevin12345Mc: checks 
taluk_00: checks 
tabu33: checks 
*** RIVER *** [Ah 9c Td Ks] [6d]
Kevin12345Mc: checks 
taluk_00: checks 
tabu33: checks 
*** SHOW DOWN ***
Kevin12345Mc: shows [Js 9s] (a pair of Nines)
taluk_00: shows [7c Kc] (a pair of Kings)
tabu33: shows [Qd Kh] (a pair of Kings - Ace+Queen kicker)
tabu33 collected 9100 from pot
*** SUMMARY ***
Total pot 9100 | Rake 0 
Board [Ah 9c Td Ks 6d]
Seat 1: 578346 folded before Flop (didn't bet)
Seat 2: IoannisVaios folded before Flop (didn't bet)
Seat 3: SaLouTiGR folded before Flop (didn't bet)
Seat 4: tabu33 (button) showed [Qd Kh] and won (9100) with a pair of Kings
Seat 5: Kevin12345Mc (small blind) showed [Js 9s] and lost with a pair of Nines
Seat 6: taluk_00 (big blind) showed [7c Kc] and lost with a pair of Kings
Seat 7: MahSandrs folded before Flop (didn't bet)
Seat 8: Lunxspy folded before Flop (didn't bet)



PokerStars Hand #254989469007: Tournament #3858857107, $2.45+$2.45+$0.60 USD Hold'em No Limit - Level X (450/900) - 2025/02/22 18:54:08 WET [2025/02/22 13:54:08 ET]
Table '3858857107 71' 8-max Seat #5 is the button
Seat 1: 578346 (35629 in chips, $2.45 bounty) 
Seat 2: IoannisVaios (21973 in chips, $2.45 bounty) 
Seat 3: SaLouTiGR (17868 in chips, $2.45 bounty) 
Seat 4: tabu33 (23989 in chips, $2.45 bounty) 
Seat 5: Kevin12345Mc (80198 in chips, $4.89 bounty) 
Seat 6: taluk_00 (26812 in chips, $2.45 bounty) 
Seat 7: MahSandrs (21697 in chips, $2.45 bounty) 
Seat 8: Lunxspy (41533 in chips, $2.45 bounty) 
578346: posts the ante 125
IoannisVaios: posts the ante 125
SaLouTiGR: posts the ante 125
tabu33: posts the ante 125
Kevin12345Mc: posts the ante 125
taluk_00: posts the ante 125
MahSandrs: posts the ante 125
Lunxspy: posts the ante 125
taluk_00: posts small blind 450
MahSandrs: posts big blind 900
*** HOLE CARDS ***
Dealt to Kevin12345Mc [6s 6h]
Lunxspy: raises 999 to 1899
578346: folds 
IoannisVaios: folds 
SaLouTiGR: folds 
tabu33: folds 
Kevin12345Mc: calls 1899
taluk_00: folds 
MahSandrs: calls 999
*** FLOP *** [Th Jc 5d]
MahSandrs: checks 
Lunxspy: bets 3073
Kevin12345Mc: folds 
MahSandrs: folds 
Uncalled bet (3073) returned to Lunxspy
Lunxspy collected 7147 from pot
*** SUMMARY ***
Total pot 7147 | Rake 0 
Board [Th Jc 5d]
Seat 1: 578346 folded before Flop (didn't bet)
Seat 2: IoannisVaios folded before Flop (didn't bet)
Seat 3: SaLouTiGR folded before Flop (didn't bet)
Seat 4: tabu33 folded before Flop (didn't bet)
Seat 5: Kevin12345Mc (button) folded on the Flop
Seat 6: taluk_00 (small blind) folded before Flop
Seat 7: MahSandrs (big blind) folded on the Flop
Seat 8: Lunxspy collected (7147)



PokerStars Hand #254989580532: Tournament #3858857107, $2.45+$2.45+$0.60 USD Hold'em No Limit - Level X (450/900) - 2025/02/22 19:02:47 WET [2025/02/22 14:02:47 ET]
Table '3858857107 71' 8-max Seat #6 is the button
Seat 1: 578346 (35504 in chips, $2.45 bounty) 
Seat 2: IoannisVaios (21848 in chips, $2.45 bounty) 
Seat 3: SaLouTiGR (17743 in chips, $2.45 bounty) 
Seat 4: tabu33 (23864 in chips, $2.45 bounty) 
Seat 5: Kevin12345Mc (78174 in chips, $4.89 bounty) 
Seat 6: taluk_00 (26237 in chips, $2.45 bounty) 
Seat 7: MahSandrs (19673 in chips, $2.45 bounty) 
Seat 8: Lunxspy (46656 in chips, $2.45 bounty) 
578346: posts the ante 125
IoannisVaios: posts the ante 125
SaLouTiGR: posts the ante 125
tabu33: posts the ante 125
Kevin12345Mc: posts the ante 125
taluk_00: posts the ante 125
MahSandrs: posts the ante 125
Lunxspy: posts the ante 125
MahSandrs: posts small blind 450
Lunxspy: posts big blind 900
*** HOLE CARDS ***
Dealt to Kevin12345Mc [Ks 2c]
578346: folds 
IoannisVaios: folds 
SaLouTiGR: folds 
tabu33: folds 
Kevin12345Mc: folds 
taluk_00: folds 
MahSandrs is disconnected 
MahSandrs is connected 
MahSandrs: calls 450
Lunxspy: checks 
*** FLOP *** [Ah Jh 7h]
MahSandrs: bets 900
Lunxspy: calls 900
*** TURN *** [Ah Jh 7h] [3s]
MahSandrs: bets 2349
Lunxspy: folds 
Uncalled bet (2349) returned to MahSandrs
MahSandrs collected 4600 from pot
MahSandrs: doesn't show hand 
*** SUMMARY ***
Total pot 4600 | Rake 0 
Board [Ah Jh 7h 3s]
Seat 1: 578346 folded before Flop (didn't bet)
Seat 2: IoannisVaios folded before Flop (didn't bet)
Seat 3: SaLouTiGR folded before Flop (didn't bet)
Seat 4: tabu33 folded before Flop (didn't bet)
Seat 5: Kevin12345Mc folded before Flop (didn't bet)
Seat 6: taluk_00 (button) folded before Flop (didn't bet)
Seat 7: MahSandrs (small blind) collected (4600)
Seat 8: Lunxspy (big blind) folded on the Turn



PokerStars Hand #254989600257: Tournament #3858857107, $2.45+$2.45+$0.60 USD Hold'em No Limit - Level X (450/900) - 2025/02/22 19:03:57 WET [2025/02/22 14:03:57 ET]
Table '3858857107 71' 8-max Seat #7 is the button
Seat 1: 578346 (35379 in chips, $2.45 bounty) 
Seat 2: IoannisVaios (21723 in chips, $2.45 bounty) 
Seat 3: SaLouTiGR (17618 in chips, $2.45 bounty) 
Seat 4: tabu33 (23739 in chips, $2.45 bounty) 
Seat 5: Kevin12345Mc (78049 in chips, $4.89 bounty) 
Seat 6: taluk_00 (26112 in chips, $2.45 bounty) 
Seat 7: MahSandrs (22348 in chips, $2.45 bounty) 
Seat 8: Lunxspy (44731 in chips, $2.45 bounty) 
578346: posts the ante 125
IoannisVaios: posts the ante 125
SaLouTiGR: posts the ante 125
tabu33: posts the ante 125
Kevin12345Mc: posts the ante 125
taluk_00: posts the ante 125
MahSandrs: posts the ante 125
Lunxspy: posts the ante 125
Lunxspy: posts small blind 450
578346: posts big blind 900
*** HOLE CARDS ***
Dealt to Kevin12345Mc [3c 6h]
IoannisVaios: folds 
SaLouTiGR: folds 
tabu33: folds 
Kevin12345Mc: folds 
taluk_00: folds 
MahSandrs: raises 900 to 1800
Lunxspy: calls 1350
578346: calls 900
*** FLOP *** [Qs 2h 3h]
Lunxspy: checks 
578346: checks 
MahSandrs: bets 2115
Lunxspy: calls 2115
578346: folds 
*** TURN *** [Qs 2h 3h] [9h]
Lunxspy: checks 
MahSandrs: bets 5418
Lunxspy: folds 
Uncalled bet (5418) returned to MahSandrs
MahSandrs collected 10630 from pot
*** SUMMARY ***
Total pot 10630 | Rake 0 
Board [Qs 2h 3h 9h]
Seat 1: 578346 (big blind) folded on the Flop
Seat 2: IoannisVaios folded before Flop (didn't bet)
Seat 3: SaLouTiGR folded before Flop (didn't bet)
Seat 4: tabu33 folded before Flop (didn't bet)
Seat 5: Kevin12345Mc folded before Flop (didn't bet)
Seat 6: taluk_00 folded before Flop (didn't bet)
Seat 7: MahSandrs (button) collected (10630)
Seat 8: Lunxspy (small blind) folded on the Turn



PokerStars Hand #254990122866: Tournament #3858857107, $2.45+$2.45+$0.60 USD Hold'em No Limit - Level X (450/900) - 2025/02/22 19:05:15 WET [2025/02/22 14:05:15 ET]
Table '3858857107 71' 8-max Seat #8 is the button
Seat 1: 578346 (33454 in chips, $2.45 bounty) 
Seat 2: IoannisVaios (21598 in chips, $2.45 bounty) 
Seat 3: SaLouTiGR (17493 in chips, $2.45 bounty) 
Seat 4: tabu33 (23614 in chips, $2.45 bounty) 
Seat 5: Kevin12345Mc (77924 in chips, $4.89 bounty) 
Seat 6: taluk_00 (25987 in chips, $2.45 bounty) 
Seat 7: MahSandrs (28938 in chips, $2.45 bounty) 
Seat 8: Lunxspy (40691 in chips, $2.45 bounty) 
578346: posts the ante 125
IoannisVaios: posts the ante 125
SaLouTiGR: posts the ante 125
tabu33: posts the ante 125
Kevin12345Mc: posts the ante 125
taluk_00: posts the ante 125
MahSandrs: posts the ante 125
Lunxspy: posts the ante 125
578346: posts small blind 450
IoannisVaios: posts big blind 900
*** HOLE CARDS ***
Dealt to Kevin12345Mc [Qd 4h]
SaLouTiGR: folds 
tabu33: calls 900
Kevin12345Mc: folds 
taluk_00: folds 
MahSandrs is disconnected 
MahSandrs has timed out while disconnected
MahSandrs: folds 
MahSandrs is sitting out
Lunxspy: folds 
578346: folds 
IoannisVaios: checks 
*** FLOP *** [As 2s Qh]
IoannisVaios: checks 
tabu33: bets 1625
IoannisVaios: folds 
Uncalled bet (1625) returned to tabu33
tabu33 collected 3250 from pot
tabu33: doesn't show hand 
*** SUMMARY ***
Total pot 3250 | Rake 0 
Board [As 2s Qh]
Seat 1: 578346 (small blind) folded before Flop
Seat 2: IoannisVaios (big blind) folded on the Flop
Seat 3: SaLouTiGR folded before Flop (didn't bet)
Seat 4: tabu33 collected (3250)
Seat 5: Kevin12345Mc folded before Flop (didn't bet)
Seat 6: taluk_00 folded before Flop (didn't bet)
Seat 7: MahSandrs folded before Flop (didn't bet)
Seat 8: Lunxspy (button) folded before Flop (didn't bet)



PokerStars Hand #254990137030: Tournament #3858857107, $2.45+$2.45+$0.60 USD Hold'em No Limit - Level X (450/900) - 2025/02/22 19:06:04 WET [2025/02/22 14:06:04 ET]
Table '3858857107 71' 8-max Seat #1 is the button
Seat 1: 578346 (32879 in chips, $2.45 bounty) 
Seat 2: IoannisVaios (20573 in chips, $2.45 bounty) 
Seat 3: SaLouTiGR (17368 in chips, $2.45 bounty) 
Seat 4: tabu33 (25839 in chips, $2.45 bounty) 
Seat 5: Kevin12345Mc (77799 in chips, $4.89 bounty) 
Seat 6: taluk_00 (25862 in chips, $2.45 bounty) 
Seat 7: MahSandrs (28813 in chips, $2.45 bounty) is sitting out
Seat 8: Lunxspy (40566 in chips, $2.45 bounty) 
578346: posts the ante 125
IoannisVaios: posts the ante 125
SaLouTiGR: posts the ante 125
tabu33: posts the ante 125
Kevin12345Mc: posts the ante 125
taluk_00: posts the ante 125
MahSandrs: posts the ante 125
Lunxspy: posts the ante 125
IoannisVaios: posts small blind 450
SaLouTiGR: posts big blind 900
*** HOLE CARDS ***
Dealt to Kevin12345Mc [8h 2h]
MahSandrs has returned
tabu33: folds 
Kevin12345Mc: folds 
taluk_00: folds 
MahSandrs: folds 
Lunxspy: raises 1683 to 2583
578346: calls 2583
IoannisVaios: folds 
SaLouTiGR: folds 
*** FLOP *** [Qd Ts 9h]
Lunxspy: bets 3232
578346: folds 
Uncalled bet (3232) returned to Lunxspy
Lunxspy collected 7516 from pot
*** SUMMARY ***
Total pot 7516 | Rake 0 
Board [Qd Ts 9h]
Seat 1: 578346 (button) folded on the Flop
Seat 2: IoannisVaios (small blind) folded before Flop
Seat 3: SaLouTiGR (big blind) folded before Flop
Seat 4: tabu33 folded before Flop (didn't bet)
Seat 5: Kevin12345Mc folded before Flop (didn't bet)
Seat 6: taluk_00 folded before Flop (didn't bet)
Seat 7: MahSandrs folded before Flop (didn't bet)
Seat 8: Lunxspy collected (7516)



PokerStars Hand #254990148366: Tournament #3858857107, $2.45+$2.45+$0.60 USD Hold'em No Limit - Level XI (500/1000) - 2025/02/22 19:06:43 WET [2025/02/22 14:06:43 ET]
Table '3858857107 71' 8-max Seat #2 is the button
Seat 1: 578346 (30171 in chips, $2.45 bounty) 
Seat 2: IoannisVaios (19998 in chips, $2.45 bounty) 
Seat 3: SaLouTiGR (16343 in chips, $2.45 bounty) 
Seat 4: tabu33 (25714 in chips, $2.45 bounty) 
Seat 5: Kevin12345Mc (77674 in chips, $4.89 bounty) 
Seat 6: taluk_00 (25737 in chips, $2.45 bounty) 
Seat 7: MahSandrs (28688 in chips, $2.45 bounty) 
Seat 8: Lunxspy (45374 in chips, $2.45 bounty) 
578346: posts the ante 150
IoannisVaios: posts the ante 150
SaLouTiGR: posts the ante 150
tabu33: posts the ante 150
Kevin12345Mc: posts the ante 150
taluk_00: posts the ante 150
MahSandrs: posts the ante 150
Lunxspy: posts the ante 150
SaLouTiGR: posts small blind 500
tabu33: posts big blind 1000
*** HOLE CARDS ***
Dealt to Kevin12345Mc [2h 6h]
Kevin12345Mc: folds 
taluk_00: raises 1000 to 2000
MahSandrs: raises 26538 to 28538 and is all-in
Lunxspy: folds 
578346: folds 
IoannisVaios: folds 
SaLouTiGR: folds 
tabu33: folds 
taluk_00: folds 
Uncalled bet (26538) returned to MahSandrs
MahSandrs collected 6700 from pot
MahSandrs: doesn't show hand 
*** SUMMARY ***
Total pot 6700 | Rake 0 
Seat 1: 578346 folded before Flop (didn't bet)
Seat 2: IoannisVaios (button) folded before Flop (didn't bet)
Seat 3: SaLouTiGR (small blind) folded before Flop
Seat 4: tabu33 (big blind) folded before Flop
Seat 5: Kevin12345Mc folded before Flop (didn't bet)
Seat 6: taluk_00 folded before Flop
Seat 7: MahSandrs collected (6700)
Seat 8: Lunxspy folded before Flop (didn't bet)



PokerStars Hand #254990156220: Tournament #3858857107, $2.45+$2.45+$0.60 USD Hold'em No Limit - Level XI (500/1000) - 2025/02/22 19:07:10 WET [2025/02/22 14:07:10 ET]
Table '3858857107 71' 8-max Seat #4 is the button
Seat 1: 578346 (30021 in chips, $2.45 bounty) 
Seat 2: IoannisVaios (19848 in chips, $2.45 bounty) 
Seat 4: tabu33 (24564 in chips, $2.45 bounty) 
Seat 5: Kevin12345Mc (77524 in chips, $4.89 bounty) 
Seat 6: taluk_00 (23587 in chips, $2.45 bounty) 
Seat 7: MahSandrs (33238 in chips, $2.45 bounty) 
Seat 8: Lunxspy (45224 in chips, $2.45 bounty) 
578346: posts the ante 150
IoannisVaios: posts the ante 150
tabu33: posts the ante 150
Kevin12345Mc: posts the ante 150
taluk_00: posts the ante 150
MahSandrs: posts the ante 150
Lunxspy: posts the ante 150
Kevin12345Mc: posts small blind 500
taluk_00: posts big blind 1000
*** HOLE CARDS ***
Dealt to Kevin12345Mc [Qs Td]
MahSandrs: folds 
Lunxspy: raises 1110 to 2110
578346: folds 
IoannisVaios: folds 
tabu33: folds 
Kevin12345Mc: folds 
taluk_00: calls 1110
*** FLOP *** [Ah Qh 4c]
taluk_00: checks 
Lunxspy: bets 2481
taluk_00: folds 
Uncalled bet (2481) returned to Lunxspy
Lunxspy collected 5770 from pot
*** SUMMARY ***
Total pot 5770 | Rake 0 
Board [Ah Qh 4c]
Seat 1: 578346 folded before Flop (didn't bet)
Seat 2: IoannisVaios folded before Flop (didn't bet)
Seat 4: tabu33 (button) folded before Flop (didn't bet)
Seat 5: Kevin12345Mc (small blind) folded before Flop
Seat 6: taluk_00 (big blind) folded on the Flop
Seat 7: MahSandrs folded before Flop (didn't bet)
Seat 8: Lunxspy collected (5770)



PokerStars Hand #254990168591: Tournament #3858857107, $2.45+$2.45+$0.60 USD Hold'em No Limit - Level XI (500/1000) - 2025/02/22 19:07:53 WET [2025/02/22 14:07:53 ET]
Table '3858857107 71' 8-max Seat #5 is the button
Seat 1: 578346 (29871 in chips, $2.45 bounty) 
Seat 2: IoannisVaios (19698 in chips, $2.45 bounty) 
Seat 3: decus1 (38275 in chips, $3.67 bounty) 
Seat 4: tabu33 (24414 in chips, $2.45 bounty) 
Seat 5: Kevin12345Mc (76874 in chips, $4.89 bounty) 
Seat 6: taluk_00 (21327 in chips, $2.45 bounty) 
Seat 7: MahSandrs (33088 in chips, $2.45 bounty) 
Seat 8: Lunxspy (48734 in chips, $2.45 bounty) 
578346: posts the ante 150
IoannisVaios: posts the ante 150
decus1: posts the ante 150
tabu33: posts the ante 150
Kevin12345Mc: posts the ante 150
taluk_00: posts the ante 150
MahSandrs: posts the ante 150
Lunxspy: posts the ante 150
taluk_00: posts small blind 500
MahSandrs: posts big blind 1000
*** HOLE CARDS ***
Dealt to Kevin12345Mc [6s 7c]
Lunxspy: raises 1110 to 2110
578346: folds 
IoannisVaios: folds 
decus1: folds 
tabu33: folds 
Kevin12345Mc: folds 
taluk_00: raises 19067 to 21177 and is all-in
MahSandrs: folds 
Lunxspy: folds 
Uncalled bet (19067) returned to taluk_00
Lunxspy is sitting out
taluk_00 collected 6420 from pot
taluk_00: doesn't show hand 
Lunxspy has returned
*** SUMMARY ***
Total pot 6420 | Rake 0 
Seat 1: 578346 folded before Flop (didn't bet)
Seat 2: IoannisVaios folded before Flop (didn't bet)
Seat 3: decus1 folded before Flop (didn't bet)
Seat 4: tabu33 folded before Flop (didn't bet)
Seat 5: Kevin12345Mc (button) folded before Flop (didn't bet)
Seat 6: taluk_00 (small blind) collected (6420)
Seat 7: MahSandrs (big blind) folded before Flop
Seat 8: Lunxspy folded before Flop



PokerStars Hand #254990178500: Tournament #3858857107, $2.45+$2.45+$0.60 USD Hold'em No Limit - Level XI (500/1000) - 2025/02/22 19:08:28 WET [2025/02/22 14:08:28 ET]
Table '3858857107 71' 8-max Seat #6 is the button
Seat 1: 578346 (29721 in chips, $2.45 bounty) 
Seat 2: IoannisVaios (19548 in chips, $2.45 bounty) 
Seat 3: decus1 (38125 in chips, $3.67 bounty) 
Seat 4: tabu33 (24264 in chips, $2.45 bounty) 
Seat 5: Kevin12345Mc (76724 in chips, $4.89 bounty) 
Seat 6: taluk_00 (25487 in chips, $2.45 bounty) 
Seat 7: MahSandrs (31938 in chips, $2.45 bounty) 
Seat 8: Lunxspy (46474 in chips, $2.45 bounty) 
578346: posts the ante 150
IoannisVaios: posts the ante 150
decus1: posts the ante 150
tabu33: posts the ante 150
Kevin12345Mc: posts the ante 150
taluk_00: posts the ante 150
MahSandrs: posts the ante 150
Lunxspy: posts the ante 150
MahSandrs: posts small blind 500
Lunxspy: posts big blind 1000
*** HOLE CARDS ***
Dealt to Kevin12345Mc [4d Ad]
578346: folds 
IoannisVaios: raises 18398 to 19398 and is all-in
decus1: folds 
tabu33: folds 
Kevin12345Mc: folds 
taluk_00: folds 
MahSandrs: folds 
Lunxspy: folds 
Lunxspy is sitting out
Uncalled bet (18398) returned to IoannisVaios
Lunxspy has returned
IoannisVaios collected 3700 from pot
IoannisVaios: doesn't show hand 
*** SUMMARY ***
Total pot 3700 | Rake 0 
Seat 1: 578346 folded before Flop (didn't bet)
Seat 2: IoannisVaios collected (3700)
Seat 3: decus1 folded before Flop (didn't bet)
Seat 4: tabu33 folded before Flop (didn't bet)
Seat 5: Kevin12345Mc folded before Flop (didn't bet)
Seat 6: taluk_00 (button) folded before Flop (didn't bet)
Seat 7: MahSandrs (small blind) folded before Flop
Seat 8: Lunxspy (big blind) folded before Flop



PokerStars Hand #254990185158: Tournament #3858857107, $2.45+$2.45+$0.60 USD Hold'em No Limit - Level XI (500/1000) - 2025/02/22 19:08:51 WET [2025/02/22 14:08:51 ET]
Table '3858857107 71' 8-max Seat #7 is the button
Seat 1: 578346 (29571 in chips, $2.45 bounty) 
Seat 2: IoannisVaios (22098 in chips, $2.45 bounty) 
Seat 3: decus1 (37975 in chips, $3.67 bounty) 
Seat 4: tabu33 (24114 in chips, $2.45 bounty) 
Seat 5: Kevin12345Mc (76574 in chips, $4.89 bounty) 
Seat 6: taluk_00 (25337 in chips, $2.45 bounty) 
Seat 7: MahSandrs (31288 in chips, $2.45 bounty) 
Seat 8: Lunxspy (45324 in chips, $2.45 bounty) 
578346: posts the ante 150
IoannisVaios: posts the ante 150
decus1: posts the ante 150
tabu33: posts the ante 150
Kevin12345Mc: posts the ante 150
taluk_00: posts the ante 150
MahSandrs: posts the ante 150
Lunxspy: posts the ante 150
Lunxspy: posts small blind 500
578346: posts big blind 1000
*** HOLE CARDS ***
Dealt to Kevin12345Mc [Qs Jd]
IoannisVaios: folds 
decus1: folds 
tabu33: folds 
Kevin12345Mc: raises 1300 to 2300
taluk_00: folds 
MahSandrs: folds 
Lunxspy: folds 
578346: calls 1300
*** FLOP *** [4h Qh 4c]
578346: checks 
Kevin12345Mc: bets 2079
578346: folds 
Uncalled bet (2079) returned to Kevin12345Mc
Kevin12345Mc collected 6300 from pot
Kevin12345Mc: doesn't show hand 
*** SUMMARY ***
Total pot 6300 | Rake 0 
Board [4h Qh 4c]
Seat 1: 578346 (big blind) folded on the Flop
Seat 2: IoannisVaios folded before Flop (didn't bet)
Seat 3: decus1 folded before Flop (didn't bet)
Seat 4: tabu33 folded before Flop (didn't bet)
Seat 5: Kevin12345Mc collected (6300)
Seat 6: taluk_00 folded before Flop (didn't bet)
Seat 7: MahSandrs (button) folded before Flop (didn't bet)
Seat 8: Lunxspy (small blind) folded before Flop



PokerStars Hand #254990198025: Tournament #3858857107, $2.45+$2.45+$0.60 USD Hold'em No Limit - Level XI (500/1000) - 2025/02/22 19:09:36 WET [2025/02/22 14:09:36 ET]
Table '3858857107 71' 8-max Seat #8 is the button
Seat 1: 578346 (27121 in chips, $2.45 bounty) 
Seat 2: IoannisVaios (21948 in chips, $2.45 bounty) 
Seat 3: decus1 (37825 in chips, $3.67 bounty) 
Seat 4: tabu33 (23964 in chips, $2.45 bounty) 
Seat 5: Kevin12345Mc (80424 in chips, $4.89 bounty) 
Seat 6: taluk_00 (25187 in chips, $2.45 bounty) 
Seat 7: MahSandrs (31138 in chips, $2.45 bounty) 
Seat 8: Lunxspy (44674 in chips, $2.45 bounty) 
578346: posts the ante 150
IoannisVaios: posts the ante 150
decus1: posts the ante 150
tabu33: posts the ante 150
Kevin12345Mc: posts the ante 150
taluk_00: posts the ante 150
MahSandrs: posts the ante 150
Lunxspy: posts the ante 150
578346: posts small blind 500
IoannisVaios: posts big blind 1000
*** HOLE CARDS ***
Dealt to Kevin12345Mc [3h Ks]
decus1: raises 2000 to 3000
tabu33: folds 
Kevin12345Mc: folds 
taluk_00: folds 
MahSandrs: folds 
Lunxspy: folds 
578346: folds 
IoannisVaios: folds 
Uncalled bet (2000) returned to decus1
decus1 collected 3700 from pot
*** SUMMARY ***
Total pot 3700 | Rake 0 
Seat 1: 578346 (small blind) folded before Flop
Seat 2: IoannisVaios (big blind) folded before Flop
Seat 3: decus1 collected (3700)
Seat 4: tabu33 folded before Flop (didn't bet)
Seat 5: Kevin12345Mc folded before Flop (didn't bet)
Seat 6: taluk_00 folded before Flop (didn't bet)
Seat 7: MahSandrs folded before Flop (didn't bet)
Seat 8: Lunxspy (button) folded before Flop (didn't bet)



PokerStars Hand #254990205717: Tournament #3858857107, $2.45+$2.45+$0.60 USD Hold'em No Limit - Level XI (500/1000) - 2025/02/22 19:10:03 WET [2025/02/22 14:10:03 ET]
Table '3858857107 71' 8-max Seat #1 is the button
Seat 1: 578346 (26471 in chips, $2.45 bounty) 
Seat 2: IoannisVaios (20798 in chips, $2.45 bounty) 
Seat 3: decus1 (40375 in chips, $3.67 bounty) 
Seat 4: tabu33 (23814 in chips, $2.45 bounty) 
Seat 5: Kevin12345Mc (80274 in chips, $4.89 bounty) 
Seat 6: taluk_00 (25037 in chips, $2.45 bounty) 
Seat 7: MahSandrs (30988 in chips, $2.45 bounty) 
Seat 8: Lunxspy (44524 in chips, $2.45 bounty) 
578346: posts the ante 150
IoannisVaios: posts the ante 150
decus1: posts the ante 150
tabu33: posts the ante 150
Kevin12345Mc: posts the ante 150
taluk_00: posts the ante 150
MahSandrs: posts the ante 150
Lunxspy: posts the ante 150
IoannisVaios: posts small blind 500
decus1: posts big blind 1000
*** HOLE CARDS ***
Dealt to Kevin12345Mc [4s 2d]
tabu33: folds 
Kevin12345Mc: folds 
taluk_00: folds 
MahSandrs: folds 
Lunxspy: folds 
578346: folds 
IoannisVaios: raises 19648 to 20648 and is all-in
decus1: folds 
Uncalled bet (19648) returned to IoannisVaios
IoannisVaios collected 3200 from pot
IoannisVaios: doesn't show hand 
*** SUMMARY ***
Total pot 3200 | Rake 0 
Seat 1: 578346 (button) folded before Flop (didn't bet)
Seat 2: IoannisVaios (small blind) collected (3200)
Seat 3: decus1 (big blind) folded before Flop
Seat 4: tabu33 folded before Flop (didn't bet)
Seat 5: Kevin12345Mc folded before Flop (didn't bet)
Seat 6: taluk_00 folded before Flop (didn't bet)
Seat 7: MahSandrs folded before Flop (didn't bet)
Seat 8: Lunxspy folded before Flop (didn't bet)



PokerStars Hand #254990217002: Tournament #3858857107, $2.45+$2.45+$0.60 USD Hold'em No Limit - Level XI (500/1000) - 2025/02/22 19:10:42 WET [2025/02/22 14:10:42 ET]
Table '3858857107 71' 8-max Seat #2 is the button
Seat 1: 578346 (26321 in chips, $2.45 bounty) 
Seat 2: IoannisVaios (22848 in chips, $2.45 bounty) 
Seat 3: decus1 (39225 in chips, $3.67 bounty) 
Seat 4: tabu33 (23664 in chips, $2.45 bounty) 
Seat 5: Kevin12345Mc (80124 in chips, $4.89 bounty) 
Seat 6: taluk_00 (24887 in chips, $2.45 bounty) 
Seat 7: MahSandrs (30838 in chips, $2.45 bounty) 
Seat 8: Lunxspy (44374 in chips, $2.45 bounty) 
578346: posts the ante 150
IoannisVaios: posts the ante 150
decus1: posts the ante 150
tabu33: posts the ante 150
Kevin12345Mc: posts the ante 150
taluk_00: posts the ante 150
MahSandrs: posts the ante 150
Lunxspy: posts the ante 150
decus1: posts small blind 500
tabu33: posts big blind 1000
*** HOLE CARDS ***
Dealt to Kevin12345Mc [Td 2s]
Kevin12345Mc: folds 
taluk_00: folds 
MahSandrs: folds 
Lunxspy: raises 1870 to 2870
578346: calls 2870
IoannisVaios: folds 
decus1: raises 36205 to 39075 and is all-in
tabu33: folds 
Lunxspy: folds 
578346: folds 
Uncalled bet (36205) returned to decus1
decus1 collected 10810 from pot
*** SUMMARY ***
Total pot 10810 | Rake 0 
Seat 1: 578346 folded before Flop
Seat 2: IoannisVaios (button) folded before Flop (didn't bet)
Seat 3: decus1 (small blind) collected (10810)
Seat 4: tabu33 (big blind) folded before Flop
Seat 5: Kevin12345Mc folded before Flop (didn't bet)
Seat 6: taluk_00 folded before Flop (didn't bet)
Seat 7: MahSandrs folded before Flop (didn't bet)
Seat 8: Lunxspy folded before Flop



PokerStars Hand #254990230574: Tournament #3858857107, $2.45+$2.45+$0.60 USD Hold'em No Limit - Level XI (500/1000) - 2025/02/22 19:11:29 WET [2025/02/22 14:11:29 ET]
Table '3858857107 71' 8-max Seat #3 is the button
Seat 1: 578346 (23301 in chips, $2.45 bounty) 
Seat 2: IoannisVaios (22698 in chips, $2.45 bounty) 
Seat 3: decus1 (47015 in chips, $3.67 bounty) 
Seat 4: tabu33 (22514 in chips, $2.45 bounty) 
Seat 5: Kevin12345Mc (79974 in chips, $4.89 bounty) 
Seat 6: taluk_00 (24737 in chips, $2.45 bounty) 
Seat 7: MahSandrs (30688 in chips, $2.45 bounty) 
Seat 8: Lunxspy (41354 in chips, $2.45 bounty) 
578346: posts the ante 150
IoannisVaios: posts the ante 150
decus1: posts the ante 150
tabu33: posts the ante 150
Kevin12345Mc: posts the ante 150
taluk_00: posts the ante 150
MahSandrs: posts the ante 150
Lunxspy: posts the ante 150
tabu33: posts small blind 500
Kevin12345Mc: posts big blind 1000
*** HOLE CARDS ***
Dealt to Kevin12345Mc [5s Qs]
taluk_00: folds 
MahSandrs: folds 
Lunxspy: raises 1110 to 2110
578346: folds 
IoannisVaios: folds 
decus1: folds 
tabu33: folds 
Kevin12345Mc: calls 1110
*** FLOP *** [Jd As 8s]
Kevin12345Mc: checks 
Lunxspy: bets 4558
Kevin12345Mc: calls 4558
*** TURN *** [Jd As 8s] [Tc]
Kevin12345Mc: checks 
Lunxspy: bets 8000
Kevin12345Mc: calls 8000
*** RIVER *** [Jd As 8s Tc] [Kc]
Kevin12345Mc: checks 
Lunxspy: checks 
*** SHOW DOWN ***
Kevin12345Mc: shows [5s Qs] (a straight, Ten to Ace)
Lunxspy: mucks hand 
Kevin12345Mc collected 31036 from pot
*** SUMMARY ***
Total pot 31036 | Rake 0 
Board [Jd As 8s Tc Kc]
Seat 1: 578346 folded before Flop (didn't bet)
Seat 2: IoannisVaios folded before Flop (didn't bet)
Seat 3: decus1 (button) folded before Flop (didn't bet)
Seat 4: tabu33 (small blind) folded before Flop
Seat 5: Kevin12345Mc (big blind) showed [5s Qs] and won (31036) with a straight, Ten to Ace
Seat 6: taluk_00 folded before Flop (didn't bet)
Seat 7: MahSandrs folded before Flop (didn't bet)
Seat 8: Lunxspy mucked [4d 9d]



PokerStars Hand #254990250152: Tournament #3858857107, $2.45+$2.45+$0.60 USD Hold'em No Limit - Level XI (500/1000) - 2025/02/22 19:12:37 WET [2025/02/22 14:12:37 ET]
Table '3858857107 71' 8-max Seat #4 is the button
Seat 1: 578346 (23151 in chips, $2.45 bounty) 
Seat 2: IoannisVaios (22548 in chips, $2.45 bounty) 
Seat 3: decus1 (46865 in chips, $3.67 bounty) 
Seat 4: tabu33 (21864 in chips, $2.45 bounty) 
Seat 5: Kevin12345Mc (96192 in chips, $4.89 bounty) 
Seat 6: taluk_00 (24587 in chips, $2.45 bounty) 
Seat 7: MahSandrs (30538 in chips, $2.45 bounty) 
Seat 8: Lunxspy (26536 in chips, $2.45 bounty) 
578346: posts the ante 150
IoannisVaios: posts the ante 150
decus1: posts the ante 150
tabu33: posts the ante 150
Kevin12345Mc: posts the ante 150
taluk_00: posts the ante 150
MahSandrs: posts the ante 150
Lunxspy: posts the ante 150
Kevin12345Mc: posts small blind 500
taluk_00: posts big blind 1000
*** HOLE CARDS ***
Dealt to Kevin12345Mc [4s As]
MahSandrs: folds 
Lunxspy: folds 
578346: folds 
IoannisVaios: folds 
decus1: folds 
tabu33: raises 1000 to 2000
Kevin12345Mc: calls 1500
taluk_00: folds 
*** FLOP *** [Jc 9s 3h]
Kevin12345Mc: checks 
tabu33: checks 
*** TURN *** [Jc 9s 3h] [Jh]
Kevin12345Mc: checks 
tabu33: checks 
*** RIVER *** [Jc 9s 3h Jh] [9c]
Kevin12345Mc: checks 
tabu33: checks 
*** SHOW DOWN ***
Kevin12345Mc: shows [4s As] (two pair, Jacks and Nines)
tabu33: shows [Ah 6h] (two pair, Jacks and Nines)
Kevin12345Mc collected 3100 from pot
tabu33 collected 3100 from pot
*** SUMMARY ***
Total pot 6200 | Rake 0 
Board [Jc 9s 3h Jh 9c]
Seat 1: 578346 folded before Flop (didn't bet)
Seat 2: IoannisVaios folded before Flop (didn't bet)
Seat 3: decus1 folded before Flop (didn't bet)
Seat 4: tabu33 (button) showed [Ah 6h] and won (3100) with two pair, Jacks and Nines
Seat 5: Kevin12345Mc (small blind) showed [4s As] and won (3100) with two pair, Jacks and Nines
Seat 6: taluk_00 (big blind) folded before Flop
Seat 7: MahSandrs folded before Flop (didn't bet)
Seat 8: Lunxspy folded before Flop (didn't bet)



PokerStars Hand #254990267081: Tournament #3858857107, $2.45+$2.45+$0.60 USD Hold'em No Limit - Level XI (500/1000) - 2025/02/22 19:13:36 WET [2025/02/22 14:13:36 ET]
Table '3858857107 71' 8-max Seat #5 is the button
Seat 1: 578346 (23001 in chips, $2.45 bounty) 
Seat 2: IoannisVaios (22398 in chips, $2.45 bounty) 
Seat 3: decus1 (46715 in chips, $3.67 bounty) 
Seat 4: tabu33 (22814 in chips, $2.45 bounty) 
Seat 5: Kevin12345Mc (97142 in chips, $4.89 bounty) 
Seat 6: taluk_00 (23437 in chips, $2.45 bounty) 
Seat 7: MahSandrs (30388 in chips, $2.45 bounty) 
Seat 8: Lunxspy (26386 in chips, $2.45 bounty) 
578346: posts the ante 150
IoannisVaios: posts the ante 150
decus1: posts the ante 150
tabu33: posts the ante 150
Kevin12345Mc: posts the ante 150
taluk_00: posts the ante 150
MahSandrs: posts the ante 150
Lunxspy: posts the ante 150
taluk_00: posts small blind 500
MahSandrs: posts big blind 1000
*** HOLE CARDS ***
Dealt to Kevin12345Mc [2s 8c]
Lunxspy: folds 
578346: raises 1000 to 2000
IoannisVaios: folds 
decus1: folds 
tabu33: folds 
Kevin12345Mc: folds 
decus1 is disconnected 
taluk_00: folds 
MahSandrs: calls 1000
*** FLOP *** [7d Jc Jd]
decus1 is disconnected 
MahSandrs: checks 
578346: checks 
*** TURN *** [7d Jc Jd] [8s]
MahSandrs: checks 
578346: checks 
*** RIVER *** [7d Jc Jd 8s] [Ks]
MahSandrs: checks 
578346: bets 2000
MahSandrs: raises 3200 to 5200
578346: calls 3200
*** SHOW DOWN ***
MahSandrs: shows [As 7s] (two pair, Jacks and Sevens)
578346: shows [Ah Kd] (two pair, Kings and Jacks)
578346 collected 16100 from pot
*** SUMMARY ***
Total pot 16100 | Rake 0 
Board [7d Jc Jd 8s Ks]
Seat 1: 578346 showed [Ah Kd] and won (16100) with two pair, Kings and Jacks
Seat 2: IoannisVaios folded before Flop (didn't bet)
Seat 3: decus1 folded before Flop (didn't bet)
Seat 4: tabu33 folded before Flop (didn't bet)
Seat 5: Kevin12345Mc (button) folded before Flop (didn't bet)
Seat 6: taluk_00 (small blind) folded before Flop
Seat 7: MahSandrs (big blind) showed [As 7s] and lost with two pair, Jacks and Sevens
Seat 8: Lunxspy folded before Flop (didn't bet)



PokerStars Hand #254990297254: Tournament #3858857107, $2.45+$2.45+$0.60 USD Hold'em No Limit - Level XII (600/1200) - 2025/02/22 19:15:21 WET [2025/02/22 14:15:21 ET]
Table '3858857107 71' 8-max Seat #6 is the button
Seat 1: 578346 (31751 in chips, $2.45 bounty) 
Seat 2: IoannisVaios (22248 in chips, $2.45 bounty) 
Seat 3: decus1 (46565 in chips, $3.67 bounty) 
Seat 4: tabu33 (22664 in chips, $2.45 bounty) 
Seat 5: Kevin12345Mc (96992 in chips, $4.89 bounty) 
Seat 6: taluk_00 (22787 in chips, $2.45 bounty) 
Seat 7: MahSandrs (23038 in chips, $2.45 bounty) 
Seat 8: Lunxspy (26236 in chips, $2.45 bounty) 
578346: posts the ante 175
IoannisVaios: posts the ante 175
decus1: posts the ante 175
tabu33: posts the ante 175
Kevin12345Mc: posts the ante 175
taluk_00: posts the ante 175
MahSandrs: posts the ante 175
Lunxspy: posts the ante 175
MahSandrs: posts small blind 600
Lunxspy: posts big blind 1200
*** HOLE CARDS ***
Dealt to Kevin12345Mc [4h Qc]
578346: folds 
IoannisVaios: folds 
decus1: calls 1200
tabu33: folds 
Kevin12345Mc: folds 
taluk_00: folds 
MahSandrs: folds 
Lunxspy: checks 
*** FLOP *** [3d Kd 5h]
Lunxspy: checks 
decus1: checks 
*** TURN *** [3d Kd 5h] [6d]
Lunxspy: bets 2400
decus1: calls 2400
*** RIVER *** [3d Kd 5h 6d] [5s]
Lunxspy: bets 10800
decus1: folds 
Uncalled bet (10800) returned to Lunxspy
Lunxspy collected 9200 from pot
*** SUMMARY ***
Total pot 9200 | Rake 0 
Board [3d Kd 5h 6d 5s]
Seat 1: 578346 folded before Flop (didn't bet)
Seat 2: IoannisVaios folded before Flop (didn't bet)
Seat 3: decus1 folded on the River
Seat 4: tabu33 folded before Flop (didn't bet)
Seat 5: Kevin12345Mc folded before Flop (didn't bet)
Seat 6: taluk_00 (button) folded before Flop (didn't bet)
Seat 7: MahSandrs (small blind) folded before Flop
Seat 8: Lunxspy (big blind) collected (9200)



PokerStars Hand #254990312535: Tournament #3858857107, $2.45+$2.45+$0.60 USD Hold'em No Limit - Level XII (600/1200) - 2025/02/22 19:16:14 WET [2025/02/22 14:16:14 ET]
Table '3858857107 71' 8-max Seat #7 is the button
Seat 1: 578346 (31576 in chips, $2.45 bounty) 
Seat 2: IoannisVaios (22073 in chips, $2.45 bounty) 
Seat 3: decus1 (42790 in chips, $3.67 bounty) 
Seat 4: tabu33 (22489 in chips, $2.45 bounty) 
Seat 5: Kevin12345Mc (96817 in chips, $4.89 bounty) 
Seat 6: taluk_00 (22612 in chips, $2.45 bounty) 
Seat 7: MahSandrs (22263 in chips, $2.45 bounty) 
Seat 8: Lunxspy (31661 in chips, $2.45 bounty) 
578346: posts the ante 175
IoannisVaios: posts the ante 175
decus1: posts the ante 175
tabu33: posts the ante 175
Kevin12345Mc: posts the ante 175
taluk_00: posts the ante 175
MahSandrs: posts the ante 175
Lunxspy: posts the ante 175
Lunxspy: posts small blind 600
578346: posts big blind 1200
*** HOLE CARDS ***
Dealt to Kevin12345Mc [8h Ts]
IoannisVaios: folds 
decus1: folds 
tabu33: folds 
Kevin12345Mc: folds 
taluk_00: raises 21237 to 22437 and is all-in
MahSandrs: folds 
Lunxspy: folds 
578346: folds 
Uncalled bet (21237) returned to taluk_00
taluk_00 collected 4400 from pot
taluk_00: doesn't show hand 
*** SUMMARY ***
Total pot 4400 | Rake 0 
Seat 1: 578346 (big blind) folded before Flop
Seat 2: IoannisVaios folded before Flop (didn't bet)
Seat 3: decus1 folded before Flop (didn't bet)
Seat 4: tabu33 folded before Flop (didn't bet)
Seat 5: Kevin12345Mc folded before Flop (didn't bet)
Seat 6: taluk_00 collected (4400)
Seat 7: MahSandrs (button) folded before Flop (didn't bet)
Seat 8: Lunxspy (small blind) folded before Flop



PokerStars Hand #254990322231: Tournament #3858857107, $2.45+$2.45+$0.60 USD Hold'em No Limit - Level XII (600/1200) - 2025/02/22 19:16:48 WET [2025/02/22 14:16:48 ET]
Table '3858857107 71' 8-max Seat #8 is the button
Seat 1: 578346 (30201 in chips, $2.45 bounty) 
Seat 2: IoannisVaios (21898 in chips, $2.45 bounty) 
Seat 3: decus1 (42615 in chips, $3.67 bounty) 
Seat 4: tabu33 (22314 in chips, $2.45 bounty) 
Seat 5: Kevin12345Mc (96642 in chips, $4.89 bounty) 
Seat 6: taluk_00 (25637 in chips, $2.45 bounty) 
Seat 7: MahSandrs (22088 in chips, $2.45 bounty) 
Seat 8: Lunxspy (30886 in chips, $2.45 bounty) 
578346: posts the ante 175
IoannisVaios: posts the ante 175
decus1: posts the ante 175
tabu33: posts the ante 175
Kevin12345Mc: posts the ante 175
taluk_00: posts the ante 175
MahSandrs: posts the ante 175
Lunxspy: posts the ante 175
578346: posts small blind 600
IoannisVaios: posts big blind 1200
*** HOLE CARDS ***
Dealt to Kevin12345Mc [9s Ks]
decus1: folds 
tabu33: raises 2400 to 3600
Kevin12345Mc: folds 
taluk_00: folds 
MahSandrs: folds 
Lunxspy: folds 
578346: folds 
IoannisVaios: folds 
Uncalled bet (2400) returned to tabu33
tabu33 collected 4400 from pot
tabu33: doesn't show hand 
*** SUMMARY ***
Total pot 4400 | Rake 0 
Seat 1: 578346 (small blind) folded before Flop
Seat 2: IoannisVaios (big blind) folded before Flop
Seat 3: decus1 folded before Flop (didn't bet)
Seat 4: tabu33 collected (4400)
Seat 5: Kevin12345Mc folded before Flop (didn't bet)
Seat 6: taluk_00 folded before Flop (didn't bet)
Seat 7: MahSandrs folded before Flop (didn't bet)
Seat 8: Lunxspy (button) folded before Flop (didn't bet)



PokerStars Hand #254990333203: Tournament #3858857107, $2.45+$2.45+$0.60 USD Hold'em No Limit - Level XII (600/1200) - 2025/02/22 19:17:26 WET [2025/02/22 14:17:26 ET]
Table '3858857107 71' 8-max Seat #1 is the button
Seat 1: 578346 (29426 in chips, $2.45 bounty) 
Seat 2: IoannisVaios (20523 in chips, $2.45 bounty) 
Seat 3: decus1 (42440 in chips, $3.67 bounty) 
Seat 4: tabu33 (25339 in chips, $2.45 bounty) 
Seat 5: Kevin12345Mc (96467 in chips, $4.89 bounty) 
Seat 6: taluk_00 (25462 in chips, $2.45 bounty) 
Seat 7: MahSandrs (21913 in chips, $2.45 bounty) 
Seat 8: Lunxspy (30711 in chips, $2.45 bounty) 
578346: posts the ante 175
IoannisVaios: posts the ante 175
decus1: posts the ante 175
tabu33: posts the ante 175
Kevin12345Mc: posts the ante 175
taluk_00: posts the ante 175
MahSandrs: posts the ante 175
Lunxspy: posts the ante 175
IoannisVaios: posts small blind 600
decus1: posts big blind 1200
*** HOLE CARDS ***
Dealt to Kevin12345Mc [6c 8d]
tabu33: folds 
Kevin12345Mc: folds 
taluk_00: folds 
MahSandrs: folds 
Lunxspy: raises 2244 to 3444
578346: folds 
IoannisVaios: folds 
decus1: folds 
Uncalled bet (2244) returned to Lunxspy
Lunxspy collected 4400 from pot
*** SUMMARY ***
Total pot 4400 | Rake 0 
Seat 1: 578346 (button) folded before Flop (didn't bet)
Seat 2: IoannisVaios (small blind) folded before Flop
Seat 3: decus1 (big blind) folded before Flop
Seat 4: tabu33 folded before Flop (didn't bet)
Seat 5: Kevin12345Mc folded before Flop (didn't bet)
Seat 6: taluk_00 folded before Flop (didn't bet)
Seat 7: MahSandrs folded before Flop (didn't bet)
Seat 8: Lunxspy collected (4400)



PokerStars Hand #254990340217: Tournament #3858857107, $2.45+$2.45+$0.60 USD Hold'em No Limit - Level XII (600/1200) - 2025/02/22 19:17:50 WET [2025/02/22 14:17:50 ET]
Table '3858857107 71' 8-max Seat #2 is the button
Seat 1: 578346 (29251 in chips, $2.45 bounty) 
Seat 2: IoannisVaios (19748 in chips, $2.45 bounty) 
Seat 3: decus1 (41065 in chips, $3.67 bounty) 
Seat 4: tabu33 (25164 in chips, $2.45 bounty) 
Seat 5: Kevin12345Mc (96292 in chips, $4.89 bounty) 
Seat 6: taluk_00 (25287 in chips, $2.45 bounty) 
Seat 7: MahSandrs (21738 in chips, $2.45 bounty) 
Seat 8: Lunxspy (33736 in chips, $2.45 bounty) 
578346: posts the ante 175
IoannisVaios: posts the ante 175
decus1: posts the ante 175
tabu33: posts the ante 175
Kevin12345Mc: posts the ante 175
taluk_00: posts the ante 175
MahSandrs: posts the ante 175
Lunxspy: posts the ante 175
decus1: posts small blind 600
tabu33: posts big blind 1200
*** HOLE CARDS ***
Dealt to Kevin12345Mc [2h Jh]
Kevin12345Mc: folds 
taluk_00: folds 
MahSandrs: folds 
Lunxspy: folds 
578346: folds 
IoannisVaios: raises 18373 to 19573 and is all-in
decus1: folds 
tabu33: folds 
Uncalled bet (18373) returned to IoannisVaios
IoannisVaios collected 4400 from pot
IoannisVaios: doesn't show hand 
*** SUMMARY ***
Total pot 4400 | Rake 0 
Seat 1: 578346 folded before Flop (didn't bet)
Seat 2: IoannisVaios (button) collected (4400)
Seat 3: decus1 (small blind) folded before Flop
Seat 4: tabu33 (big blind) folded before Flop
Seat 5: Kevin12345Mc folded before Flop (didn't bet)
Seat 6: taluk_00 folded before Flop (didn't bet)
Seat 7: MahSandrs folded before Flop (didn't bet)
Seat 8: Lunxspy folded before Flop (didn't bet)



PokerStars Hand #254990355857: Tournament #3858857107, $2.45+$2.45+$0.60 USD Hold'em No Limit - Level XII (600/1200) - 2025/02/22 19:18:45 WET [2025/02/22 14:18:45 ET]
Table '3858857107 71' 8-max Seat #3 is the button
Seat 1: 578346 (29076 in chips, $2.45 bounty) 
Seat 2: IoannisVaios (22773 in chips, $2.45 bounty) 
Seat 3: decus1 (40290 in chips, $3.67 bounty) 
Seat 4: tabu33 (23789 in chips, $2.45 bounty) 
Seat 5: Kevin12345Mc (96117 in chips, $4.89 bounty) 
Seat 6: taluk_00 (25112 in chips, $2.45 bounty) 
Seat 7: MahSandrs (21563 in chips, $2.45 bounty) 
Seat 8: Lunxspy (33561 in chips, $2.45 bounty) 
578346: posts the ante 175
IoannisVaios: posts the ante 175
decus1: posts the ante 175
tabu33: posts the ante 175
Kevin12345Mc: posts the ante 175
taluk_00: posts the ante 175
MahSandrs: posts the ante 175
Lunxspy: posts the ante 175
tabu33: posts small blind 600
Kevin12345Mc: posts big blind 1200
*** HOLE CARDS ***
Dealt to Kevin12345Mc [8h Kh]
taluk_00: raises 1200 to 2400
MahSandrs: calls 2400
Lunxspy: folds 
578346: folds 
IoannisVaios: folds 
decus1: calls 2400
tabu33: folds 
Kevin12345Mc: calls 1200
*** FLOP *** [Th 4d 2c]
Kevin12345Mc: checks 
taluk_00: checks 
MahSandrs: checks 
decus1: bets 5800
Kevin12345Mc: folds 
taluk_00: folds 
MahSandrs: raises 13188 to 18988 and is all-in
decus1: calls 13188
*** TURN *** [Th 4d 2c] [3h]
*** RIVER *** [Th 4d 2c 3h] [Jh]
*** SHOW DOWN ***
MahSandrs: shows [Ad Td] (a pair of Tens)
decus1: shows [Ks Tc] (a pair of Tens - lower kicker)
MahSandrs collected 49576 from pot
*** SUMMARY ***
Total pot 49576 | Rake 0 
Board [Th 4d 2c 3h Jh]
Seat 1: 578346 folded before Flop (didn't bet)
Seat 2: IoannisVaios folded before Flop (didn't bet)
Seat 3: decus1 (button) showed [Ks Tc] and lost with a pair of Tens
Seat 4: tabu33 (small blind) folded before Flop
Seat 5: Kevin12345Mc (big blind) folded on the Flop
Seat 6: taluk_00 folded on the Flop
Seat 7: MahSandrs showed [Ad Td] and won (49576) with a pair of Tens
Seat 8: Lunxspy folded before Flop (didn't bet)



PokerStars Hand #254990375047: Tournament #3858857107, $2.45+$2.45+$0.60 USD Hold'em No Limit - Level XII (600/1200) - 2025/02/22 19:19:51 WET [2025/02/22 14:19:51 ET]
Table '3858857107 71' 8-max Seat #4 is the button
Seat 1: 578346 (28901 in chips, $2.45 bounty) 
Seat 2: IoannisVaios (22598 in chips, $2.45 bounty) 
Seat 3: decus1 (18727 in chips, $3.67 bounty) 
Seat 4: tabu33 (23014 in chips, $2.45 bounty) 
Seat 5: Kevin12345Mc (93542 in chips, $4.89 bounty) 
Seat 6: taluk_00 (22537 in chips, $2.45 bounty) 
Seat 7: MahSandrs (49576 in chips, $2.45 bounty) 
Seat 8: Lunxspy (33386 in chips, $2.45 bounty) 
578346: posts the ante 175
IoannisVaios: posts the ante 175
decus1: posts the ante 175
tabu33: posts the ante 175
Kevin12345Mc: posts the ante 175
taluk_00: posts the ante 175
MahSandrs: posts the ante 175
Lunxspy: posts the ante 175
Kevin12345Mc: posts small blind 600
taluk_00: posts big blind 1200
*** HOLE CARDS ***
Dealt to Kevin12345Mc [Jc 2d]
MahSandrs: folds 
Lunxspy: raises 1332 to 2532
578346: folds 
IoannisVaios: folds 
decus1: folds 
tabu33: raises 2268 to 4800
Kevin12345Mc: folds 
taluk_00: folds 
Lunxspy: calls 2268
*** FLOP *** [Jh 7h Tc]
Lunxspy: checks 
tabu33: checks 
*** TURN *** [Jh 7h Tc] [9c]
Lunxspy: bets 5504
tabu33: calls 5504
*** RIVER *** [Jh 7h Tc 9c] [2s]
Lunxspy: checks 
tabu33: checks 
*** SHOW DOWN ***
Lunxspy: shows [Ts Qh] (a pair of Tens)
tabu33: mucks hand 
Lunxspy collected 23808 from pot
*** SUMMARY ***
Total pot 23808 | Rake 0 
Board [Jh 7h Tc 9c 2s]
Seat 1: 578346 folded before Flop (didn't bet)
Seat 2: IoannisVaios folded before Flop (didn't bet)
Seat 3: decus1 folded before Flop (didn't bet)
Seat 4: tabu33 (button) mucked [Kh Ah]
Seat 5: Kevin12345Mc (small blind) folded before Flop
Seat 6: taluk_00 (big blind) folded before Flop
Seat 7: MahSandrs folded before Flop (didn't bet)
Seat 8: Lunxspy showed [Ts Qh] and won (23808) with a pair of Tens



PokerStars Hand #254990395831: Tournament #3858857107, $2.45+$2.45+$0.60 USD Hold'em No Limit - Level XII (600/1200) - 2025/02/22 19:21:03 WET [2025/02/22 14:21:03 ET]
Table '3858857107 71' 8-max Seat #5 is the button
Seat 1: 578346 (28726 in chips, $2.45 bounty) 
Seat 2: IoannisVaios (22423 in chips, $2.45 bounty) 
Seat 3: decus1 (18552 in chips, $3.67 bounty) 
Seat 4: tabu33 (12535 in chips, $2.45 bounty) 
Seat 5: Kevin12345Mc (92767 in chips, $4.89 bounty) 
Seat 6: taluk_00 (21162 in chips, $2.45 bounty) 
Seat 7: MahSandrs (49401 in chips, $2.45 bounty) 
Seat 8: Lunxspy (46715 in chips, $2.45 bounty) 
578346: posts the ante 175
IoannisVaios: posts the ante 175
decus1: posts the ante 175
tabu33: posts the ante 175
Kevin12345Mc: posts the ante 175
taluk_00: posts the ante 175
MahSandrs: posts the ante 175
Lunxspy: posts the ante 175
taluk_00: posts small blind 600
MahSandrs: posts big blind 1200
*** HOLE CARDS ***
Dealt to Kevin12345Mc [5s 7c]
Lunxspy: folds 
578346: folds 
IoannisVaios: folds 
decus1: folds 
tabu33: folds 
Kevin12345Mc: folds 
taluk_00: folds 
Uncalled bet (600) returned to MahSandrs
MahSandrs collected 2600 from pot
MahSandrs: doesn't show hand 
*** SUMMARY ***
Total pot 2600 | Rake 0 
Seat 1: 578346 folded before Flop (didn't bet)
Seat 2: IoannisVaios folded before Flop (didn't bet)
Seat 3: decus1 folded before Flop (didn't bet)
Seat 4: tabu33 folded before Flop (didn't bet)
Seat 5: Kevin12345Mc (button) folded before Flop (didn't bet)
Seat 6: taluk_00 (small blind) folded before Flop
Seat 7: MahSandrs (big blind) collected (2600)
Seat 8: Lunxspy folded before Flop (didn't bet)



PokerStars Hand #254990401636: Tournament #3858857107, $2.45+$2.45+$0.60 USD Hold'em No Limit - Level XII (600/1200) - 2025/02/22 19:21:23 WET [2025/02/22 14:21:23 ET]
Table '3858857107 71' 8-max Seat #6 is the button
Seat 1: 578346 (28551 in chips, $2.45 bounty) 
Seat 2: IoannisVaios (22248 in chips, $2.45 bounty) 
Seat 3: decus1 (18377 in chips, $3.67 bounty) 
Seat 4: tabu33 (12360 in chips, $2.45 bounty) 
Seat 5: Kevin12345Mc (92592 in chips, $4.89 bounty) 
Seat 6: taluk_00 (20387 in chips, $2.45 bounty) 
Seat 7: MahSandrs (51226 in chips, $2.45 bounty) 
Seat 8: Lunxspy (46540 in chips, $2.45 bounty) 
578346: posts the ante 175
IoannisVaios: posts the ante 175
decus1: posts the ante 175
tabu33: posts the ante 175
Kevin12345Mc: posts the ante 175
taluk_00: posts the ante 175
MahSandrs: posts the ante 175
Lunxspy: posts the ante 175
MahSandrs: posts small blind 600
Lunxspy: posts big blind 1200
*** HOLE CARDS ***
Dealt to Kevin12345Mc [9h 2h]
578346: folds 
IoannisVaios: folds 
decus1: folds 
tabu33: folds 
Kevin12345Mc: folds 
taluk_00: folds 
MahSandrs: raises 3720 to 4920
Lunxspy: folds 
Uncalled bet (3720) returned to MahSandrs
MahSandrs collected 3800 from pot
MahSandrs: doesn't show hand 
*** SUMMARY ***
Total pot 3800 | Rake 0 
Seat 1: 578346 folded before Flop (didn't bet)
Seat 2: IoannisVaios folded before Flop (didn't bet)
Seat 3: decus1 folded before Flop (didn't bet)
Seat 4: tabu33 folded before Flop (didn't bet)
Seat 5: Kevin12345Mc folded before Flop (didn't bet)
Seat 6: taluk_00 (button) folded before Flop (didn't bet)
Seat 7: MahSandrs (small blind) collected (3800)
Seat 8: Lunxspy (big blind) folded before Flop



PokerStars Hand #254990410575: Tournament #3858857107, $2.45+$2.45+$0.60 USD Hold'em No Limit - Level XII (600/1200) - 2025/02/22 19:21:54 WET [2025/02/22 14:21:54 ET]
Table '3858857107 71' 8-max Seat #7 is the button
Seat 1: 578346 (28376 in chips, $2.45 bounty) 
Seat 2: IoannisVaios (22073 in chips, $2.45 bounty) 
Seat 3: decus1 (18202 in chips, $3.67 bounty) 
Seat 4: tabu33 (12185 in chips, $2.45 bounty) 
Seat 5: Kevin12345Mc (92417 in chips, $4.89 bounty) 
Seat 6: taluk_00 (20212 in chips, $2.45 bounty) 
Seat 7: MahSandrs (53651 in chips, $2.45 bounty) 
Seat 8: Lunxspy (45165 in chips, $2.45 bounty) 
578346: posts the ante 175
IoannisVaios: posts the ante 175
decus1: posts the ante 175
tabu33: posts the ante 175
Kevin12345Mc: posts the ante 175
taluk_00: posts the ante 175
MahSandrs: posts the ante 175
Lunxspy: posts the ante 175
Lunxspy: posts small blind 600
578346: posts big blind 1200
*** HOLE CARDS ***
Dealt to Kevin12345Mc [Jc Th]
IoannisVaios: folds 
decus1: folds 
tabu33: raises 10810 to 12010 and is all-in
Kevin12345Mc: folds 
taluk_00: folds 
MahSandrs: raises 41466 to 53476 and is all-in
Lunxspy: folds 
578346: folds 
Uncalled bet (41466) returned to MahSandrs
*** FLOP *** [Kc 8c Ks]
*** TURN *** [Kc 8c Ks] [Tc]
*** RIVER *** [Kc 8c Ks Tc] [9d]
*** SHOW DOWN ***
tabu33: shows [5h Ah] (a pair of Kings)
MahSandrs: shows [Td Ac] (two pair, Kings and Tens)
MahSandrs collected 27220 from pot
MahSandrs wins $1.23 for eliminating tabu33 and their own bounty increases by $1.22 to $3.67
tabu33 finished the tournament
*** SUMMARY ***
Total pot 27220 | Rake 0 
Board [Kc 8c Ks Tc 9d]
Seat 1: 578346 (big blind) folded before Flop
Seat 2: IoannisVaios folded before Flop (didn't bet)
Seat 3: decus1 folded before Flop (didn't bet)
Seat 4: tabu33 showed [5h Ah] and lost with a pair of Kings
Seat 5: Kevin12345Mc folded before Flop (didn't bet)
Seat 6: taluk_00 folded before Flop (didn't bet)
Seat 7: MahSandrs (button) showed [Td Ac] and won (27220) with two pair, Kings and Tens
Seat 8: Lunxspy (small blind) folded before Flop



PokerStars Hand #254990422387: Tournament #3858857107, $2.45+$2.45+$0.60 USD Hold'em No Limit - Level XIII (700/1400) - 2025/02/22 19:22:35 WET [2025/02/22 14:22:35 ET]
Table '3858857107 71' 8-max Seat #8 is the button
Seat 1: 578346 (27001 in chips, $2.45 bounty) 
Seat 2: IoannisVaios (21898 in chips, $2.45 bounty) 
Seat 3: decus1 (18027 in chips, $3.67 bounty) 
Seat 5: Kevin12345Mc (92242 in chips, $4.89 bounty) 
Seat 6: taluk_00 (20037 in chips, $2.45 bounty) 
Seat 7: MahSandrs (68686 in chips, $3.67 bounty) 
Seat 8: Lunxspy (44390 in chips, $2.45 bounty) 
578346: posts the ante 200
IoannisVaios: posts the ante 200
decus1: posts the ante 200
Kevin12345Mc: posts the ante 200
taluk_00: posts the ante 200
MahSandrs: posts the ante 200
Lunxspy: posts the ante 200
578346: posts small blind 700
IoannisVaios: posts big blind 1400
*** HOLE CARDS ***
Dealt to Kevin12345Mc [3h Qs]
decus1: raises 1400 to 2800
Kevin12345Mc: folds 
taluk_00: folds 
MahSandrs: folds 
Lunxspy: folds 
578346: folds 
IoannisVaios: folds 
Uncalled bet (1400) returned to decus1
decus1 collected 4900 from pot
*** SUMMARY ***
Total pot 4900 | Rake 0 
Seat 1: 578346 (small blind) folded before Flop
Seat 2: IoannisVaios (big blind) folded before Flop
Seat 3: decus1 collected (4900)
Seat 5: Kevin12345Mc folded before Flop (didn't bet)
Seat 6: taluk_00 folded before Flop (didn't bet)
Seat 7: MahSandrs folded before Flop (didn't bet)
Seat 8: Lunxspy (button) folded before Flop (didn't bet)



PokerStars Hand #254990429095: Tournament #3858857107, $2.45+$2.45+$0.60 USD Hold'em No Limit - Level XIII (700/1400) - 2025/02/22 19:22:58 WET [2025/02/22 14:22:58 ET]
Table '3858857107 71' 8-max Seat #1 is the button
Seat 1: 578346 (26101 in chips, $2.45 bounty) 
Seat 2: IoannisVaios (20298 in chips, $2.45 bounty) 
Seat 3: decus1 (21327 in chips, $3.67 bounty) 
Seat 5: Kevin12345Mc (92042 in chips, $4.89 bounty) 
Seat 6: taluk_00 (19837 in chips, $2.45 bounty) 
Seat 7: MahSandrs (68486 in chips, $3.67 bounty) 
Seat 8: Lunxspy (44190 in chips, $2.45 bounty) 
578346: posts the ante 200
IoannisVaios: posts the ante 200
decus1: posts the ante 200
Kevin12345Mc: posts the ante 200
taluk_00: posts the ante 200
MahSandrs: posts the ante 200
Lunxspy: posts the ante 200
IoannisVaios: posts small blind 700
decus1: posts big blind 1400
*** HOLE CARDS ***
Dealt to Kevin12345Mc [Qd Qh]
BuddhA_FP is disconnected 
Kevin12345Mc: raises 1820 to 3220
taluk_00: folds 
MahSandrs: folds 
Lunxspy: folds 
578346: folds 
IoannisVaios: folds 
decus1: folds 
Uncalled bet (1820) returned to Kevin12345Mc
Kevin12345Mc collected 4900 from pot
Kevin12345Mc: doesn't show hand 
*** SUMMARY ***
Total pot 4900 | Rake 0 
Seat 1: 578346 (button) folded before Flop (didn't bet)
Seat 2: IoannisVaios (small blind) folded before Flop
Seat 3: decus1 (big blind) folded before Flop
Seat 5: Kevin12345Mc collected (4900)
Seat 6: taluk_00 folded before Flop (didn't bet)
Seat 7: MahSandrs folded before Flop (didn't bet)
Seat 8: Lunxspy folded before Flop (didn't bet)



PokerStars Hand #254990436107: Tournament #3858857107, $2.45+$2.45+$0.60 USD Hold'em No Limit - Level XIII (700/1400) - 2025/02/22 19:23:22 WET [2025/02/22 14:23:22 ET]
Table '3858857107 71' 8-max Seat #2 is the button
Seat 1: 578346 (25901 in chips, $2.45 bounty) 
Seat 2: IoannisVaios (19398 in chips, $2.45 bounty) 
Seat 3: decus1 (19727 in chips, $3.67 bounty) 
Seat 4: BuddhA_FP (10224 in chips, $2.45 bounty) 
Seat 5: Kevin12345Mc (95342 in chips, $4.89 bounty) 
Seat 6: taluk_00 (19637 in chips, $2.45 bounty) 
Seat 7: MahSandrs (68286 in chips, $3.67 bounty) 
Seat 8: Lunxspy (43990 in chips, $2.45 bounty) 
578346: posts the ante 200
IoannisVaios: posts the ante 200
decus1: posts the ante 200
BuddhA_FP: posts the ante 200
Kevin12345Mc: posts the ante 200
taluk_00: posts the ante 200
MahSandrs: posts the ante 200
Lunxspy: posts the ante 200
decus1: posts small blind 700
BuddhA_FP: posts big blind 1400
*** HOLE CARDS ***
Dealt to Kevin12345Mc [Kc 2d]
Kevin12345Mc: folds 
taluk_00: folds 
MahSandrs: folds 
Lunxspy: raises 1554 to 2954
578346: folds 
IoannisVaios: folds 
decus1: folds 
BuddhA_FP: calls 1554
*** FLOP *** [2h Qs Qc]
BuddhA_FP: checks 
Lunxspy: checks 
*** TURN *** [2h Qs Qc] [7d]
BuddhA_FP: checks 
Lunxspy: bets 1400
BuddhA_FP: raises 2100 to 3500
Lunxspy: calls 2100
*** RIVER *** [2h Qs Qc 7d] [4c]
BuddhA_FP: bets 3570 and is all-in
Lunxspy: calls 3570
*** SHOW DOWN ***
BuddhA_FP: shows [Qh 6c] (three of a kind, Queens)
Lunxspy: shows [Th Jc] (a pair of Queens)
BuddhA_FP collected 22348 from pot
*** SUMMARY ***
Total pot 22348 | Rake 0 
Board [2h Qs Qc 7d 4c]
Seat 1: 578346 folded before Flop (didn't bet)
Seat 2: IoannisVaios (button) folded before Flop (didn't bet)
Seat 3: decus1 (small blind) folded before Flop
Seat 4: BuddhA_FP (big blind) showed [Qh 6c] and won (22348) with three of a kind, Queens
Seat 5: Kevin12345Mc folded before Flop (didn't bet)
Seat 6: taluk_00 folded before Flop (didn't bet)
Seat 7: MahSandrs folded before Flop (didn't bet)
Seat 8: Lunxspy showed [Th Jc] and lost with a pair of Queens



PokerStars Hand #254990454676: Tournament #3858857107, $2.45+$2.45+$0.60 USD Hold'em No Limit - Level XIII (700/1400) - 2025/02/22 19:24:27 WET [2025/02/22 14:24:27 ET]
Table '3858857107 71' 8-max Seat #3 is the button
Seat 1: 578346 (25701 in chips, $2.45 bounty) 
Seat 2: IoannisVaios (19198 in chips, $2.45 bounty) 
Seat 3: decus1 (18827 in chips, $3.67 bounty) 
Seat 4: BuddhA_FP (22348 in chips, $2.45 bounty) 
Seat 5: Kevin12345Mc (95142 in chips, $4.89 bounty) 
Seat 6: taluk_00 (19437 in chips, $2.45 bounty) 
Seat 7: MahSandrs (68086 in chips, $3.67 bounty) 
Seat 8: Lunxspy (33766 in chips, $2.45 bounty) 
578346: posts the ante 200
IoannisVaios: posts the ante 200
decus1: posts the ante 200
BuddhA_FP: posts the ante 200
Kevin12345Mc: posts the ante 200
taluk_00: posts the ante 200
MahSandrs: posts the ante 200
Lunxspy: posts the ante 200
BuddhA_FP: posts small blind 700
Kevin12345Mc: posts big blind 1400
*** HOLE CARDS ***
Dealt to Kevin12345Mc [4d 9h]
taluk_00: raises 17837 to 19237 and is all-in
MahSandrs: folds 
Lunxspy: folds 
578346: folds 
IoannisVaios: folds 
decus1: folds 
BuddhA_FP: folds 
Kevin12345Mc: folds 
Uncalled bet (17837) returned to taluk_00
taluk_00 collected 5100 from pot
taluk_00: doesn't show hand 
*** SUMMARY ***
Total pot 5100 | Rake 0 
Seat 1: 578346 folded before Flop (didn't bet)
Seat 2: IoannisVaios folded before Flop (didn't bet)
Seat 3: decus1 (button) folded before Flop (didn't bet)
Seat 4: BuddhA_FP (small blind) folded before Flop
Seat 5: Kevin12345Mc (big blind) folded before Flop
Seat 6: taluk_00 collected (5100)
Seat 7: MahSandrs folded before Flop (didn't bet)
Seat 8: Lunxspy folded before Flop (didn't bet)



PokerStars Hand #254990461413: Tournament #3858857107, $2.45+$2.45+$0.60 USD Hold'em No Limit - Level XIII (700/1400) - 2025/02/22 19:24:51 WET [2025/02/22 14:24:51 ET]
Table '3858857107 71' 8-max Seat #4 is the button
Seat 1: 578346 (25501 in chips, $2.45 bounty) 
Seat 2: IoannisVaios (18998 in chips, $2.45 bounty) 
Seat 3: decus1 (18627 in chips, $3.67 bounty) 
Seat 4: BuddhA_FP (21448 in chips, $2.45 bounty) 
Seat 5: Kevin12345Mc (93542 in chips, $4.89 bounty) 
Seat 6: taluk_00 (22937 in chips, $2.45 bounty) 
Seat 7: MahSandrs (67886 in chips, $3.67 bounty) 
Seat 8: Lunxspy (33566 in chips, $2.45 bounty) 
578346: posts the ante 200
IoannisVaios: posts the ante 200
decus1: posts the ante 200
BuddhA_FP: posts the ante 200
Kevin12345Mc: posts the ante 200
taluk_00: posts the ante 200
MahSandrs: posts the ante 200
Lunxspy: posts the ante 200
Kevin12345Mc: posts small blind 700
taluk_00: posts big blind 1400
*** HOLE CARDS ***
Dealt to Kevin12345Mc [7d Jd]
MahSandrs: folds 
Lunxspy: raises 2618 to 4018
578346: folds 
IoannisVaios: folds 
decus1: folds 
BuddhA_FP: folds 
Kevin12345Mc: folds 
taluk_00: folds 
Uncalled bet (2618) returned to Lunxspy
Lunxspy collected 5100 from pot
*** SUMMARY ***
Total pot 5100 | Rake 0 
Seat 1: 578346 folded before Flop (didn't bet)
Seat 2: IoannisVaios folded before Flop (didn't bet)
Seat 3: decus1 folded before Flop (didn't bet)
Seat 4: BuddhA_FP (button) folded before Flop (didn't bet)
Seat 5: Kevin12345Mc (small blind) folded before Flop
Seat 6: taluk_00 (big blind) folded before Flop
Seat 7: MahSandrs folded before Flop (didn't bet)
Seat 8: Lunxspy collected (5100)



PokerStars Hand #254990473029: Tournament #3858857107, $2.45+$2.45+$0.60 USD Hold'em No Limit - Level XIII (700/1400) - 2025/02/22 19:25:32 WET [2025/02/22 14:25:32 ET]
Table '3858857107 71' 8-max Seat #5 is the button
Seat 1: 578346 (25301 in chips, $2.45 bounty) 
Seat 2: IoannisVaios (18798 in chips, $2.45 bounty) 
Seat 3: decus1 (18427 in chips, $3.67 bounty) 
Seat 4: BuddhA_FP (21248 in chips, $2.45 bounty) 
Seat 5: Kevin12345Mc (92642 in chips, $4.89 bounty) 
Seat 6: taluk_00 (21337 in chips, $2.45 bounty) 
Seat 7: MahSandrs (67686 in chips, $3.67 bounty) 
Seat 8: Lunxspy (37066 in chips, $2.45 bounty) 
578346: posts the ante 200
IoannisVaios: posts the ante 200
decus1: posts the ante 200
BuddhA_FP: posts the ante 200
Kevin12345Mc: posts the ante 200
taluk_00: posts the ante 200
MahSandrs: posts the ante 200
Lunxspy: posts the ante 200
taluk_00: posts small blind 700
MahSandrs: posts big blind 1400
*** HOLE CARDS ***
Dealt to Kevin12345Mc [8h 4c]
Lunxspy: raises 2618 to 4018
578346: folds 
IoannisVaios: folds 
decus1: folds 
BuddhA_FP: folds 
Kevin12345Mc: folds 
taluk_00: folds 
MahSandrs: calls 2618
*** FLOP *** [6d 7s 2s]
MahSandrs: checks 
Lunxspy: bets 4444
MahSandrs: folds 
Uncalled bet (4444) returned to Lunxspy
Lunxspy collected 10336 from pot
*** SUMMARY ***
Total pot 10336 | Rake 0 
Board [6d 7s 2s]
Seat 1: 578346 folded before Flop (didn't bet)
Seat 2: IoannisVaios folded before Flop (didn't bet)
Seat 3: decus1 folded before Flop (didn't bet)
Seat 4: BuddhA_FP folded before Flop (didn't bet)
Seat 5: Kevin12345Mc (button) folded before Flop (didn't bet)
Seat 6: taluk_00 (small blind) folded before Flop
Seat 7: MahSandrs (big blind) folded on the Flop
Seat 8: Lunxspy collected (10336)



PokerStars Hand #254990482903: Tournament #3858857107, $2.45+$2.45+$0.60 USD Hold'em No Limit - Level XIII (700/1400) - 2025/02/22 19:26:07 WET [2025/02/22 14:26:07 ET]
Table '3858857107 71' 8-max Seat #6 is the button
Seat 1: 578346 (25101 in chips, $2.45 bounty) 
Seat 2: IoannisVaios (18598 in chips, $2.45 bounty) 
Seat 3: decus1 (18227 in chips, $3.67 bounty) 
Seat 4: BuddhA_FP (21048 in chips, $2.45 bounty) 
Seat 5: Kevin12345Mc (92442 in chips, $4.89 bounty) 
Seat 6: taluk_00 (20437 in chips, $2.45 bounty) 
Seat 7: MahSandrs (63468 in chips, $3.67 bounty) 
Seat 8: Lunxspy (43184 in chips, $2.45 bounty) 
578346: posts the ante 200
IoannisVaios: posts the ante 200
decus1: posts the ante 200
BuddhA_FP: posts the ante 200
Kevin12345Mc: posts the ante 200
taluk_00: posts the ante 200
MahSandrs: posts the ante 200
Lunxspy: posts the ante 200
MahSandrs: posts small blind 700
Lunxspy: posts big blind 1400
*** HOLE CARDS ***
Dealt to Kevin12345Mc [2d Td]
578346: folds 
IoannisVaios: folds 
decus1: folds 
BuddhA_FP: folds 
Kevin12345Mc: folds 
taluk_00: folds 
MahSandrs: raises 2380 to 3780
Lunxspy: calls 2380
*** FLOP *** [2h Tc 8h]
MahSandrs: bets 3024
Lunxspy: folds 
Uncalled bet (3024) returned to MahSandrs
MahSandrs collected 9160 from pot
MahSandrs: doesn't show hand 
*** SUMMARY ***
Total pot 9160 | Rake 0 
Board [2h Tc 8h]
Seat 1: 578346 folded before Flop (didn't bet)
Seat 2: IoannisVaios folded before Flop (didn't bet)
Seat 3: decus1 folded before Flop (didn't bet)
Seat 4: BuddhA_FP folded before Flop (didn't bet)
Seat 5: Kevin12345Mc folded before Flop (didn't bet)
Seat 6: taluk_00 (button) folded before Flop (didn't bet)
Seat 7: MahSandrs (small blind) collected (9160)
Seat 8: Lunxspy (big blind) folded on the Flop



PokerStars Hand #254990495883: Tournament #3858857107, $2.45+$2.45+$0.60 USD Hold'em No Limit - Level XIII (700/1400) - 2025/02/22 19:26:53 WET [2025/02/22 14:26:53 ET]
Table '3858857107 71' 8-max Seat #7 is the button
Seat 1: 578346 (24901 in chips, $2.45 bounty) 
Seat 2: IoannisVaios (18398 in chips, $2.45 bounty) 
Seat 3: decus1 (18027 in chips, $3.67 bounty) 
Seat 4: BuddhA_FP (20848 in chips, $2.45 bounty) 
Seat 5: Kevin12345Mc (92242 in chips, $4.89 bounty) 
Seat 6: taluk_00 (20237 in chips, $2.45 bounty) 
Seat 7: MahSandrs (68648 in chips, $3.67 bounty) 
Seat 8: Lunxspy (39204 in chips, $2.45 bounty) 
578346: posts the ante 200
IoannisVaios: posts the ante 200
decus1: posts the ante 200
BuddhA_FP: posts the ante 200
Kevin12345Mc: posts the ante 200
taluk_00: posts the ante 200
MahSandrs: posts the ante 200
Lunxspy: posts the ante 200
Lunxspy: posts small blind 700
578346: posts big blind 1400
*** HOLE CARDS ***
Dealt to Kevin12345Mc [3d Qh]
IoannisVaios: folds 
decus1: calls 1400
BuddhA_FP: folds 
Kevin12345Mc: folds 
taluk_00: folds 
MahSandrs: folds 
Lunxspy: raises 2618 to 4018
578346: folds 
decus1: folds 
Uncalled bet (2618) returned to Lunxspy
Lunxspy collected 5800 from pot
*** SUMMARY ***
Total pot 5800 | Rake 0 
Seat 1: 578346 (big blind) folded before Flop
Seat 2: IoannisVaios folded before Flop (didn't bet)
Seat 3: decus1 folded before Flop
Seat 4: BuddhA_FP folded before Flop (didn't bet)
Seat 5: Kevin12345Mc folded before Flop (didn't bet)
Seat 6: taluk_00 folded before Flop (didn't bet)
Seat 7: MahSandrs (button) folded before Flop (didn't bet)
Seat 8: Lunxspy (small blind) collected (5800)



PokerStars Hand #254990504735: Tournament #3858857107, $2.45+$2.45+$0.60 USD Hold'em No Limit - Level XIII (700/1400) - 2025/02/22 19:27:24 WET [2025/02/22 14:27:24 ET]
Table '3858857107 71' 8-max Seat #8 is the button
Seat 1: 578346 (23301 in chips, $2.45 bounty) 
Seat 2: IoannisVaios (18198 in chips, $2.45 bounty) 
Seat 3: decus1 (16427 in chips, $3.67 bounty) 
Seat 4: BuddhA_FP (20648 in chips, $2.45 bounty) 
Seat 5: Kevin12345Mc (92042 in chips, $4.89 bounty) 
Seat 6: taluk_00 (20037 in chips, $2.45 bounty) 
Seat 7: MahSandrs (68448 in chips, $3.67 bounty) 
Seat 8: Lunxspy (43404 in chips, $2.45 bounty) 
578346: posts the ante 200
IoannisVaios: posts the ante 200
decus1: posts the ante 200
BuddhA_FP: posts the ante 200
Kevin12345Mc: posts the ante 200
taluk_00: posts the ante 200
MahSandrs: posts the ante 200
Lunxspy: posts the ante 200
578346: posts small blind 700
IoannisVaios: posts big blind 1400
*** HOLE CARDS ***
Dealt to Kevin12345Mc [Tc 2c]
decus1: folds 
BuddhA_FP: folds 
Kevin12345Mc: folds 
taluk_00: folds 
MahSandrs: raises 1400 to 2800
Lunxspy: calls 2800
578346: folds 
IoannisVaios: folds 
*** FLOP *** [Qs Ac 9c]
MahSandrs: checks 
Lunxspy: bets 3999
MahSandrs: folds 
Uncalled bet (3999) returned to Lunxspy
Lunxspy collected 9300 from pot
*** SUMMARY ***
Total pot 9300 | Rake 0 
Board [Qs Ac 9c]
Seat 1: 578346 (small blind) folded before Flop
Seat 2: IoannisVaios (big blind) folded before Flop
Seat 3: decus1 folded before Flop (didn't bet)
Seat 4: BuddhA_FP folded before Flop (didn't bet)
Seat 5: Kevin12345Mc folded before Flop (didn't bet)
Seat 6: taluk_00 folded before Flop (didn't bet)
Seat 7: MahSandrs folded on the Flop
Seat 8: Lunxspy (button) collected (9300)



PokerStars Hand #254990517916: Tournament #3858857107, $2.45+$2.45+$0.60 USD Hold'em No Limit - Level XIII (700/1400) - 2025/02/22 19:28:11 WET [2025/02/22 14:28:11 ET]
Table '3858857107 71' 8-max Seat #1 is the button
Seat 1: 578346 (22401 in chips, $2.45 bounty) 
Seat 2: IoannisVaios (16598 in chips, $2.45 bounty) 
Seat 3: decus1 (16227 in chips, $3.67 bounty) 
Seat 4: BuddhA_FP (20448 in chips, $2.45 bounty) 
Seat 5: Kevin12345Mc (91842 in chips, $4.89 bounty) 
Seat 6: taluk_00 (19837 in chips, $2.45 bounty) 
Seat 7: MahSandrs (65448 in chips, $3.67 bounty) 
Seat 8: Lunxspy (49704 in chips, $2.45 bounty) 
578346: posts the ante 200
IoannisVaios: posts the ante 200
decus1: posts the ante 200
BuddhA_FP: posts the ante 200
Kevin12345Mc: posts the ante 200
taluk_00: posts the ante 200
MahSandrs: posts the ante 200
Lunxspy: posts the ante 200
IoannisVaios: posts small blind 700
decus1: posts big blind 1400
*** HOLE CARDS ***
Dealt to Kevin12345Mc [5c 8c]
BuddhA_FP: folds 
Kevin12345Mc: folds 
taluk_00: folds 
MahSandrs: folds 
Lunxspy: folds 
578346: folds 
IoannisVaios: raises 14998 to 16398 and is all-in
decus1: folds 
Uncalled bet (14998) returned to IoannisVaios
IoannisVaios collected 4400 from pot
IoannisVaios: doesn't show hand 
*** SUMMARY ***
Total pot 4400 | Rake 0 
Seat 1: 578346 (button) folded before Flop (didn't bet)
Seat 2: IoannisVaios (small blind) collected (4400)
Seat 3: decus1 (big blind) folded before Flop
Seat 4: BuddhA_FP folded before Flop (didn't bet)
Seat 5: Kevin12345Mc folded before Flop (didn't bet)
Seat 6: taluk_00 folded before Flop (didn't bet)
Seat 7: MahSandrs folded before Flop (didn't bet)
Seat 8: Lunxspy folded before Flop (didn't bet)



PokerStars Hand #254990524083: Tournament #3858857107, $2.45+$2.45+$0.60 USD Hold'em No Limit - Level XIII (700/1400) - 2025/02/22 19:28:32 WET [2025/02/22 14:28:32 ET]
Table '3858857107 71' 8-max Seat #2 is the button
Seat 1: 578346 (22201 in chips, $2.45 bounty) 
Seat 2: IoannisVaios (19398 in chips, $2.45 bounty) 
Seat 3: decus1 (14627 in chips, $3.67 bounty) 
Seat 4: BuddhA_FP (20248 in chips, $2.45 bounty) 
Seat 5: Kevin12345Mc (91642 in chips, $4.89 bounty) 
Seat 6: taluk_00 (19637 in chips, $2.45 bounty) 
Seat 7: MahSandrs (65248 in chips, $3.67 bounty) 
Seat 8: Lunxspy (49504 in chips, $2.45 bounty) 
578346: posts the ante 200
IoannisVaios: posts the ante 200
decus1: posts the ante 200
BuddhA_FP: posts the ante 200
Kevin12345Mc: posts the ante 200
taluk_00: posts the ante 200
MahSandrs: posts the ante 200
Lunxspy: posts the ante 200
decus1: posts small blind 700
BuddhA_FP: posts big blind 1400
*** HOLE CARDS ***
Dealt to Kevin12345Mc [6s 3c]
Kevin12345Mc: folds 
taluk_00: folds 
MahSandrs: raises 1400 to 2800
Lunxspy: folds 
578346: folds 
IoannisVaios: folds 
decus1: folds 
BuddhA_FP: folds 
Uncalled bet (1400) returned to MahSandrs
MahSandrs collected 5100 from pot
MahSandrs: doesn't show hand 
*** SUMMARY ***
Total pot 5100 | Rake 0 
Seat 1: 578346 folded before Flop (didn't bet)
Seat 2: IoannisVaios (button) folded before Flop (didn't bet)
Seat 3: decus1 (small blind) folded before Flop
Seat 4: BuddhA_FP (big blind) folded before Flop
Seat 5: Kevin12345Mc folded before Flop (didn't bet)
Seat 6: taluk_00 folded before Flop (didn't bet)
Seat 7: MahSandrs collected (5100)
Seat 8: Lunxspy folded before Flop (didn't bet)



PokerStars Hand #254990536338: Tournament #3858857107, $2.45+$2.45+$0.60 USD Hold'em No Limit - Level XIII (700/1400) - 2025/02/22 19:29:16 WET [2025/02/22 14:29:16 ET]
Table '3858857107 71' 8-max Seat #3 is the button
Seat 1: 578346 (22001 in chips, $2.45 bounty) 
Seat 2: IoannisVaios (19198 in chips, $2.45 bounty) 
Seat 3: decus1 (13727 in chips, $3.67 bounty) 
Seat 4: BuddhA_FP (18648 in chips, $2.45 bounty) 
Seat 5: Kevin12345Mc (91442 in chips, $4.89 bounty) 
Seat 6: taluk_00 (19437 in chips, $2.45 bounty) 
Seat 7: MahSandrs (68748 in chips, $3.67 bounty) 
Seat 8: Lunxspy (49304 in chips, $2.45 bounty) 
578346: posts the ante 200
IoannisVaios: posts the ante 200
decus1: posts the ante 200
BuddhA_FP: posts the ante 200
Kevin12345Mc: posts the ante 200
taluk_00: posts the ante 200
MahSandrs: posts the ante 200
Lunxspy: posts the ante 200
BuddhA_FP: posts small blind 700
Kevin12345Mc: posts big blind 1400
*** HOLE CARDS ***
Dealt to Kevin12345Mc [3d Ts]
taluk_00: folds 
MahSandrs: folds 
Lunxspy: folds 
578346: folds 
IoannisVaios: folds 
decus1: calls 1400
BuddhA_FP: calls 700
Kevin12345Mc: checks 
*** FLOP *** [Jh Ah Jd]
BuddhA_FP: checks 
Kevin12345Mc: checks 
decus1: checks 
*** TURN *** [Jh Ah Jd] [Td]
BuddhA_FP: bets 2800
Kevin12345Mc: calls 2800
decus1: calls 2800
*** RIVER *** [Jh Ah Jd Td] [2s]
BuddhA_FP: checks 
Kevin12345Mc: checks 
decus1: checks 
*** SHOW DOWN ***
BuddhA_FP: shows [5h 7h] (a pair of Jacks)
Kevin12345Mc: shows [3d Ts] (two pair, Jacks and Tens)
decus1: shows [As 9d] (two pair, Aces and Jacks)
decus1 collected 14200 from pot
*** SUMMARY ***
Total pot 14200 | Rake 0 
Board [Jh Ah Jd Td 2s]
Seat 1: 578346 folded before Flop (didn't bet)
Seat 2: IoannisVaios folded before Flop (didn't bet)
Seat 3: decus1 (button) showed [As 9d] and won (14200) with two pair, Aces and Jacks
Seat 4: BuddhA_FP (small blind) showed [5h 7h] and lost with a pair of Jacks
Seat 5: Kevin12345Mc (big blind) showed [3d Ts] and lost with two pair, Jacks and Tens
Seat 6: taluk_00 folded before Flop (didn't bet)
Seat 7: MahSandrs folded before Flop (didn't bet)
Seat 8: Lunxspy folded before Flop (didn't bet)



PokerStars Hand #254990559300: Tournament #3858857107, $2.45+$2.45+$0.60 USD Hold'em No Limit - Level XIV (800/1600) - 2025/02/22 19:30:36 WET [2025/02/22 14:30:36 ET]
Table '3858857107 71' 8-max Seat #4 is the button
Seat 1: 578346 (21801 in chips, $2.45 bounty) 
Seat 2: IoannisVaios (18998 in chips, $2.45 bounty) 
Seat 3: decus1 (23527 in chips, $3.67 bounty) 
Seat 4: BuddhA_FP (14248 in chips, $2.45 bounty) 
Seat 5: Kevin12345Mc (87042 in chips, $4.89 bounty) 
Seat 6: taluk_00 (19237 in chips, $2.45 bounty) 
Seat 7: MahSandrs (68548 in chips, $3.67 bounty) 
Seat 8: Lunxspy (49104 in chips, $2.45 bounty) 
578346: posts the ante 225
IoannisVaios: posts the ante 225
decus1: posts the ante 225
BuddhA_FP: posts the ante 225
Kevin12345Mc: posts the ante 225
taluk_00: posts the ante 225
MahSandrs: posts the ante 225
Lunxspy: posts the ante 225
Kevin12345Mc: posts small blind 800
taluk_00: posts big blind 1600
*** HOLE CARDS ***
Dealt to Kevin12345Mc [Tc 2d]
MahSandrs: folds 
Lunxspy: raises 1776 to 3376
578346: folds 
IoannisVaios: folds 
decus1: folds 
BuddhA_FP: folds 
Kevin12345Mc: folds 
taluk_00: folds 
Uncalled bet (1776) returned to Lunxspy
Lunxspy collected 5800 from pot
*** SUMMARY ***
Total pot 5800 | Rake 0 
Seat 1: 578346 folded before Flop (didn't bet)
Seat 2: IoannisVaios folded before Flop (didn't bet)
Seat 3: decus1 folded before Flop (didn't bet)
Seat 4: BuddhA_FP (button) folded before Flop (didn't bet)
Seat 5: Kevin12345Mc (small blind) folded before Flop
Seat 6: taluk_00 (big blind) folded before Flop
Seat 7: MahSandrs folded before Flop (didn't bet)
Seat 8: Lunxspy collected (5800)



PokerStars Hand #254990569040: Tournament #3858857107, $2.45+$2.45+$0.60 USD Hold'em No Limit - Level XIV (800/1600) - 2025/02/22 19:31:11 WET [2025/02/22 14:31:11 ET]
Table '3858857107 71' 8-max Seat #5 is the button
Seat 1: 578346 (21576 in chips, $2.45 bounty) 
Seat 2: IoannisVaios (18773 in chips, $2.45 bounty) 
Seat 3: decus1 (23302 in chips, $3.67 bounty) 
Seat 4: BuddhA_FP (14023 in chips, $2.45 bounty) 
Seat 5: Kevin12345Mc (86017 in chips, $4.89 bounty) 
Seat 6: taluk_00 (17412 in chips, $2.45 bounty) 
Seat 7: MahSandrs (68323 in chips, $3.67 bounty) 
Seat 8: Lunxspy (53079 in chips, $2.45 bounty) 
578346: posts the ante 225
IoannisVaios: posts the ante 225
decus1: posts the ante 225
BuddhA_FP: posts the ante 225
Kevin12345Mc: posts the ante 225
taluk_00: posts the ante 225
MahSandrs: posts the ante 225
Lunxspy: posts the ante 225
taluk_00: posts small blind 800
MahSandrs: posts big blind 1600
*** HOLE CARDS ***
Dealt to Kevin12345Mc [3d 8c]
Lunxspy: folds 
578346: folds 
IoannisVaios: folds 
decus1: folds 
BuddhA_FP: folds 
Kevin12345Mc: folds 
taluk_00: raises 15587 to 17187 and is all-in
MahSandrs: folds 
Uncalled bet (15587) returned to taluk_00
taluk_00 collected 5000 from pot
taluk_00: doesn't show hand 
*** SUMMARY ***
Total pot 5000 | Rake 0 
Seat 1: 578346 folded before Flop (didn't bet)
Seat 2: IoannisVaios folded before Flop (didn't bet)
Seat 3: decus1 folded before Flop (didn't bet)
Seat 4: BuddhA_FP folded before Flop (didn't bet)
Seat 5: Kevin12345Mc (button) folded before Flop (didn't bet)
Seat 6: taluk_00 (small blind) collected (5000)
Seat 7: MahSandrs (big blind) folded before Flop
Seat 8: Lunxspy folded before Flop (didn't bet)



PokerStars Hand #254990579916: Tournament #3858857107, $2.45+$2.45+$0.60 USD Hold'em No Limit - Level XIV (800/1600) - 2025/02/22 19:31:49 WET [2025/02/22 14:31:49 ET]
Table '3858857107 71' 8-max Seat #6 is the button
Seat 1: 578346 (21351 in chips, $2.45 bounty) 
Seat 2: IoannisVaios (18548 in chips, $2.45 bounty) 
Seat 3: decus1 (23077 in chips, $3.67 bounty) 
Seat 4: BuddhA_FP (13798 in chips, $2.45 bounty) 
Seat 5: Kevin12345Mc (85792 in chips, $4.89 bounty) 
Seat 6: taluk_00 (20587 in chips, $2.45 bounty) 
Seat 7: MahSandrs (66498 in chips, $3.67 bounty) 
Seat 8: Lunxspy (52854 in chips, $2.45 bounty) 
578346: posts the ante 225
IoannisVaios: posts the ante 225
decus1: posts the ante 225
BuddhA_FP: posts the ante 225
Kevin12345Mc: posts the ante 225
taluk_00: posts the ante 225
MahSandrs: posts the ante 225
Lunxspy: posts the ante 225
MahSandrs: posts small blind 800
Lunxspy: posts big blind 1600
*** HOLE CARDS ***
Dealt to Kevin12345Mc [Ah 7d]
578346: folds 
IoannisVaios: folds 
decus1: calls 1600
BuddhA_FP: folds 
Kevin12345Mc: folds 
taluk_00: folds 
MahSandrs: calls 800
Lunxspy: checks 
*** FLOP *** [3c Qd Kd]
MahSandrs: checks 
Lunxspy: checks 
decus1: bets 3200
MahSandrs: folds 
Lunxspy: folds 
Uncalled bet (3200) returned to decus1
decus1 collected 6600 from pot
*** SUMMARY ***
Total pot 6600 | Rake 0 
Board [3c Qd Kd]
Seat 1: 578346 folded before Flop (didn't bet)
Seat 2: IoannisVaios folded before Flop (didn't bet)
Seat 3: decus1 collected (6600)
Seat 4: BuddhA_FP folded before Flop (didn't bet)
Seat 5: Kevin12345Mc folded before Flop (didn't bet)
Seat 6: taluk_00 (button) folded before Flop (didn't bet)
Seat 7: MahSandrs (small blind) folded on the Flop
Seat 8: Lunxspy (big blind) folded on the Flop



PokerStars Hand #254990595026: Tournament #3858857107, $2.45+$2.45+$0.60 USD Hold'em No Limit - Level XIV (800/1600) - 2025/02/22 19:32:42 WET [2025/02/22 14:32:42 ET]
Table '3858857107 71' 8-max Seat #7 is the button
Seat 1: 578346 (21126 in chips, $2.45 bounty) 
Seat 2: IoannisVaios (18323 in chips, $2.45 bounty) 
Seat 3: decus1 (27852 in chips, $3.67 bounty) 
Seat 4: BuddhA_FP (13573 in chips, $2.45 bounty) 
Seat 5: Kevin12345Mc (85567 in chips, $4.89 bounty) 
Seat 6: taluk_00 (20362 in chips, $2.45 bounty) 
Seat 7: MahSandrs (64673 in chips, $3.67 bounty) 
Seat 8: Lunxspy (51029 in chips, $2.45 bounty) 
578346: posts the ante 225
IoannisVaios: posts the ante 225
decus1: posts the ante 225
BuddhA_FP: posts the ante 225
Kevin12345Mc: posts the ante 225
taluk_00: posts the ante 225
MahSandrs: posts the ante 225
Lunxspy: posts the ante 225
Lunxspy: posts small blind 800
578346: posts big blind 1600
*** HOLE CARDS ***
Dealt to Kevin12345Mc [3s 2d]
IoannisVaios: folds 
decus1: folds 
BuddhA_FP: folds 
Kevin12345Mc: folds 
taluk_00: folds 
MahSandrs: folds 
Lunxspy: calls 800
578346: checks 
*** FLOP *** [Ac 8c 6h]
Lunxspy: bets 1600
578346: folds 
Uncalled bet (1600) returned to Lunxspy
Lunxspy collected 5000 from pot
*** SUMMARY ***
Total pot 5000 | Rake 0 
Board [Ac 8c 6h]
Seat 1: 578346 (big blind) folded on the Flop
Seat 2: IoannisVaios folded before Flop (didn't bet)
Seat 3: decus1 folded before Flop (didn't bet)
Seat 4: BuddhA_FP folded before Flop (didn't bet)
Seat 5: Kevin12345Mc folded before Flop (didn't bet)
Seat 6: taluk_00 folded before Flop (didn't bet)
Seat 7: MahSandrs (button) folded before Flop (didn't bet)
Seat 8: Lunxspy (small blind) collected (5000)



PokerStars Hand #254990601483: Tournament #3858857107, $2.45+$2.45+$0.60 USD Hold'em No Limit - Level XIV (800/1600) - 2025/02/22 19:33:05 WET [2025/02/22 14:33:05 ET]
Table '3858857107 71' 8-max Seat #8 is the button
Seat 1: 578346 (19301 in chips, $2.45 bounty) 
Seat 2: IoannisVaios (18098 in chips, $2.45 bounty) 
Seat 3: decus1 (27627 in chips, $3.67 bounty) 
Seat 4: BuddhA_FP (13348 in chips, $2.45 bounty) 
Seat 5: Kevin12345Mc (85342 in chips, $4.89 bounty) 
Seat 6: taluk_00 (20137 in chips, $2.45 bounty) 
Seat 7: MahSandrs (64448 in chips, $3.67 bounty) 
Seat 8: Lunxspy (54204 in chips, $2.45 bounty) 
578346: posts the ante 225
IoannisVaios: posts the ante 225
decus1: posts the ante 225
BuddhA_FP: posts the ante 225
Kevin12345Mc: posts the ante 225
taluk_00: posts the ante 225
MahSandrs: posts the ante 225
Lunxspy: posts the ante 225
578346: posts small blind 800
IoannisVaios: posts big blind 1600
*** HOLE CARDS ***
Dealt to Kevin12345Mc [Kd Ac]
decus1: folds 
BuddhA_FP: folds 
Kevin12345Mc: raises 2080 to 3680
taluk_00: folds 
MahSandrs: folds 
Lunxspy: calls 3680
578346: folds 
IoannisVaios: calls 2080
*** FLOP *** [3h Kc Ks]
IoannisVaios: checks 
Kevin12345Mc: checks 
Lunxspy: checks 
*** TURN *** [3h Kc Ks] [2s]
IoannisVaios: checks 
Kevin12345Mc: bets 4501
Lunxspy: calls 4501
IoannisVaios: folds 
*** RIVER *** [3h Kc Ks 2s] [3d]
Kevin12345Mc: bets 11321
Lunxspy: calls 11321
*** SHOW DOWN ***
Kevin12345Mc: shows [Kd Ac] (a full house, Kings full of Threes)
Lunxspy: mucks hand 
Kevin12345Mc collected 45284 from pot
*** SUMMARY ***
Total pot 45284 | Rake 0 
Board [3h Kc Ks 2s 3d]
Seat 1: 578346 (small blind) folded before Flop
Seat 2: IoannisVaios (big blind) folded on the Turn
Seat 3: decus1 folded before Flop (didn't bet)
Seat 4: BuddhA_FP folded before Flop (didn't bet)
Seat 5: Kevin12345Mc showed [Kd Ac] and won (45284) with a full house, Kings full of Threes
Seat 6: taluk_00 folded before Flop (didn't bet)
Seat 7: MahSandrs folded before Flop (didn't bet)
Seat 8: Lunxspy (button) mucked [9h Ah]



PokerStars Hand #254990616798: Tournament #3858857107, $2.45+$2.45+$0.60 USD Hold'em No Limit - Level XIV (800/1600) - 2025/02/22 19:33:59 WET [2025/02/22 14:33:59 ET]
Table '3858857107 71' 8-max Seat #1 is the button
Seat 1: 578346 (18276 in chips, $2.45 bounty) 
Seat 2: IoannisVaios (14193 in chips, $2.45 bounty) 
Seat 3: decus1 (27402 in chips, $3.67 bounty) 
Seat 4: BuddhA_FP (13123 in chips, $2.45 bounty) 
Seat 5: Kevin12345Mc (110899 in chips, $4.89 bounty) 
Seat 6: taluk_00 (19912 in chips, $2.45 bounty) 
Seat 7: MahSandrs (64223 in chips, $3.67 bounty) 
Seat 8: Lunxspy (34477 in chips, $2.45 bounty) 
578346: posts the ante 225
IoannisVaios: posts the ante 225
decus1: posts the ante 225
BuddhA_FP: posts the ante 225
Kevin12345Mc: posts the ante 225
taluk_00: posts the ante 225
MahSandrs: posts the ante 225
Lunxspy: posts the ante 225
IoannisVaios: posts small blind 800
decus1: posts big blind 1600
*** HOLE CARDS ***
Dealt to Kevin12345Mc [Kh Qd]
BuddhA_FP: folds 
Kevin12345Mc: raises 2080 to 3680
taluk_00: folds 
MahSandrs: raises 7360 to 11040
Lunxspy: calls 11040
578346: folds 
IoannisVaios: folds 
decus1: folds 
Kevin12345Mc: calls 7360
*** FLOP *** [Th 9h 7s]
Kevin12345Mc: checks 
MahSandrs: bets 12304
Lunxspy: calls 12304
Kevin12345Mc: calls 12304
*** TURN *** [Th 9h 7s] [4h]
Kevin12345Mc: checks 
MahSandrs: bets 40654 and is all-in
Lunxspy: calls 10908 and is all-in
Kevin12345Mc: folds 
Uncalled bet (29746) returned to MahSandrs
*** RIVER *** [Th 9h 7s 4h] [8s]
*** SHOW DOWN ***
MahSandrs: shows [Ad Ah] (a pair of Aces)
Lunxspy: shows [Ks 6s] (a straight, Six to Ten)
Lunxspy collected 96048 from pot
*** SUMMARY ***
Total pot 96048 | Rake 0 
Board [Th 9h 7s 4h 8s]
Seat 1: 578346 (button) folded before Flop (didn't bet)
Seat 2: IoannisVaios (small blind) folded before Flop
Seat 3: decus1 (big blind) folded before Flop
Seat 4: BuddhA_FP folded before Flop (didn't bet)
Seat 5: Kevin12345Mc folded on the Turn
Seat 6: taluk_00 folded before Flop (didn't bet)
Seat 7: MahSandrs showed [Ad Ah] and lost with a pair of Aces
Seat 8: Lunxspy showed [Ks 6s] and won (96048) with a straight, Six to Ten



PokerStars Hand #254990637952: Tournament #3858857107, $2.45+$2.45+$0.60 USD Hold'em No Limit - Level XIV (800/1600) - 2025/02/22 19:35:14 WET [2025/02/22 14:35:14 ET]
Table '3858857107 71' 8-max Seat #2 is the button
Seat 1: 578346 (18051 in chips, $2.45 bounty) 
Seat 2: IoannisVaios (13168 in chips, $2.45 bounty) 
Seat 3: decus1 (25577 in chips, $3.67 bounty) 
Seat 4: BuddhA_FP (12898 in chips, $2.45 bounty) 
Seat 5: Kevin12345Mc (87330 in chips, $4.89 bounty) 
Seat 6: taluk_00 (19687 in chips, $2.45 bounty) 
Seat 7: MahSandrs (29746 in chips, $3.67 bounty) 
Seat 8: Lunxspy (96048 in chips, $2.45 bounty) 
578346: posts the ante 225
IoannisVaios: posts the ante 225
decus1: posts the ante 225
BuddhA_FP: posts the ante 225
Kevin12345Mc: posts the ante 225
taluk_00: posts the ante 225
MahSandrs: posts the ante 225
Lunxspy: posts the ante 225
decus1: posts small blind 800
BuddhA_FP: posts big blind 1600
*** HOLE CARDS ***
Dealt to Kevin12345Mc [Js 2d]
Kevin12345Mc: folds 
taluk_00: folds 
MahSandrs: folds 
Lunxspy: raises 1776 to 3376
578346: folds 
IoannisVaios: raises 9567 to 12943 and is all-in
decus1: folds 
BuddhA_FP: folds 
Lunxspy: calls 9567
*** FLOP *** [Ac Td Kh]
*** TURN *** [Ac Td Kh] [3h]
*** RIVER *** [Ac Td Kh 3h] [Ad]
*** SHOW DOWN ***
Lunxspy: shows [Jd 9d] (a pair of Aces)
IoannisVaios: shows [Qc Qd] (two pair, Aces and Queens)
IoannisVaios collected 30086 from pot
*** SUMMARY ***
Total pot 30086 | Rake 0 
Board [Ac Td Kh 3h Ad]
Seat 1: 578346 folded before Flop (didn't bet)
Seat 2: IoannisVaios (button) showed [Qc Qd] and won (30086) with two pair, Aces and Queens
Seat 3: decus1 (small blind) folded before Flop
Seat 4: BuddhA_FP (big blind) folded before Flop
Seat 5: Kevin12345Mc folded before Flop (didn't bet)
Seat 6: taluk_00 folded before Flop (didn't bet)
Seat 7: MahSandrs folded before Flop (didn't bet)
Seat 8: Lunxspy showed [Jd 9d] and lost with a pair of Aces



PokerStars Hand #254990647138: Tournament #3858857107, $2.45+$2.45+$0.60 USD Hold'em No Limit - Level XIV (800/1600) - 2025/02/22 19:35:47 WET [2025/02/22 14:35:47 ET]
Table '3858857107 71' 8-max Seat #3 is the button
Seat 1: 578346 (17826 in chips, $2.45 bounty) 
Seat 2: IoannisVaios (30086 in chips, $2.45 bounty) 
Seat 3: decus1 (24552 in chips, $3.67 bounty) 
Seat 4: BuddhA_FP (11073 in chips, $2.45 bounty) 
Seat 5: Kevin12345Mc (87105 in chips, $4.89 bounty) 
Seat 6: taluk_00 (19462 in chips, $2.45 bounty) 
Seat 7: MahSandrs (29521 in chips, $3.67 bounty) 
Seat 8: Lunxspy (82880 in chips, $2.45 bounty) 
578346: posts the ante 225
IoannisVaios: posts the ante 225
decus1: posts the ante 225
BuddhA_FP: posts the ante 225
Kevin12345Mc: posts the ante 225
taluk_00: posts the ante 225
MahSandrs: posts the ante 225
Lunxspy: posts the ante 225
BuddhA_FP: posts small blind 800
Kevin12345Mc: posts big blind 1600
*** HOLE CARDS ***
Dealt to Kevin12345Mc [Qs 7h]
taluk_00: folds 
MahSandrs: folds 
Lunxspy: folds 
578346: folds 
IoannisVaios: folds 
decus1: folds 
Lunxspy is sitting out
BuddhA_FP: raises 9248 to 10848 and is all-in
Lunxspy has returned
Kevin12345Mc: calls 9248
*** FLOP *** [Ac 5s 3c]
*** TURN *** [Ac 5s 3c] [8c]
*** RIVER *** [Ac 5s 3c 8c] [Jh]
*** SHOW DOWN ***
BuddhA_FP: shows [Ah 2h] (a pair of Aces)
Kevin12345Mc: shows [Qs 7h] (high card Ace)
BuddhA_FP collected 23496 from pot
*** SUMMARY ***
Total pot 23496 | Rake 0 
Board [Ac 5s 3c 8c Jh]
Seat 1: 578346 folded before Flop (didn't bet)
Seat 2: IoannisVaios folded before Flop (didn't bet)
Seat 3: decus1 (button) folded before Flop (didn't bet)
Seat 4: BuddhA_FP (small blind) showed [Ah 2h] and won (23496) with a pair of Aces
Seat 5: Kevin12345Mc (big blind) showed [Qs 7h] and lost with high card Ace
Seat 6: taluk_00 folded before Flop (didn't bet)
Seat 7: MahSandrs folded before Flop (didn't bet)
Seat 8: Lunxspy folded before Flop (didn't bet)



PokerStars Hand #254990659226: Tournament #3858857107, $2.45+$2.45+$0.60 USD Hold'em No Limit - Level XIV (800/1600) - 2025/02/22 19:36:30 WET [2025/02/22 14:36:30 ET]
Table '3858857107 71' 8-max Seat #4 is the button
Seat 1: 578346 (17601 in chips, $2.45 bounty) 
Seat 2: IoannisVaios (29861 in chips, $2.45 bounty) 
Seat 3: decus1 (24327 in chips, $3.67 bounty) 
Seat 4: BuddhA_FP (23496 in chips, $2.45 bounty) 
Seat 5: Kevin12345Mc (76032 in chips, $4.89 bounty) 
Seat 6: taluk_00 (19237 in chips, $2.45 bounty) 
Seat 7: MahSandrs (29296 in chips, $3.67 bounty) 
Seat 8: Lunxspy (82655 in chips, $2.45 bounty) 
578346: posts the ante 225
IoannisVaios: posts the ante 225
decus1: posts the ante 225
BuddhA_FP: posts the ante 225
Kevin12345Mc: posts the ante 225
taluk_00: posts the ante 225
MahSandrs: posts the ante 225
Lunxspy: posts the ante 225
Kevin12345Mc: posts small blind 800
taluk_00: posts big blind 1600
*** HOLE CARDS ***
Dealt to Kevin12345Mc [Th Qs]
MahSandrs: folds 
Lunxspy: folds 
578346: folds 
IoannisVaios: folds 
decus1: raises 3200 to 4800
BuddhA_FP: folds 
Kevin12345Mc: folds 
taluk_00: calls 3200
*** FLOP *** [8d 3d Jh]
taluk_00: checks 
decus1: bets 19302 and is all-in
taluk_00: calls 14212 and is all-in
Uncalled bet (5090) returned to decus1
*** TURN *** [8d 3d Jh] [8h]
*** RIVER *** [8d 3d Jh 8h] [6s]
*** SHOW DOWN ***
taluk_00: shows [9d Tc] (a pair of Eights)
decus1: shows [Kh Ks] (two pair, Kings and Eights)
decus1 collected 40624 from pot
decus1 wins $1.23 for eliminating taluk_00 and their own bounty increases by $1.22 to $4.89
taluk_00 finished the tournament in 1597th place
*** SUMMARY ***
Total pot 40624 | Rake 0 
Board [8d 3d Jh 8h 6s]
Seat 1: 578346 folded before Flop (didn't bet)
Seat 2: IoannisVaios folded before Flop (didn't bet)
Seat 3: decus1 showed [Kh Ks] and won (40624) with two pair, Kings and Eights
Seat 4: BuddhA_FP (button) folded before Flop (didn't bet)
Seat 5: Kevin12345Mc (small blind) folded before Flop
Seat 6: taluk_00 (big blind) showed [9d Tc] and lost with a pair of Eights
Seat 7: MahSandrs folded before Flop (didn't bet)
Seat 8: Lunxspy folded before Flop (didn't bet)



PokerStars Hand #254990678488: Tournament #3858857107, $2.45+$2.45+$0.60 USD Hold'em No Limit - Level XIV (800/1600) - 2025/02/22 19:37:39 WET [2025/02/22 14:37:39 ET]
Table '3858857107 71' 8-max Seat #5 is the button
Seat 1: 578346 (17376 in chips, $2.45 bounty) 
Seat 2: IoannisVaios (29636 in chips, $2.45 bounty) 
Seat 3: decus1 (45714 in chips, $4.89 bounty) 
Seat 4: BuddhA_FP (23271 in chips, $2.45 bounty) 
Seat 5: Kevin12345Mc (75007 in chips, $4.89 bounty) 
Seat 7: MahSandrs (29071 in chips, $3.67 bounty) 
Seat 8: Lunxspy (82430 in chips, $2.45 bounty) 
578346: posts the ante 225
IoannisVaios: posts the ante 225
decus1: posts the ante 225
BuddhA_FP: posts the ante 225
Kevin12345Mc: posts the ante 225
MahSandrs: posts the ante 225
Lunxspy: posts the ante 225
MahSandrs: posts small blind 800
Lunxspy: posts big blind 1600
*** HOLE CARDS ***
Dealt to Kevin12345Mc [8d 4d]
578346: folds 
joe_m_27 is disconnected 
IoannisVaios: folds 
decus1: folds 
BuddhA_FP: calls 1600
Kevin12345Mc: folds 
MahSandrs: folds 
Lunxspy: checks 
*** FLOP *** [3s 4h As]
Lunxspy: checks 
BuddhA_FP: bets 1788
Lunxspy: raises 1788 to 3576
BuddhA_FP: folds 
Uncalled bet (1788) returned to Lunxspy
Lunxspy collected 9151 from pot
*** SUMMARY ***
Total pot 9151 | Rake 0 
Board [3s 4h As]
Seat 1: 578346 folded before Flop (didn't bet)
Seat 2: IoannisVaios folded before Flop (didn't bet)
Seat 3: decus1 folded before Flop (didn't bet)
Seat 4: BuddhA_FP folded on the Flop
Seat 5: Kevin12345Mc (button) folded before Flop (didn't bet)
Seat 7: MahSandrs (small blind) folded before Flop
Seat 8: Lunxspy (big blind) collected (9151)



PokerStars Hand #254990692816: Tournament #3858857107, $2.45+$2.45+$0.60 USD Hold'em No Limit - Level XV (900/1800) - 2025/02/22 19:38:30 WET [2025/02/22 14:38:30 ET]
Table '3858857107 71' 8-max Seat #7 is the button
Seat 1: 578346 (17151 in chips, $2.45 bounty) 
Seat 2: IoannisVaios (29411 in chips, $2.45 bounty) 
Seat 3: decus1 (45489 in chips, $4.89 bounty) 
Seat 4: BuddhA_FP (19658 in chips, $2.45 bounty) 
Seat 5: Kevin12345Mc (74782 in chips, $4.89 bounty) 
Seat 6: joe_m_27 (45350 in chips, $2.45 bounty) 
Seat 7: MahSandrs (28046 in chips, $3.67 bounty) 
Seat 8: Lunxspy (87968 in chips, $2.45 bounty) 
578346: posts the ante 250
IoannisVaios: posts the ante 250
decus1: posts the ante 250
BuddhA_FP: posts the ante 250
Kevin12345Mc: posts the ante 250
joe_m_27: posts the ante 250
MahSandrs: posts the ante 250
Lunxspy: posts the ante 250
Lunxspy: posts small blind 900
578346: posts big blind 1800
*** HOLE CARDS ***
Dealt to Kevin12345Mc [9h 4d]
IoannisVaios: folds 
decus1: folds 
BuddhA_FP: folds 
Kevin12345Mc: folds 
joe_m_27: calls 1800
MahSandrs: folds 
Lunxspy: calls 900
578346: raises 15101 to 16901 and is all-in
joe_m_27: raises 28199 to 45100 and is all-in
Lunxspy: folds 
Uncalled bet (28199) returned to joe_m_27
*** FLOP *** [7h Ad Kc]
*** TURN *** [7h Ad Kc] [2s]
*** RIVER *** [7h Ad Kc 2s] [3h]
*** SHOW DOWN ***
578346: shows [As 4s] (a pair of Aces)
joe_m_27: shows [5d 5h] (a pair of Fives)
578346 collected 37602 from pot
*** SUMMARY ***
Total pot 37602 | Rake 0 
Board [7h Ad Kc 2s 3h]
Seat 1: 578346 (big blind) showed [As 4s] and won (37602) with a pair of Aces
Seat 2: IoannisVaios folded before Flop (didn't bet)
Seat 3: decus1 folded before Flop (didn't bet)
Seat 4: BuddhA_FP folded before Flop (didn't bet)
Seat 5: Kevin12345Mc folded before Flop (didn't bet)
Seat 6: joe_m_27 showed [5d 5h] and lost with a pair of Fives
Seat 7: MahSandrs (button) folded before Flop (didn't bet)
Seat 8: Lunxspy (small blind) folded before Flop



PokerStars Hand #254990701276: Tournament #3858857107, $2.45+$2.45+$0.60 USD Hold'em No Limit - Level XV (900/1800) - 2025/02/22 19:39:00 WET [2025/02/22 14:39:00 ET]
Table '3858857107 71' 8-max Seat #8 is the button
Seat 1: 578346 (37602 in chips, $2.45 bounty) 
Seat 2: IoannisVaios (29161 in chips, $2.45 bounty) 
Seat 3: decus1 (45239 in chips, $4.89 bounty) 
Seat 4: BuddhA_FP (19408 in chips, $2.45 bounty) 
Seat 5: Kevin12345Mc (74532 in chips, $4.89 bounty) 
Seat 6: joe_m_27 (28199 in chips, $2.45 bounty) 
Seat 7: MahSandrs (27796 in chips, $3.67 bounty) 
Seat 8: Lunxspy (85918 in chips, $2.45 bounty) 
578346: posts the ante 250
IoannisVaios: posts the ante 250
decus1: posts the ante 250
BuddhA_FP: posts the ante 250
Kevin12345Mc: posts the ante 250
joe_m_27: posts the ante 250
MahSandrs: posts the ante 250
Lunxspy: posts the ante 250
578346: posts small blind 900
IoannisVaios: posts big blind 1800
*** HOLE CARDS ***
Dealt to Kevin12345Mc [2h Ad]
decus1: folds 
BuddhA_FP: folds 
Kevin12345Mc: folds 
joe_m_27: folds 
MahSandrs: folds 
Lunxspy: raises 3366 to 5166
578346: folds 
IoannisVaios: folds 
Uncalled bet (3366) returned to Lunxspy
Lunxspy collected 6500 from pot
*** SUMMARY ***
Total pot 6500 | Rake 0 
Seat 1: 578346 (small blind) folded before Flop
Seat 2: IoannisVaios (big blind) folded before Flop
Seat 3: decus1 folded before Flop (didn't bet)
Seat 4: BuddhA_FP folded before Flop (didn't bet)
Seat 5: Kevin12345Mc folded before Flop (didn't bet)
Seat 6: joe_m_27 folded before Flop (didn't bet)
Seat 7: MahSandrs folded before Flop (didn't bet)
Seat 8: Lunxspy (button) collected (6500)



PokerStars Hand #254990711418: Tournament #3858857107, $2.45+$2.45+$0.60 USD Hold'em No Limit - Level XV (900/1800) - 2025/02/22 19:39:37 WET [2025/02/22 14:39:37 ET]
Table '3858857107 71' 8-max Seat #1 is the button
Seat 1: 578346 (36452 in chips, $2.45 bounty) 
Seat 2: IoannisVaios (27111 in chips, $2.45 bounty) 
Seat 3: decus1 (44989 in chips, $4.89 bounty) 
Seat 4: BuddhA_FP (19158 in chips, $2.45 bounty) 
Seat 5: Kevin12345Mc (74282 in chips, $4.89 bounty) 
Seat 6: joe_m_27 (27949 in chips, $2.45 bounty) 
Seat 7: MahSandrs (27546 in chips, $3.67 bounty) 
Seat 8: Lunxspy (90368 in chips, $2.45 bounty) 
578346: posts the ante 250
IoannisVaios: posts the ante 250
decus1: posts the ante 250
BuddhA_FP: posts the ante 250
Kevin12345Mc: posts the ante 250
joe_m_27: posts the ante 250
MahSandrs: posts the ante 250
Lunxspy: posts the ante 250
IoannisVaios: posts small blind 900
decus1: posts big blind 1800
*** HOLE CARDS ***
Dealt to Kevin12345Mc [2c Qd]
BuddhA_FP: folds 
Kevin12345Mc: folds 
joe_m_27: calls 1800
MahSandrs: folds 
Lunxspy: calls 1800
578346: folds 
IoannisVaios: folds 
decus1: checks 
*** FLOP *** [3s 9h 7h]
decus1: checks 
joe_m_27: bets 1800
Lunxspy: raises 3927 to 5727
decus1: folds 
joe_m_27: folds 
Uncalled bet (3927) returned to Lunxspy
Lunxspy collected 11900 from pot
*** SUMMARY ***
Total pot 11900 | Rake 0 
Board [3s 9h 7h]
Seat 1: 578346 (button) folded before Flop (didn't bet)
Seat 2: IoannisVaios (small blind) folded before Flop
Seat 3: decus1 (big blind) folded on the Flop
Seat 4: BuddhA_FP folded before Flop (didn't bet)
Seat 5: Kevin12345Mc folded before Flop (didn't bet)
Seat 6: joe_m_27 folded on the Flop
Seat 7: MahSandrs folded before Flop (didn't bet)
Seat 8: Lunxspy collected (11900)



PokerStars Hand #254990724946: Tournament #3858857107, $2.45+$2.45+$0.60 USD Hold'em No Limit - Level XV (900/1800) - 2025/02/22 19:40:25 WET [2025/02/22 14:40:25 ET]
Table '3858857107 71' 8-max Seat #2 is the button
Seat 1: 578346 (36202 in chips, $2.45 bounty) 
Seat 2: IoannisVaios (25961 in chips, $2.45 bounty) 
Seat 3: decus1 (42939 in chips, $4.89 bounty) 
Seat 4: BuddhA_FP (18908 in chips, $2.45 bounty) 
Seat 5: Kevin12345Mc (74032 in chips, $4.89 bounty) 
Seat 6: joe_m_27 (24099 in chips, $2.45 bounty) 
Seat 7: MahSandrs (27296 in chips, $3.67 bounty) 
Seat 8: Lunxspy (98418 in chips, $2.45 bounty) 
578346: posts the ante 250
IoannisVaios: posts the ante 250
decus1: posts the ante 250
BuddhA_FP: posts the ante 250
Kevin12345Mc: posts the ante 250
joe_m_27: posts the ante 250
MahSandrs: posts the ante 250
Lunxspy: posts the ante 250
decus1: posts small blind 900
BuddhA_FP: posts big blind 1800
*** HOLE CARDS ***
Dealt to Kevin12345Mc [2s 8s]
Kevin12345Mc: folds 
joe_m_27: folds 
MahSandrs: folds 
Lunxspy: raises 1998 to 3798
578346: folds 
IoannisVaios: folds 
decus1: folds 
BuddhA_FP: calls 1998
*** FLOP *** [8d 3c 3h]
BuddhA_FP: checks 
Lunxspy: bets 4513
BuddhA_FP: raises 10347 to 14860 and is all-in
Lunxspy: calls 10347
*** TURN *** [8d 3c 3h] [6h]
*** RIVER *** [8d 3c 3h 6h] [2h]
*** SHOW DOWN ***
BuddhA_FP: shows [4d 4h] (two pair, Fours and Threes)
Lunxspy: shows [As 8c] (two pair, Eights and Threes)
Lunxspy collected 40216 from pot
Lunxspy wins $1.23 for eliminating BuddhA_FP and their own bounty increases by $1.22 to $3.67
BuddhA_FP finished the tournament in 1496th place
*** SUMMARY ***
Total pot 40216 | Rake 0 
Board [8d 3c 3h 6h 2h]
Seat 1: 578346 folded before Flop (didn't bet)
Seat 2: IoannisVaios (button) folded before Flop (didn't bet)
Seat 3: decus1 (small blind) folded before Flop
Seat 4: BuddhA_FP (big blind) showed [4d 4h] and lost with two pair, Fours and Threes
Seat 5: Kevin12345Mc folded before Flop (didn't bet)
Seat 6: joe_m_27 folded before Flop (didn't bet)
Seat 7: MahSandrs folded before Flop (didn't bet)
Seat 8: Lunxspy showed [As 8c] and won (40216) with two pair, Eights and Threes



PokerStars Hand #254990739067: Tournament #3858857107, $2.45+$2.45+$0.60 USD Hold'em No Limit - Level XV (900/1800) - 2025/02/22 19:41:15 WET [2025/02/22 14:41:15 ET]
Table '3858857107 71' 8-max Seat #3 is the button
Seat 1: 578346 (35952 in chips, $2.45 bounty) 
Seat 2: IoannisVaios (25711 in chips, $2.45 bounty) 
Seat 3: decus1 (41789 in chips, $4.89 bounty) 
Seat 5: Kevin12345Mc (73782 in chips, $4.89 bounty) 
Seat 6: joe_m_27 (23849 in chips, $2.45 bounty) 
Seat 7: MahSandrs (27046 in chips, $3.67 bounty) 
Seat 8: Lunxspy (119726 in chips, $3.67 bounty) 
578346: posts the ante 250
IoannisVaios: posts the ante 250
decus1: posts the ante 250
Kevin12345Mc: posts the ante 250
joe_m_27: posts the ante 250
MahSandrs: posts the ante 250
Lunxspy: posts the ante 250
Kevin12345Mc: posts small blind 900
joe_m_27: posts big blind 1800
*** HOLE CARDS ***
Dealt to Kevin12345Mc [9d Kh]
MahSandrs: raises 1800 to 3600
Lunxspy: calls 3600
578346: folds 
IoannisVaios: folds 
decus1: folds 
Kevin12345Mc: folds 
joe_m_27: folds 
*** FLOP *** [3c Ts 9s]
MahSandrs: checks 
Lunxspy: checks 
*** TURN *** [3c Ts 9s] [4s]
MahSandrs: checks 
Lunxspy: bets 1800
MahSandrs: calls 1800
*** RIVER *** [3c Ts 9s 4s] [8s]
MahSandrs: checks 
Lunxspy: checks 
*** SHOW DOWN ***
MahSandrs: shows [Js Ad] (a flush, Jack high)
Lunxspy: mucks hand 
MahSandrs collected 15250 from pot
*** SUMMARY ***
Total pot 15250 | Rake 0 
Board [3c Ts 9s 4s 8s]
Seat 1: 578346 folded before Flop (didn't bet)
Seat 2: IoannisVaios folded before Flop (didn't bet)
Seat 3: decus1 (button) folded before Flop (didn't bet)
Seat 5: Kevin12345Mc (small blind) folded before Flop
Seat 6: joe_m_27 (big blind) folded before Flop
Seat 7: MahSandrs showed [Js Ad] and won (15250) with a flush, Jack high
Seat 8: Lunxspy mucked [Ac 7c]



PokerStars Hand #254990754462: Tournament #3858857107, $2.45+$2.45+$0.60 USD Hold'em No Limit - Level XV (900/1800) - 2025/02/22 19:42:10 WET [2025/02/22 14:42:10 ET]
Table '3858857107 71' 8-max Seat #5 is the button
Seat 1: 578346 (35702 in chips, $2.45 bounty) 
Seat 2: IoannisVaios (25461 in chips, $2.45 bounty) 
Seat 3: decus1 (41539 in chips, $4.89 bounty) 
Seat 4: Zok1989 (29521 in chips, $4.89 bounty) 
Seat 5: Kevin12345Mc (72632 in chips, $4.89 bounty) 
Seat 6: joe_m_27 (21799 in chips, $2.45 bounty) 
Seat 7: MahSandrs (36646 in chips, $3.67 bounty) 
Seat 8: Lunxspy (114076 in chips, $3.67 bounty) 
578346: posts the ante 250
IoannisVaios: posts the ante 250
decus1: posts the ante 250
Zok1989: posts the ante 250
Kevin12345Mc: posts the ante 250
joe_m_27: posts the ante 250
MahSandrs: posts the ante 250
Lunxspy: posts the ante 250
joe_m_27: posts small blind 900
MahSandrs: posts big blind 1800
*** HOLE CARDS ***
Dealt to Kevin12345Mc [3d 5s]
Lunxspy: raises 1998 to 3798
578346: folds 
IoannisVaios: folds 
decus1: calls 3798
Zok1989: folds 
Kevin12345Mc: folds 
joe_m_27: folds 
MahSandrs: folds 
*** FLOP *** [3h Ah 4d]
Lunxspy: checks 
decus1: checks 
*** TURN *** [3h Ah 4d] [Qh]
Lunxspy: bets 3600
decus1: folds 
Uncalled bet (3600) returned to Lunxspy
Lunxspy collected 12296 from pot
*** SUMMARY ***
Total pot 12296 | Rake 0 
Board [3h Ah 4d Qh]
Seat 1: 578346 folded before Flop (didn't bet)
Seat 2: IoannisVaios folded before Flop (didn't bet)
Seat 3: decus1 folded on the Turn
Seat 4: Zok1989 folded before Flop (didn't bet)
Seat 5: Kevin12345Mc (button) folded before Flop (didn't bet)
Seat 6: joe_m_27 (small blind) folded before Flop
Seat 7: MahSandrs (big blind) folded before Flop
Seat 8: Lunxspy collected (12296)



PokerStars Hand #254990770647: Tournament #3858857107, $2.45+$2.45+$0.60 USD Hold'em No Limit - Level XV (900/1800) - 2025/02/22 19:43:09 WET [2025/02/22 14:43:09 ET]
Table '3858857107 71' 8-max Seat #6 is the button
Seat 1: 578346 (35452 in chips, $2.45 bounty) 
Seat 2: IoannisVaios (25211 in chips, $2.45 bounty) 
Seat 3: decus1 (37491 in chips, $4.89 bounty) 
Seat 4: Zok1989 (29271 in chips, $4.89 bounty) 
Seat 5: Kevin12345Mc (72382 in chips, $4.89 bounty) 
Seat 6: joe_m_27 (20649 in chips, $2.45 bounty) 
Seat 7: MahSandrs (34596 in chips, $3.67 bounty) 
Seat 8: Lunxspy (122324 in chips, $3.67 bounty) 
578346: posts the ante 250
IoannisVaios: posts the ante 250
decus1: posts the ante 250
Zok1989: posts the ante 250
Kevin12345Mc: posts the ante 250
joe_m_27: posts the ante 250
MahSandrs: posts the ante 250
Lunxspy: posts the ante 250
MahSandrs: posts small blind 900
Lunxspy: posts big blind 1800
*** HOLE CARDS ***
Dealt to Kevin12345Mc [9c Kh]
578346: folds 
IoannisVaios: folds 
decus1: folds 
Zok1989: raises 3600 to 5400
Kevin12345Mc: folds 
joe_m_27: folds 
MahSandrs: folds 
Lunxspy: raises 5994 to 11394
Zok1989: raises 17627 to 29021 and is all-in
Lunxspy: calls 17627
*** FLOP *** [Tc 6s 4h]
*** TURN *** [Tc 6s 4h] [2s]
*** RIVER *** [Tc 6s 4h 2s] [7h]
*** SHOW DOWN ***
Lunxspy: shows [Kc Ah] (high card Ace)
Zok1989: shows [Th Ks] (a pair of Tens)
Zok1989 collected 60942 from pot
*** SUMMARY ***
Total pot 60942 | Rake 0 
Board [Tc 6s 4h 2s 7h]
Seat 1: 578346 folded before Flop (didn't bet)
Seat 2: IoannisVaios folded before Flop (didn't bet)
Seat 3: decus1 folded before Flop (didn't bet)
Seat 4: Zok1989 showed [Th Ks] and won (60942) with a pair of Tens
Seat 5: Kevin12345Mc folded before Flop (didn't bet)
Seat 6: joe_m_27 (button) folded before Flop (didn't bet)
Seat 7: MahSandrs (small blind) folded before Flop
Seat 8: Lunxspy (big blind) showed [Kc Ah] and lost with high card Ace



PokerStars Hand #254990782102: Tournament #3858857107, $2.45+$2.45+$0.60 USD Hold'em No Limit - Level XV (900/1800) - 2025/02/22 19:43:50 WET [2025/02/22 14:43:50 ET]
Table '3858857107 71' 8-max Seat #7 is the button
Seat 1: 578346 (35202 in chips, $2.45 bounty) 
Seat 2: IoannisVaios (24961 in chips, $2.45 bounty) 
Seat 3: decus1 (37241 in chips, $4.89 bounty) 
Seat 4: Zok1989 (60942 in chips, $4.89 bounty) 
Seat 5: Kevin12345Mc (72132 in chips, $4.89 bounty) 
Seat 6: joe_m_27 (20399 in chips, $2.45 bounty) 
Seat 7: MahSandrs (33446 in chips, $3.67 bounty) 
Seat 8: Lunxspy (93053 in chips, $3.67 bounty) 
578346: posts the ante 250
IoannisVaios: posts the ante 250
decus1: posts the ante 250
Zok1989: posts the ante 250
Kevin12345Mc: posts the ante 250
joe_m_27: posts the ante 250
MahSandrs: posts the ante 250
Lunxspy: posts the ante 250
Lunxspy: posts small blind 900
578346: posts big blind 1800
*** HOLE CARDS ***
Dealt to Kevin12345Mc [2s 2h]
IoannisVaios: raises 22911 to 24711 and is all-in
decus1: folds 
Zok1989: folds 
Kevin12345Mc: folds 
joe_m_27: folds 
MahSandrs: folds 
Lunxspy: raises 68092 to 92803 and is all-in
578346: folds 
Uncalled bet (68092) returned to Lunxspy
*** FLOP *** [8s 6h Kd]
*** TURN *** [8s 6h Kd] [3c]
*** RIVER *** [8s 6h Kd 3c] [8c]
*** SHOW DOWN ***
Lunxspy: shows [Jd Ac] (a pair of Eights)
IoannisVaios: shows [2d Ad] (a pair of Eights - lower kicker)
Lunxspy collected 53222 from pot
Lunxspy wins $1.23 for eliminating IoannisVaios and their own bounty increases by $1.22 to $4.89
IoannisVaios finished the tournament in 1407th place
*** SUMMARY ***
Total pot 53222 | Rake 0 
Board [8s 6h Kd 3c 8c]
Seat 1: 578346 (big blind) folded before Flop
Seat 2: IoannisVaios showed [2d Ad] and lost with a pair of Eights
Seat 3: decus1 folded before Flop (didn't bet)
Seat 4: Zok1989 folded before Flop (didn't bet)
Seat 5: Kevin12345Mc folded before Flop (didn't bet)
Seat 6: joe_m_27 folded before Flop (didn't bet)
Seat 7: MahSandrs (button) folded before Flop (didn't bet)
Seat 8: Lunxspy (small blind) showed [Jd Ac] and won (53222) with a pair of Eights



PokerStars Hand #254990790847: Tournament #3858857107, $2.45+$2.45+$0.60 USD Hold'em No Limit - Level XV (900/1800) - 2025/02/22 19:44:21 WET [2025/02/22 14:44:21 ET]
Table '3858857107 71' 8-max Seat #8 is the button
Seat 1: 578346 (33152 in chips, $2.45 bounty) 
Seat 3: decus1 (36991 in chips, $4.89 bounty) 
Seat 4: Zok1989 (60692 in chips, $4.89 bounty) 
Seat 5: Kevin12345Mc (71882 in chips, $4.89 bounty) 
Seat 6: joe_m_27 (20149 in chips, $2.45 bounty) 
Seat 7: MahSandrs (33196 in chips, $3.67 bounty) 
Seat 8: Lunxspy (121314 in chips, $4.89 bounty) 
578346: posts the ante 250
decus1: posts the ante 250
Zok1989: posts the ante 250
Kevin12345Mc: posts the ante 250
joe_m_27: posts the ante 250
MahSandrs: posts the ante 250
Lunxspy: posts the ante 250
578346: posts small blind 900
decus1: posts big blind 1800
*** HOLE CARDS ***
Dealt to Kevin12345Mc [5s 4c]
Zok1989: folds 
Kevin12345Mc: folds 
joe_m_27: folds 
capes99 is disconnected 
MahSandrs: raises 31146 to 32946 and is all-in
Lunxspy: folds 
578346: folds 
decus1: folds 
Uncalled bet (31146) returned to MahSandrs
MahSandrs collected 6250 from pot
MahSandrs: doesn't show hand 
*** SUMMARY ***
Total pot 6250 | Rake 0 
Seat 1: 578346 (small blind) folded before Flop
Seat 3: decus1 (big blind) folded before Flop
Seat 4: Zok1989 folded before Flop (didn't bet)
Seat 5: Kevin12345Mc folded before Flop (didn't bet)
Seat 6: joe_m_27 folded before Flop (didn't bet)
Seat 7: MahSandrs collected (6250)
Seat 8: Lunxspy (button) folded before Flop (didn't bet)



PokerStars Hand #254990797903: Tournament #3858857107, $2.45+$2.45+$0.60 USD Hold'em No Limit - Level XV (900/1800) - 2025/02/22 19:44:46 WET [2025/02/22 14:44:46 ET]
Table '3858857107 71' 8-max Seat #1 is the button
Seat 1: 578346 (32002 in chips, $2.45 bounty) 
Seat 2: capes99 (58376 in chips) out of hand (moved from another table into small blind)
Seat 3: decus1 (34941 in chips, $4.89 bounty) 
Seat 4: Zok1989 (60442 in chips, $4.89 bounty) 
Seat 5: Kevin12345Mc (71632 in chips, $4.89 bounty) 
Seat 6: joe_m_27 (19899 in chips, $2.45 bounty) 
Seat 7: MahSandrs (37396 in chips, $3.67 bounty) 
Seat 8: Lunxspy (121064 in chips, $4.89 bounty) 
capes99 will be allowed to play after the button
578346: posts the ante 250
decus1: posts the ante 250
Zok1989: posts the ante 250
Kevin12345Mc: posts the ante 250
joe_m_27: posts the ante 250
MahSandrs: posts the ante 250
Lunxspy: posts the ante 250
decus1: posts small blind 900
Zok1989: posts big blind 1800
*** HOLE CARDS ***
Dealt to Kevin12345Mc [8c 7h]
Kevin12345Mc: folds 
joe_m_27: folds 
MahSandrs: folds 
Lunxspy: calls 1800
578346: folds 
decus1: calls 900
Zok1989: checks 
*** FLOP *** [Td 6c 9d]
decus1: bets 3575
Zok1989: folds 
Lunxspy: calls 3575
*** TURN *** [Td 6c 9d] [6s]
decus1: bets 3600
Lunxspy: calls 3600
*** RIVER *** [Td 6c 9d 6s] [Qd]
decus1: bets 10750
Lunxspy: folds [9s]
Uncalled bet (10750) returned to decus1
decus1 collected 21500 from pot
*** SUMMARY ***
Total pot 21500 | Rake 0 
Board [Td 6c 9d 6s Qd]
Seat 1: 578346 (button) folded before Flop (didn't bet)
Seat 3: decus1 (small blind) collected (21500)
Seat 4: Zok1989 (big blind) folded on the Flop
Seat 5: Kevin12345Mc folded before Flop (didn't bet)
Seat 6: joe_m_27 folded before Flop (didn't bet)
Seat 7: MahSandrs folded before Flop (didn't bet)
Seat 8: Lunxspy folded on the River



PokerStars Hand #254990820630: Tournament #3858857107, $2.45+$2.45+$0.60 USD Hold'em No Limit - Level XV (900/1800) - 2025/02/22 19:46:08 WET [2025/02/22 14:46:08 ET]
Table '3858857107 71' 8-max Seat #3 is the button
Seat 1: 578346 (31752 in chips, $2.45 bounty) 
Seat 2: capes99 (58376 in chips, $4.89 bounty) 
Seat 3: decus1 (47216 in chips, $4.89 bounty) 
Seat 4: Zok1989 (58392 in chips, $4.89 bounty) 
Seat 5: Kevin12345Mc (71382 in chips, $4.89 bounty) 
Seat 6: joe_m_27 (19649 in chips, $2.45 bounty) 
Seat 7: MahSandrs (37146 in chips, $3.67 bounty) 
Seat 8: Lunxspy (111839 in chips, $4.89 bounty) 
578346: posts the ante 250
capes99: posts the ante 250
decus1: posts the ante 250
Zok1989: posts the ante 250
Kevin12345Mc: posts the ante 250
joe_m_27: posts the ante 250
MahSandrs: posts the ante 250
Lunxspy: posts the ante 250
Zok1989: posts small blind 900
Kevin12345Mc: posts big blind 1800
*** HOLE CARDS ***
Dealt to Kevin12345Mc [9h 9s]
joe_m_27: folds 
MahSandrs: folds 
Lunxspy: folds 
578346: calls 1800
capes99: folds 
decus1: folds 
Zok1989: calls 900
Kevin12345Mc: raises 5940 to 7740
578346: folds 
Zok1989: folds 
Uncalled bet (5940) returned to Kevin12345Mc
Kevin12345Mc collected 7400 from pot
Kevin12345Mc: doesn't show hand 
*** SUMMARY ***
Total pot 7400 | Rake 0 
Seat 1: 578346 folded before Flop
Seat 2: capes99 folded before Flop (didn't bet)
Seat 3: decus1 (button) folded before Flop (didn't bet)
Seat 4: Zok1989 (small blind) folded before Flop
Seat 5: Kevin12345Mc (big blind) collected (7400)
Seat 6: joe_m_27 folded before Flop (didn't bet)
Seat 7: MahSandrs folded before Flop (didn't bet)
Seat 8: Lunxspy folded before Flop (didn't bet)



PokerStars Hand #254990838394: Tournament #3858857107, $2.45+$2.45+$0.60 USD Hold'em No Limit - Level XVI (1000/2000) - 2025/02/22 19:47:12 WET [2025/02/22 14:47:12 ET]
Table '3858857107 71' 8-max Seat #4 is the button
Seat 1: 578346 (29702 in chips, $2.45 bounty) 
Seat 2: capes99 (58126 in chips, $4.89 bounty) 
Seat 3: decus1 (46966 in chips, $4.89 bounty) 
Seat 4: Zok1989 (56342 in chips, $4.89 bounty) 
Seat 5: Kevin12345Mc (76732 in chips, $4.89 bounty) 
Seat 6: joe_m_27 (19399 in chips, $2.45 bounty) 
Seat 7: MahSandrs (36896 in chips, $3.67 bounty) 
Seat 8: Lunxspy (111589 in chips, $4.89 bounty) 
578346: posts the ante 300
capes99: posts the ante 300
decus1: posts the ante 300
Zok1989: posts the ante 300
Kevin12345Mc: posts the ante 300
joe_m_27: posts the ante 300
MahSandrs: posts the ante 300
Lunxspy: posts the ante 300
Kevin12345Mc: posts small blind 1000
joe_m_27: posts big blind 2000
*** HOLE CARDS ***
Dealt to Kevin12345Mc [8s Tc]
MahSandrs: folds 
Lunxspy: folds 
578346: folds 
capes99: raises 2000 to 4000
decus1: calls 4000
Zok1989: folds 
Kevin12345Mc: folds 
joe_m_27: folds 
*** FLOP *** [4d Qc Ks]
capes99: bets 4422
decus1: folds 
Uncalled bet (4422) returned to capes99
capes99 collected 13400 from pot
capes99: doesn't show hand 
*** SUMMARY ***
Total pot 13400 | Rake 0 
Board [4d Qc Ks]
Seat 1: 578346 folded before Flop (didn't bet)
Seat 2: capes99 collected (13400)
Seat 3: decus1 folded on the Flop
Seat 4: Zok1989 (button) folded before Flop (didn't bet)
Seat 5: Kevin12345Mc (small blind) folded before Flop
Seat 6: joe_m_27 (big blind) folded before Flop
Seat 7: MahSandrs folded before Flop (didn't bet)
Seat 8: Lunxspy folded before Flop (didn't bet)



PokerStars Hand #254990845880: Tournament #3858857107, $2.45+$2.45+$0.60 USD Hold'em No Limit - Level XVI (1000/2000) - 2025/02/22 19:47:39 WET [2025/02/22 14:47:39 ET]
Table '3858857107 71' 8-max Seat #5 is the button
Seat 1: 578346 (29402 in chips, $2.45 bounty) 
Seat 2: capes99 (67226 in chips, $4.89 bounty) 
Seat 3: decus1 (42666 in chips, $4.89 bounty) 
Seat 4: Zok1989 (56042 in chips, $4.89 bounty) 
Seat 5: Kevin12345Mc (75432 in chips, $4.89 bounty) 
Seat 6: joe_m_27 (17099 in chips, $2.45 bounty) 
Seat 7: MahSandrs (36596 in chips, $3.67 bounty) 
Seat 8: Lunxspy (111289 in chips, $4.89 bounty) 
578346: posts the ante 300
capes99: posts the ante 300
decus1: posts the ante 300
Zok1989: posts the ante 300
Kevin12345Mc: posts the ante 300
joe_m_27: posts the ante 300
MahSandrs: posts the ante 300
Lunxspy: posts the ante 300
joe_m_27: posts small blind 1000
MahSandrs: posts big blind 2000
*** HOLE CARDS ***
Dealt to Kevin12345Mc [8d Qc]
Lunxspy: raises 2220 to 4220
578346: folds 
capes99: calls 4220
decus1: folds 
Zok1989: folds 
Kevin12345Mc: folds 
joe_m_27: folds 
MahSandrs: calls 2220
*** FLOP *** [7s 2s 5d]
MahSandrs: checks 
Lunxspy: checks 
capes99: bets 7300
MahSandrs: folds 
Lunxspy: calls 7300
*** TURN *** [7s 2s 5d] [9s]
Lunxspy: checks 
capes99: checks 
*** RIVER *** [7s 2s 5d 9s] [Kc]
Lunxspy: bets 23608
capes99: calls 23608
*** SHOW DOWN ***
Lunxspy: shows [6s 4s] (a flush, Nine high)
capes99: mucks hand 
Lunxspy collected 77876 from pot
*** SUMMARY ***
Total pot 77876 | Rake 0 
Board [7s 2s 5d 9s Kc]
Seat 1: 578346 folded before Flop (didn't bet)
Seat 2: capes99 mucked [7c 7h]
Seat 3: decus1 folded before Flop (didn't bet)
Seat 4: Zok1989 folded before Flop (didn't bet)
Seat 5: Kevin12345Mc (button) folded before Flop (didn't bet)
Seat 6: joe_m_27 (small blind) folded before Flop
Seat 7: MahSandrs (big blind) folded on the Flop
Seat 8: Lunxspy showed [6s 4s] and won (77876) with a flush, Nine high



PokerStars Hand #254990862528: Tournament #3858857107, $2.45+$2.45+$0.60 USD Hold'em No Limit - Level XVI (1000/2000) - 2025/02/22 19:48:39 WET [2025/02/22 14:48:39 ET]
Table '3858857107 71' 8-max Seat #6 is the button
Seat 1: 578346 (29102 in chips, $2.45 bounty) 
Seat 2: capes99 (31798 in chips, $4.89 bounty) 
Seat 3: decus1 (42366 in chips, $4.89 bounty) 
Seat 4: Zok1989 (55742 in chips, $4.89 bounty) 
Seat 5: Kevin12345Mc (75132 in chips, $4.89 bounty) 
Seat 6: joe_m_27 (15799 in chips, $2.45 bounty) 
Seat 7: MahSandrs (32076 in chips, $3.67 bounty) 
Seat 8: Lunxspy (153737 in chips, $4.89 bounty) 
578346: posts the ante 300
capes99: posts the ante 300
decus1: posts the ante 300
Zok1989: posts the ante 300
Kevin12345Mc: posts the ante 300
joe_m_27: posts the ante 300
MahSandrs: posts the ante 300
Lunxspy: posts the ante 300
MahSandrs: posts small blind 1000
Lunxspy: posts big blind 2000
*** HOLE CARDS ***
Dealt to Kevin12345Mc [3c 4c]
578346: folds 
capes99: folds 
decus1: calls 2000
Zok1989: raises 6000 to 8000
Kevin12345Mc: folds 
joe_m_27: folds 
MahSandrs: folds 
Lunxspy: calls 6000
decus1: folds 
*** FLOP *** [Kc 7c Ts]
Lunxspy: checks 
Zok1989: checks 
*** TURN *** [Kc 7c Ts] [Jc]
Lunxspy: bets 2000
Zok1989: calls 2000
*** RIVER *** [Kc 7c Ts Jc] [5s]
Lunxspy: checks 
Zok1989: checks 
*** SHOW DOWN ***
Lunxspy: shows [Td Ah] (a pair of Tens)
Zok1989: shows [Ad Jd] (a pair of Jacks)
Zok1989 collected 25400 from pot
*** SUMMARY ***
Total pot 25400 | Rake 0 
Board [Kc 7c Ts Jc 5s]
Seat 1: 578346 folded before Flop (didn't bet)
Seat 2: capes99 folded before Flop (didn't bet)
Seat 3: decus1 folded before Flop
Seat 4: Zok1989 showed [Ad Jd] and won (25400) with a pair of Jacks
Seat 5: Kevin12345Mc folded before Flop (didn't bet)
Seat 6: joe_m_27 (button) folded before Flop (didn't bet)
Seat 7: MahSandrs (small blind) folded before Flop
Seat 8: Lunxspy (big blind) showed [Td Ah] and lost with a pair of Tens



PokerStars Hand #254990888354: Tournament #3858857107, $2.45+$2.45+$0.60 USD Hold'em No Limit - Level XVI (1000/2000) - 2025/02/22 19:50:12 WET [2025/02/22 14:50:12 ET]
Table '3858857107 71' 8-max Seat #7 is the button
Seat 1: 578346 (28802 in chips, $2.45 bounty) 
Seat 2: capes99 (31498 in chips, $4.89 bounty) 
Seat 3: decus1 (40066 in chips, $4.89 bounty) 
Seat 4: Zok1989 (70842 in chips, $4.89 bounty) 
Seat 5: Kevin12345Mc (74832 in chips, $4.89 bounty) 
Seat 6: joe_m_27 (15499 in chips, $2.45 bounty) 
Seat 7: MahSandrs (30776 in chips, $3.67 bounty) 
Seat 8: Lunxspy (143437 in chips, $4.89 bounty) 
578346: posts the ante 300
capes99: posts the ante 300
decus1: posts the ante 300
Zok1989: posts the ante 300
Kevin12345Mc: posts the ante 300
joe_m_27: posts the ante 300
MahSandrs: posts the ante 300
Lunxspy: posts the ante 300
Lunxspy: posts small blind 1000
578346: posts big blind 2000
*** HOLE CARDS ***
Dealt to Kevin12345Mc [Jc 4d]
capes99: raises 2000 to 4000
decus1: folds 
Zok1989: folds 
Kevin12345Mc: folds 
joe_m_27: folds 
MahSandrs: raises 26476 to 30476 and is all-in
Lunxspy: folds 
578346: folds 
capes99: calls 26476
*** FLOP *** [5s Kh Qh]
*** TURN *** [5s Kh Qh] [9s]
*** RIVER *** [5s Kh Qh 9s] [5d]
*** SHOW DOWN ***
capes99: shows [Ts Ks] (two pair, Kings and Fives)
MahSandrs: shows [8h 8s] (two pair, Eights and Fives)
capes99 collected 66352 from pot
capes99 wins $1.84 for eliminating MahSandrs and their own bounty increases by $1.83 to $6.72
MahSandrs finished the tournament in 1253rd place
*** SUMMARY ***
Total pot 66352 | Rake 0 
Board [5s Kh Qh 9s 5d]
Seat 1: 578346 (big blind) folded before Flop
Seat 2: capes99 showed [Ts Ks] and won (66352) with two pair, Kings and Fives
Seat 3: decus1 folded before Flop (didn't bet)
Seat 4: Zok1989 folded before Flop (didn't bet)
Seat 5: Kevin12345Mc folded before Flop (didn't bet)
Seat 6: joe_m_27 folded before Flop (didn't bet)
Seat 7: MahSandrs (button) showed [8h 8s] and lost with two pair, Eights and Fives
Seat 8: Lunxspy (small blind) folded before Flop



PokerStars Hand #254990900247: Tournament #3858857107, $2.45+$2.45+$0.60 USD Hold'em No Limit - Level XVI (1000/2000) - 2025/02/22 19:50:55 WET [2025/02/22 14:50:55 ET]
Table '3858857107 71' 8-max Seat #8 is the button
Seat 1: 578346 (26502 in chips, $2.45 bounty) 
Seat 2: capes99 (67074 in chips, $6.72 bounty) 
Seat 3: decus1 (39766 in chips, $4.89 bounty) 
Seat 4: Zok1989 (70542 in chips, $4.89 bounty) 
Seat 5: Kevin12345Mc (74532 in chips, $4.89 bounty) 
Seat 6: joe_m_27 (15199 in chips, $2.45 bounty) 
Seat 8: Lunxspy (142137 in chips, $4.89 bounty) 
578346: posts the ante 300
capes99: posts the ante 300
decus1: posts the ante 300
Zok1989: posts the ante 300
Kevin12345Mc: posts the ante 300
joe_m_27: posts the ante 300
Lunxspy: posts the ante 300
578346: posts small blind 1000
capes99: posts big blind 2000
*** HOLE CARDS ***
Dealt to Kevin12345Mc [5c 9h]
GreatVantos is disconnected 
decus1: folds 
Zok1989: folds 
Kevin12345Mc: folds 
joe_m_27: folds 
Lunxspy: raises 2220 to 4220
578346: folds 
capes99: calls 2220
*** FLOP *** [4h Qd 3h]
capes99: checks 
Lunxspy: checks 
*** TURN *** [4h Qd 3h] [Ks]
capes99: checks 
Lunxspy: bets 8886
capes99: folds 
Uncalled bet (8886) returned to Lunxspy
Lunxspy collected 11540 from pot
*** SUMMARY ***
Total pot 11540 | Rake 0 
Board [4h Qd 3h Ks]
Seat 1: 578346 (small blind) folded before Flop
Seat 2: capes99 (big blind) folded on the Turn
Seat 3: decus1 folded before Flop (didn't bet)
Seat 4: Zok1989 folded before Flop (didn't bet)
Seat 5: Kevin12345Mc folded before Flop (didn't bet)
Seat 6: joe_m_27 folded before Flop (didn't bet)
Seat 8: Lunxspy (button) collected (11540)



PokerStars Hand #254990910285: Tournament #3858857107, $2.45+$2.45+$0.60 USD Hold'em No Limit - Level XVI (1000/2000) - 2025/02/22 19:51:31 WET [2025/02/22 14:51:31 ET]
Table '3858857107 71' 8-max Seat #1 is the button
Seat 1: 578346 (25202 in chips, $2.45 bounty) 
Seat 2: capes99 (62554 in chips, $6.72 bounty) 
Seat 3: decus1 (39466 in chips, $4.89 bounty) 
Seat 4: Zok1989 (70242 in chips, $4.89 bounty) 
Seat 5: Kevin12345Mc (74232 in chips, $4.89 bounty) 
Seat 6: joe_m_27 (14899 in chips, $2.45 bounty) 
Seat 7: GreatVantos (64905 in chips, $6.11 bounty) 
Seat 8: Lunxspy (149157 in chips, $4.89 bounty) 
578346: posts the ante 300
capes99: posts the ante 300
decus1: posts the ante 300
Zok1989: posts the ante 300
Kevin12345Mc: posts the ante 300
joe_m_27: posts the ante 300
GreatVantos: posts the ante 300
Lunxspy: posts the ante 300
capes99: posts small blind 1000
decus1: posts big blind 2000
*** HOLE CARDS ***
Dealt to Kevin12345Mc [9d As]
Zok1989: folds 
Kevin12345Mc: folds 
joe_m_27: raises 12599 to 14599 and is all-in
GreatVantos: calls 14599
Lunxspy: folds 
578346: folds 
capes99: folds 
decus1: folds 
*** FLOP *** [4h 7s Kd]
*** TURN *** [4h 7s Kd] [3c]
*** RIVER *** [4h 7s Kd 3c] [Kh]
*** SHOW DOWN ***
joe_m_27: shows [Ac Kc] (three of a kind, Kings)
GreatVantos: shows [3h Ah] (two pair, Kings and Threes)
joe_m_27 collected 34598 from pot
*** SUMMARY ***
Total pot 34598 | Rake 0 
Board [4h 7s Kd 3c Kh]
Seat 1: 578346 (button) folded before Flop (didn't bet)
Seat 2: capes99 (small blind) folded before Flop
Seat 3: decus1 (big blind) folded before Flop
Seat 4: Zok1989 folded before Flop (didn't bet)
Seat 5: Kevin12345Mc folded before Flop (didn't bet)
Seat 6: joe_m_27 showed [Ac Kc] and won (34598) with three of a kind, Kings
Seat 7: GreatVantos showed [3h Ah] and lost with two pair, Kings and Threes
Seat 8: Lunxspy folded before Flop (didn't bet)



PokerStars Hand #254990919784: Tournament #3858857107, $2.45+$2.45+$0.60 USD Hold'em No Limit - Level XVI (1000/2000) - 2025/02/22 19:52:06 WET [2025/02/22 14:52:06 ET]
Table '3858857107 71' 8-max Seat #2 is the button
Seat 1: 578346 (24902 in chips, $2.45 bounty) 
Seat 2: capes99 (61254 in chips, $6.72 bounty) 
Seat 3: decus1 (37166 in chips, $4.89 bounty) 
Seat 4: Zok1989 (69942 in chips, $4.89 bounty) 
Seat 5: Kevin12345Mc (73932 in chips, $4.89 bounty) 
Seat 6: joe_m_27 (34598 in chips, $2.45 bounty) 
Seat 7: GreatVantos (50006 in chips, $6.11 bounty) 
Seat 8: Lunxspy (148857 in chips, $4.89 bounty) 
578346: posts the ante 300
capes99: posts the ante 300
decus1: posts the ante 300
Zok1989: posts the ante 300
Kevin12345Mc: posts the ante 300
joe_m_27: posts the ante 300
GreatVantos: posts the ante 300
Lunxspy: posts the ante 300
decus1: posts small blind 1000
Zok1989: posts big blind 2000
*** HOLE CARDS ***
Dealt to Kevin12345Mc [6c 2s]
Kevin12345Mc: folds 
joe_m_27: folds 
GreatVantos: raises 2000 to 4000
Lunxspy: calls 4000
578346: folds 
capes99: folds 
decus1: folds 
Zok1989: calls 2000
*** FLOP *** [Kh Kd 8h]
Zok1989: checks 
GreatVantos: bets 6000
Lunxspy: calls 6000
Zok1989: folds 
*** TURN *** [Kh Kd 8h] [7c]
GreatVantos: checks 
Lunxspy: bets 6000
GreatVantos: folds 
Uncalled bet (6000) returned to Lunxspy
Lunxspy collected 27400 from pot
*** SUMMARY ***
Total pot 27400 | Rake 0 
Board [Kh Kd 8h 7c]
Seat 1: 578346 folded before Flop (didn't bet)
Seat 2: capes99 (button) folded before Flop (didn't bet)
Seat 3: decus1 (small blind) folded before Flop
Seat 4: Zok1989 (big blind) folded on the Flop
Seat 5: Kevin12345Mc folded before Flop (didn't bet)
Seat 6: joe_m_27 folded before Flop (didn't bet)
Seat 7: GreatVantos folded on the Turn
Seat 8: Lunxspy collected (27400)



PokerStars Hand #254990942839: Tournament #3858857107, $2.45+$2.45+$0.60 USD Hold'em No Limit - Level XVI (1000/2000) - 2025/02/22 19:53:28 WET [2025/02/22 14:53:28 ET]
Table '3858857107 71' 8-max Seat #3 is the button
Seat 1: 578346 (24602 in chips, $2.45 bounty) 
Seat 2: capes99 (60954 in chips, $6.72 bounty) 
Seat 3: decus1 (35866 in chips, $4.89 bounty) 
Seat 4: Zok1989 (65642 in chips, $4.89 bounty) 
Seat 5: Kevin12345Mc (73632 in chips, $4.89 bounty) 
Seat 6: joe_m_27 (34298 in chips, $2.45 bounty) 
Seat 7: GreatVantos (39706 in chips, $6.11 bounty) 
Seat 8: Lunxspy (165957 in chips, $4.89 bounty) 
578346: posts the ante 300
capes99: posts the ante 300
decus1: posts the ante 300
Zok1989: posts the ante 300
Kevin12345Mc: posts the ante 300
joe_m_27: posts the ante 300
GreatVantos: posts the ante 300
Lunxspy: posts the ante 300
Zok1989: posts small blind 1000
Kevin12345Mc: posts big blind 2000
*** HOLE CARDS ***
Dealt to Kevin12345Mc [Js 8d]
joe_m_27: folds 
GreatVantos: folds 
Lunxspy: raises 2220 to 4220
578346: folds 
capes99: folds 
decus1: folds 
Zok1989: folds 
Kevin12345Mc: calls 2220
*** FLOP *** [Th 4d 3s]
Kevin12345Mc: checks 
Lunxspy: bets 5091
Kevin12345Mc: folds 
Uncalled bet (5091) returned to Lunxspy
Lunxspy collected 11840 from pot
*** SUMMARY ***
Total pot 11840 | Rake 0 
Board [Th 4d 3s]
Seat 1: 578346 folded before Flop (didn't bet)
Seat 2: capes99 folded before Flop (didn't bet)
Seat 3: decus1 (button) folded before Flop (didn't bet)
Seat 4: Zok1989 (small blind) folded before Flop
Seat 5: Kevin12345Mc (big blind) folded on the Flop
Seat 6: joe_m_27 folded before Flop (didn't bet)
Seat 7: GreatVantos folded before Flop (didn't bet)
Seat 8: Lunxspy collected (11840)



PokerStars Hand #254990952410: Tournament #3858857107, $2.45+$2.45+$0.60 USD Hold'em No Limit - Level XVI (1000/2000) - 2025/02/22 19:54:03 WET [2025/02/22 14:54:03 ET]
Table '3858857107 71' 8-max Seat #4 is the button
Seat 1: 578346 (24302 in chips, $2.45 bounty) 
Seat 2: capes99 (60654 in chips, $6.72 bounty) 
Seat 3: decus1 (35566 in chips, $4.89 bounty) 
Seat 4: Zok1989 (64342 in chips, $4.89 bounty) 
Seat 5: Kevin12345Mc (69112 in chips, $4.89 bounty) 
Seat 6: joe_m_27 (33998 in chips, $2.45 bounty) 
Seat 7: GreatVantos (39406 in chips, $6.11 bounty) 
Seat 8: Lunxspy (173277 in chips, $4.89 bounty) 
578346: posts the ante 300
capes99: posts the ante 300
decus1: posts the ante 300
Zok1989: posts the ante 300
Kevin12345Mc: posts the ante 300
joe_m_27: posts the ante 300
GreatVantos: posts the ante 300
Lunxspy: posts the ante 300
Kevin12345Mc: posts small blind 1000
joe_m_27: posts big blind 2000
*** HOLE CARDS ***
Dealt to Kevin12345Mc [4h 3h]
GreatVantos: folds 
Lunxspy: folds 
578346: raises 22002 to 24002 and is all-in
capes99: raises 36352 to 60354 and is all-in
decus1: folds 
Zok1989: folds 
Kevin12345Mc: folds 
joe_m_27: folds 
Uncalled bet (36352) returned to capes99
*** FLOP *** [7c 2s Jd]
*** TURN *** [7c 2s Jd] [Tc]
*** RIVER *** [7c 2s Jd Tc] [8h]
*** SHOW DOWN ***
578346: shows [Qh Ac] (high card Ace)
capes99: shows [Ah Kc] (high card Ace - King kicker)
capes99 collected 53404 from pot
capes99 wins $1.23 for eliminating 578346 and their own bounty increases by $1.22 to $7.94
578346 finished the tournament in 1172nd place
*** SUMMARY ***
Total pot 53404 | Rake 0 
Board [7c 2s Jd Tc 8h]
Seat 1: 578346 showed [Qh Ac] and lost with high card Ace
Seat 2: capes99 showed [Ah Kc] and won (53404) with high card Ace
Seat 3: decus1 folded before Flop (didn't bet)
Seat 4: Zok1989 (button) folded before Flop (didn't bet)
Seat 5: Kevin12345Mc (small blind) folded before Flop
Seat 6: joe_m_27 (big blind) folded before Flop
Seat 7: GreatVantos folded before Flop (didn't bet)
Seat 8: Lunxspy folded before Flop (didn't bet)



PokerStars Hand #254990964634: Tournament #3858857107, $2.45+$2.45+$0.60 USD Hold'em No Limit - Level XVII (1250/2500) - 2025/02/22 19:54:48 WET [2025/02/22 14:54:48 ET]
Table '3858857107 71' 8-max Seat #5 is the button
Seat 2: capes99 (89756 in chips, $7.94 bounty) 
Seat 3: decus1 (35266 in chips, $4.89 bounty) 
Seat 4: Zok1989 (64042 in chips, $4.89 bounty) 
Seat 5: Kevin12345Mc (67812 in chips, $4.89 bounty) 
Seat 6: joe_m_27 (31698 in chips, $2.45 bounty) 
Seat 7: GreatVantos (39106 in chips, $6.11 bounty) 
Seat 8: Lunxspy (172977 in chips, $4.89 bounty) 
capes99: posts the ante 350
decus1: posts the ante 350
Zok1989: posts the ante 350
Kevin12345Mc: posts the ante 350
joe_m_27: posts the ante 350
GreatVantos: posts the ante 350
Lunxspy: posts the ante 350
joe_m_27: posts small blind 1250
GreatVantos: posts big blind 2500
*** HOLE CARDS ***
Dealt to Kevin12345Mc [Ks 3d]
Lunxspy: calls 2500
CrispyLuck is disconnected 
capes99 is connected 
capes99 is connected 
capes99: folds 
decus1: folds 
Zok1989: folds 
Kevin12345Mc: folds 
joe_m_27: calls 1250
GreatVantos: raises 36256 to 38756 and is all-in
Lunxspy: folds 
joe_m_27: calls 28848 and is all-in
Uncalled bet (7408) returned to GreatVantos
*** FLOP *** [5c 6d Jc]
*** TURN *** [5c 6d Jc] [Qh]
*** RIVER *** [5c 6d Jc Qh] [8s]
*** SHOW DOWN ***
joe_m_27: shows [Ac Tc] (high card Ace)
GreatVantos: shows [Qd As] (a pair of Queens)
GreatVantos collected 67646 from pot
GreatVantos wins $1.23 for eliminating joe_m_27 and their own bounty increases by $1.22 to $7.33
joe_m_27 finished the tournament in 1153rd place
*** SUMMARY ***
Total pot 67646 | Rake 0 
Board [5c 6d Jc Qh 8s]
Seat 2: capes99 folded before Flop (didn't bet)
Seat 3: decus1 folded before Flop (didn't bet)
Seat 4: Zok1989 folded before Flop (didn't bet)
Seat 5: Kevin12345Mc (button) folded before Flop (didn't bet)
Seat 6: joe_m_27 (small blind) showed [Ac Tc] and lost with high card Ace
Seat 7: GreatVantos (big blind) showed [Qd As] and won (67646) with a pair of Queens
Seat 8: Lunxspy folded before Flop



PokerStars Hand #254991056098: Tournament #3858857107, $2.45+$2.45+$0.60 USD Hold'em No Limit - Level XVII (1250/2500) - 2025/02/22 20:02:12 WET [2025/02/22 15:02:12 ET]
Table '3858857107 78' 8-max Seat #4 is the button
Seat 1: Kevin12345Mc (67462 in chips, $4.89 bounty) 
Seat 2: strongsoler (297361 in chips, $7.03 bounty) 
Seat 3: Ivanmorosov (155382 in chips, $7.94 bounty) 
Seat 4: LeventFL (90121 in chips, $4.89 bounty) 
Seat 5: DonZordon (62338 in chips, $2.45 bounty) 
Seat 6: Grinde123 (89165 in chips, $2.45 bounty) 
Seat 7: paleva88 (67123 in chips, $13.13 bounty) 
Seat 8: zaminhan_jpz (33690 in chips, $4.89 bounty) 
Kevin12345Mc: posts the ante 350
strongsoler: posts the ante 350
Ivanmorosov: posts the ante 350
LeventFL: posts the ante 350
DonZordon: posts the ante 350
Grinde123: posts the ante 350
paleva88: posts the ante 350
zaminhan_jpz: posts the ante 350
DonZordon: posts small blind 1250
Grinde123: posts big blind 2500
*** HOLE CARDS ***
Dealt to Kevin12345Mc [6h 5h]
paleva88: folds 
zaminhan_jpz: raises 30840 to 33340 and is all-in
Kevin12345Mc: folds 
strongsoler: calls 33340
Ivanmorosov: folds 
LeventFL: folds 
DonZordon: folds 
Grinde123: folds 
*** FLOP *** [Ts Ks 3h]
*** TURN *** [Ts Ks 3h] [2h]
*** RIVER *** [Ts Ks 3h 2h] [Js]
*** SHOW DOWN ***
zaminhan_jpz: shows [Qh Th] (a pair of Tens)
strongsoler: shows [Ac Jc] (a pair of Jacks)
strongsoler collected 73230 from pot
strongsoler wins $2.45 for eliminating zaminhan_jpz and their own bounty increases by $2.44 to $9.47
zaminhan_jpz finished the tournament in 1142nd place
*** SUMMARY ***
Total pot 73230 | Rake 0 
Board [Ts Ks 3h 2h Js]
Seat 1: Kevin12345Mc folded before Flop (didn't bet)
Seat 2: strongsoler showed [Ac Jc] and won (73230) with a pair of Jacks
Seat 3: Ivanmorosov folded before Flop (didn't bet)
Seat 4: LeventFL (button) folded before Flop (didn't bet)
Seat 5: DonZordon (small blind) folded before Flop
Seat 6: Grinde123 (big blind) folded before Flop
Seat 7: paleva88 folded before Flop (didn't bet)
Seat 8: zaminhan_jpz showed [Qh Th] and lost with a pair of Tens



PokerStars Hand #254991066655: Tournament #3858857107, $2.45+$2.45+$0.60 USD Hold'em No Limit - Level XVII (1250/2500) - 2025/02/22 20:02:52 WET [2025/02/22 15:02:52 ET]
Table '3858857107 78' 8-max Seat #5 is the button
Seat 1: Kevin12345Mc (67112 in chips, $4.89 bounty) 
Seat 2: strongsoler (336901 in chips, $9.47 bounty) 
Seat 3: Ivanmorosov (155032 in chips, $7.94 bounty) 
Seat 4: LeventFL (89771 in chips, $4.89 bounty) 
Seat 5: DonZordon (60738 in chips, $2.45 bounty) 
Seat 6: Grinde123 (86315 in chips, $2.45 bounty) 
Seat 7: paleva88 (66773 in chips, $13.13 bounty) 
Kevin12345Mc: posts the ante 350
strongsoler: posts the ante 350
Ivanmorosov: posts the ante 350
LeventFL: posts the ante 350
DonZordon: posts the ante 350
Grinde123: posts the ante 350
paleva88: posts the ante 350
Grinde123: posts small blind 1250
paleva88: posts big blind 2500
*** HOLE CARDS ***
Dealt to Kevin12345Mc [Ah Kc]
Kevin12345Mc: raises 2750 to 5250
strongsoler: calls 5250
Ivanmorosov: folds 
LeventFL: folds 
DonZordon: folds 
Grinde123: folds 
paleva88: calls 2750
*** FLOP *** [Qs 4d As]
paleva88: checks 
Kevin12345Mc: bets 6419
strongsoler: calls 6419
paleva88: folds 
*** TURN *** [Qs 4d As] [Qc]
Kevin12345Mc: bets 10655
strongsoler: calls 10655
*** RIVER *** [Qs 4d As Qc] [Qh]
Kevin12345Mc: bets 44438 and is all-in
strongsoler: calls 44438
*** SHOW DOWN ***
Kevin12345Mc: shows [Ah Kc] (a full house, Queens full of Aces)
strongsoler: shows [Ac 5c] (a full house, Queens full of Aces)
Kevin12345Mc collected 71237 from pot
strongsoler collected 71237 from pot
*** SUMMARY ***
Total pot 142474 | Rake 0 
Board [Qs 4d As Qc Qh]
Seat 1: Kevin12345Mc showed [Ah Kc] and won (71237) with a full house, Queens full of Aces
Seat 2: strongsoler showed [Ac 5c] and won (71237) with a full house, Queens full of Aces
Seat 3: Ivanmorosov folded before Flop (didn't bet)
Seat 4: LeventFL folded before Flop (didn't bet)
Seat 5: DonZordon (button) folded before Flop (didn't bet)
Seat 6: Grinde123 (small blind) folded before Flop
Seat 7: paleva88 (big blind) folded on the Flop



PokerStars Hand #254991081613: Tournament #3858857107, $2.45+$2.45+$0.60 USD Hold'em No Limit - Level XVII (1250/2500) - 2025/02/22 20:03:45 WET [2025/02/22 15:03:45 ET]
Table '3858857107 78' 8-max Seat #6 is the button
Seat 1: Kevin12345Mc (71237 in chips, $4.89 bounty) 
Seat 2: strongsoler (341026 in chips, $9.47 bounty) 
Seat 3: Ivanmorosov (154682 in chips, $7.94 bounty) 
Seat 4: LeventFL (89421 in chips, $4.89 bounty) 
Seat 5: DonZordon (60388 in chips, $2.45 bounty) 
Seat 6: Grinde123 (84715 in chips, $2.45 bounty) 
Seat 7: paleva88 (61173 in chips, $13.13 bounty) 
Seat 8: nodnek111 (130485 in chips, $7.94 bounty) is sitting out
Kevin12345Mc: posts the ante 350
strongsoler: posts the ante 350
Ivanmorosov: posts the ante 350
LeventFL: posts the ante 350
DonZordon: posts the ante 350
Grinde123: posts the ante 350
paleva88: posts the ante 350
nodnek111: posts the ante 350
paleva88: posts small blind 1250
nodnek111: posts big blind 2500
*** HOLE CARDS ***
Dealt to Kevin12345Mc [3d Jd]
Kevin12345Mc: folds 
strongsoler: raises 2500 to 5000
Ivanmorosov: folds 
LeventFL: folds 
DonZordon: folds 
Grinde123: folds 
paleva88: folds 
nodnek111: folds 
Uncalled bet (2500) returned to strongsoler
strongsoler collected 9050 from pot
strongsoler: doesn't show hand 
*** SUMMARY ***
Total pot 9050 | Rake 0 
Seat 1: Kevin12345Mc folded before Flop (didn't bet)
Seat 2: strongsoler collected (9050)
Seat 3: Ivanmorosov folded before Flop (didn't bet)
Seat 4: LeventFL folded before Flop (didn't bet)
Seat 5: DonZordon folded before Flop (didn't bet)
Seat 6: Grinde123 (button) folded before Flop (didn't bet)
Seat 7: paleva88 (small blind) folded before Flop
Seat 8: nodnek111 (big blind) folded before Flop



PokerStars Hand #254991088964: Tournament #3858857107, $2.45+$2.45+$0.60 USD Hold'em No Limit - Level XVII (1250/2500) - 2025/02/22 20:04:10 WET [2025/02/22 15:04:10 ET]
Table '3858857107 78' 8-max Seat #7 is the button
Seat 1: Kevin12345Mc (70887 in chips, $4.89 bounty) 
Seat 2: strongsoler (347226 in chips, $9.47 bounty) 
Seat 3: Ivanmorosov (154332 in chips, $7.94 bounty) 
Seat 4: LeventFL (89071 in chips, $4.89 bounty) 
Seat 5: DonZordon (60038 in chips, $2.45 bounty) 
Seat 6: Grinde123 (84365 in chips, $2.45 bounty) 
Seat 7: paleva88 (59573 in chips, $13.13 bounty) 
Seat 8: nodnek111 (127635 in chips, $7.94 bounty) is sitting out
Kevin12345Mc: posts the ante 350
strongsoler: posts the ante 350
Ivanmorosov: posts the ante 350
LeventFL: posts the ante 350
DonZordon: posts the ante 350
Grinde123: posts the ante 350
paleva88: posts the ante 350
nodnek111: posts the ante 350
nodnek111: posts small blind 1250
Kevin12345Mc: posts big blind 2500
*** HOLE CARDS ***
Dealt to Kevin12345Mc [7s Qs]
strongsoler: folds 
Ivanmorosov: folds 
LeventFL: raises 3000 to 5500
DonZordon: folds 
Grinde123: folds 
paleva88: calls 5500
nodnek111: folds 
Kevin12345Mc: calls 3000
*** FLOP *** [8h 6d Ac]
Kevin12345Mc: checks 
LeventFL: bets 6782
paleva88: folds 
Kevin12345Mc: folds 
Uncalled bet (6782) returned to LeventFL
LeventFL collected 20550 from pot
LeventFL: doesn't show hand 
*** SUMMARY ***
Total pot 20550 | Rake 0 
Board [8h 6d Ac]
Seat 1: Kevin12345Mc (big blind) folded on the Flop
Seat 2: strongsoler folded before Flop (didn't bet)
Seat 3: Ivanmorosov folded before Flop (didn't bet)
Seat 4: LeventFL collected (20550)
Seat 5: DonZordon folded before Flop (didn't bet)
Seat 6: Grinde123 folded before Flop (didn't bet)
Seat 7: paleva88 (button) folded on the Flop
Seat 8: nodnek111 (small blind) folded before Flop



PokerStars Hand #254991098722: Tournament #3858857107, $2.45+$2.45+$0.60 USD Hold'em No Limit - Level XVII (1250/2500) - 2025/02/22 20:04:45 WET [2025/02/22 15:04:45 ET]
Table '3858857107 78' 8-max Seat #8 is the button
Seat 1: Kevin12345Mc (65037 in chips, $4.89 bounty) 
Seat 2: strongsoler (346876 in chips, $9.47 bounty) 
Seat 3: Ivanmorosov (153982 in chips, $7.94 bounty) 
Seat 4: LeventFL (103771 in chips, $4.89 bounty) 
Seat 5: DonZordon (59688 in chips, $2.45 bounty) 
Seat 6: Grinde123 (84015 in chips, $2.45 bounty) 
Seat 7: paleva88 (53723 in chips, $13.13 bounty) 
Seat 8: nodnek111 (126035 in chips, $7.94 bounty) is sitting out
Kevin12345Mc: posts the ante 350
strongsoler: posts the ante 350
Ivanmorosov: posts the ante 350
LeventFL: posts the ante 350
DonZordon: posts the ante 350
Grinde123: posts the ante 350
paleva88: posts the ante 350
nodnek111: posts the ante 350
Kevin12345Mc: posts small blind 1250
strongsoler: posts big blind 2500
*** HOLE CARDS ***
Dealt to Kevin12345Mc [5d Th]
Ivanmorosov: folds 
LeventFL: folds 
DonZordon: folds 
Grinde123: folds 
paleva88: folds 
nodnek111: folds 
nodnek111 is disconnected 
Kevin12345Mc: calls 1250
nodnek111 has returned
strongsoler: raises 5300 to 7800
Kevin12345Mc: folds 
Uncalled bet (5300) returned to strongsoler
strongsoler collected 7800 from pot
strongsoler: doesn't show hand 
*** SUMMARY ***
Total pot 7800 | Rake 0 
Seat 1: Kevin12345Mc (small blind) folded before Flop
Seat 2: strongsoler (big blind) collected (7800)
Seat 3: Ivanmorosov folded before Flop (didn't bet)
Seat 4: LeventFL folded before Flop (didn't bet)
Seat 5: DonZordon folded before Flop (didn't bet)
Seat 6: Grinde123 folded before Flop (didn't bet)
Seat 7: paleva88 folded before Flop (didn't bet)
Seat 8: nodnek111 (button) folded before Flop (didn't bet)



PokerStars Hand #254991106431: Tournament #3858857107, $2.45+$2.45+$0.60 USD Hold'em No Limit - Level XVII (1250/2500) - 2025/02/22 20:05:12 WET [2025/02/22 15:05:12 ET]
Table '3858857107 78' 8-max Seat #1 is the button
Seat 1: Kevin12345Mc (62187 in chips, $4.89 bounty) 
Seat 2: strongsoler (351826 in chips, $9.47 bounty) 
Seat 3: Ivanmorosov (153632 in chips, $7.94 bounty) 
Seat 4: LeventFL (103421 in chips, $4.89 bounty) 
Seat 5: DonZordon (59338 in chips, $2.45 bounty) 
Seat 6: Grinde123 (83665 in chips, $2.45 bounty) 
Seat 7: paleva88 (53373 in chips, $13.13 bounty) 
Seat 8: nodnek111 (125685 in chips, $7.94 bounty) 
Kevin12345Mc: posts the ante 350
strongsoler: posts the ante 350
Ivanmorosov: posts the ante 350
LeventFL: posts the ante 350
DonZordon: posts the ante 350
Grinde123: posts the ante 350
paleva88: posts the ante 350
nodnek111: posts the ante 350
strongsoler: posts small blind 1250
Ivanmorosov: posts big blind 2500
*** HOLE CARDS ***
Dealt to Kevin12345Mc [8d 4h]
LeventFL: folds 
DonZordon: folds 
Grinde123: folds 
paleva88: folds 
nodnek111 is disconnected 
nodnek111 has timed out while disconnected
nodnek111: folds 
nodnek111 is sitting out
Kevin12345Mc: folds 
nodnek111 is disconnected 
strongsoler: raises 4250 to 6750
Ivanmorosov: folds 
Uncalled bet (4250) returned to strongsoler
nodnek111 has returned
strongsoler collected 7800 from pot
strongsoler: doesn't show hand 
*** SUMMARY ***
Total pot 7800 | Rake 0 
Seat 1: Kevin12345Mc (button) folded before Flop (didn't bet)
Seat 2: strongsoler (small blind) collected (7800)
Seat 3: Ivanmorosov (big blind) folded before Flop
Seat 4: LeventFL folded before Flop (didn't bet)
Seat 5: DonZordon folded before Flop (didn't bet)
Seat 6: Grinde123 folded before Flop (didn't bet)
Seat 7: paleva88 folded before Flop (didn't bet)
Seat 8: nodnek111 folded before Flop (didn't bet)



PokerStars Hand #254991134657: Tournament #3858857107, $2.45+$2.45+$0.60 USD Hold'em No Limit - Level XVII (1250/2500) - 2025/02/22 20:06:50 WET [2025/02/22 15:06:50 ET]
Table '3858857107 78' 8-max Seat #2 is the button
Seat 1: Kevin12345Mc (61837 in chips, $4.89 bounty) 
Seat 2: strongsoler (356776 in chips, $9.47 bounty) 
Seat 3: Ivanmorosov (150782 in chips, $7.94 bounty) 
Seat 4: LeventFL (103071 in chips, $4.89 bounty) 
Seat 5: DonZordon (58988 in chips, $2.45 bounty) 
Seat 6: Grinde123 (83315 in chips, $2.45 bounty) 
Seat 7: paleva88 (53023 in chips, $13.13 bounty) 
Seat 8: nodnek111 (125335 in chips, $7.94 bounty) 
Kevin12345Mc: posts the ante 350
strongsoler: posts the ante 350
Ivanmorosov: posts the ante 350
LeventFL: posts the ante 350
DonZordon: posts the ante 350
Grinde123: posts the ante 350
paleva88: posts the ante 350
nodnek111: posts the ante 350
Ivanmorosov: posts small blind 1250
LeventFL: posts big blind 2500
*** HOLE CARDS ***
Dealt to Kevin12345Mc [9h 4d]
DonZordon: folds 
Grinde123: folds 
paleva88: folds 
nodnek111: folds 
Kevin12345Mc: folds 
strongsoler: folds 
Ivanmorosov: folds 
Uncalled bet (1250) returned to LeventFL
LeventFL collected 5300 from pot
LeventFL: doesn't show hand 
*** SUMMARY ***
Total pot 5300 | Rake 0 
Seat 1: Kevin12345Mc folded before Flop (didn't bet)
Seat 2: strongsoler (button) folded before Flop (didn't bet)
Seat 3: Ivanmorosov (small blind) folded before Flop
Seat 4: LeventFL (big blind) collected (5300)
Seat 5: DonZordon folded before Flop (didn't bet)
Seat 6: Grinde123 folded before Flop (didn't bet)
Seat 7: paleva88 folded before Flop (didn't bet)
Seat 8: nodnek111 folded before Flop (didn't bet)



PokerStars Hand #254991139489: Tournament #3858857107, $2.45+$2.45+$0.60 USD Hold'em No Limit - Level XVII (1250/2500) - 2025/02/22 20:07:07 WET [2025/02/22 15:07:07 ET]
Table '3858857107 78' 8-max Seat #3 is the button
Seat 1: Kevin12345Mc (61487 in chips, $4.89 bounty) 
Seat 2: strongsoler (356426 in chips, $9.47 bounty) 
Seat 3: Ivanmorosov (149182 in chips, $7.94 bounty) 
Seat 4: LeventFL (106771 in chips, $4.89 bounty) 
Seat 5: DonZordon (58638 in chips, $2.45 bounty) 
Seat 6: Grinde123 (82965 in chips, $2.45 bounty) 
Seat 7: paleva88 (52673 in chips, $13.13 bounty) 
Seat 8: nodnek111 (124985 in chips, $7.94 bounty) 
Kevin12345Mc: posts the ante 350
strongsoler: posts the ante 350
Ivanmorosov: posts the ante 350
LeventFL: posts the ante 350
DonZordon: posts the ante 350
Grinde123: posts the ante 350
paleva88: posts the ante 350
nodnek111: posts the ante 350
LeventFL: posts small blind 1250
DonZordon: posts big blind 2500
*** HOLE CARDS ***
Dealt to Kevin12345Mc [Qs 5s]
Grinde123: folds 
paleva88: folds 
nodnek111: folds 
Kevin12345Mc: folds 
strongsoler: folds 
Ivanmorosov: raises 5000 to 7500
LeventFL: folds 
DonZordon: folds 
Uncalled bet (5000) returned to Ivanmorosov
Ivanmorosov collected 9050 from pot
Ivanmorosov: doesn't show hand 
*** SUMMARY ***
Total pot 9050 | Rake 0 
Seat 1: Kevin12345Mc folded before Flop (didn't bet)
Seat 2: strongsoler folded before Flop (didn't bet)
Seat 3: Ivanmorosov (button) collected (9050)
Seat 4: LeventFL (small blind) folded before Flop
Seat 5: DonZordon (big blind) folded before Flop
Seat 6: Grinde123 folded before Flop (didn't bet)
Seat 7: paleva88 folded before Flop (didn't bet)
Seat 8: nodnek111 folded before Flop (didn't bet)



PokerStars Hand #254991152559: Tournament #3858857107, $2.45+$2.45+$0.60 USD Hold'em No Limit - Level XVII (1250/2500) - 2025/02/22 20:07:52 WET [2025/02/22 15:07:52 ET]
Table '3858857107 78' 8-max Seat #4 is the button
Seat 1: Kevin12345Mc (61137 in chips, $4.89 bounty) 
Seat 2: strongsoler (356076 in chips, $9.47 bounty) 
Seat 3: Ivanmorosov (155382 in chips, $7.94 bounty) 
Seat 4: LeventFL (105171 in chips, $4.89 bounty) 
Seat 5: DonZordon (55788 in chips, $2.45 bounty) 
Seat 6: Grinde123 (82615 in chips, $2.45 bounty) 
Seat 7: paleva88 (52323 in chips, $13.13 bounty) 
Seat 8: nodnek111 (124635 in chips, $7.94 bounty) 
Kevin12345Mc: posts the ante 350
strongsoler: posts the ante 350
Ivanmorosov: posts the ante 350
LeventFL: posts the ante 350
DonZordon: posts the ante 350
Grinde123: posts the ante 350
paleva88: posts the ante 350
nodnek111: posts the ante 350
DonZordon: posts small blind 1250
Grinde123: posts big blind 2500
*** HOLE CARDS ***
Dealt to Kevin12345Mc [6h 5h]
paleva88: folds 
nodnek111: raises 2500 to 5000
Kevin12345Mc: folds 
strongsoler: folds 
Ivanmorosov: folds 
LeventFL: folds 
DonZordon: folds 
Grinde123: calls 2500
*** FLOP *** [8c Kc 4c]
Grinde123: checks 
nodnek111: bets 7025
Grinde123: folds 
Uncalled bet (7025) returned to nodnek111
nodnek111 collected 14050 from pot
*** SUMMARY ***
Total pot 14050 | Rake 0 
Board [8c Kc 4c]
Seat 1: Kevin12345Mc folded before Flop (didn't bet)
Seat 2: strongsoler folded before Flop (didn't bet)
Seat 3: Ivanmorosov folded before Flop (didn't bet)
Seat 4: LeventFL (button) folded before Flop (didn't bet)
Seat 5: DonZordon (small blind) folded before Flop
Seat 6: Grinde123 (big blind) folded on the Flop
Seat 7: paleva88 folded before Flop (didn't bet)
Seat 8: nodnek111 collected (14050)



PokerStars Hand #254991166515: Tournament #3858857107, $2.45+$2.45+$0.60 USD Hold'em No Limit - Level XVII (1250/2500) - 2025/02/22 20:08:41 WET [2025/02/22 15:08:41 ET]
Table '3858857107 78' 8-max Seat #5 is the button
Seat 1: Kevin12345Mc (60787 in chips, $4.89 bounty) 
Seat 2: strongsoler (355726 in chips, $9.47 bounty) 
Seat 3: Ivanmorosov (155032 in chips, $7.94 bounty) 
Seat 4: LeventFL (104821 in chips, $4.89 bounty) 
Seat 5: DonZordon (54188 in chips, $2.45 bounty) 
Seat 6: Grinde123 (77265 in chips, $2.45 bounty) 
Seat 7: paleva88 (51973 in chips, $13.13 bounty) 
Seat 8: nodnek111 (133335 in chips, $7.94 bounty) 
Kevin12345Mc: posts the ante 350
strongsoler: posts the ante 350
Ivanmorosov: posts the ante 350
LeventFL: posts the ante 350
DonZordon: posts the ante 350
Grinde123: posts the ante 350
paleva88: posts the ante 350
nodnek111: posts the ante 350
Grinde123: posts small blind 1250
paleva88: posts big blind 2500
*** HOLE CARDS ***
Dealt to Kevin12345Mc [9c Td]
nodnek111: folds 
Kevin12345Mc: folds 
strongsoler: raises 2750 to 5250
Ivanmorosov: raises 12250 to 17500
LeventFL: folds 
DonZordon: folds 
Grinde123: folds 
paleva88: folds 
strongsoler: folds 
Uncalled bet (12250) returned to Ivanmorosov
Ivanmorosov collected 17050 from pot
Ivanmorosov: doesn't show hand 
*** SUMMARY ***
Total pot 17050 | Rake 0 
Seat 1: Kevin12345Mc folded before Flop (didn't bet)
Seat 2: strongsoler folded before Flop
Seat 3: Ivanmorosov collected (17050)
Seat 4: LeventFL folded before Flop (didn't bet)
Seat 5: DonZordon (button) folded before Flop (didn't bet)
Seat 6: Grinde123 (small blind) folded before Flop
Seat 7: paleva88 (big blind) folded before Flop
Seat 8: nodnek111 folded before Flop (didn't bet)



PokerStars Hand #254991178458: Tournament #3858857107, $2.45+$2.45+$0.60 USD Hold'em No Limit - Level XVII (1250/2500) - 2025/02/22 20:09:22 WET [2025/02/22 15:09:22 ET]
Table '3858857107 78' 8-max Seat #6 is the button
Seat 1: Kevin12345Mc (60437 in chips, $4.89 bounty) 
Seat 2: strongsoler (350126 in chips, $9.47 bounty) 
Seat 3: Ivanmorosov (166482 in chips, $7.94 bounty) 
Seat 4: LeventFL (104471 in chips, $4.89 bounty) 
Seat 5: DonZordon (53838 in chips, $2.45 bounty) 
Seat 6: Grinde123 (75665 in chips, $2.45 bounty) 
Seat 7: paleva88 (49123 in chips, $13.13 bounty) 
Seat 8: nodnek111 (132985 in chips, $7.94 bounty) 
Kevin12345Mc: posts the ante 350
strongsoler: posts the ante 350
Ivanmorosov: posts the ante 350
LeventFL: posts the ante 350
DonZordon: posts the ante 350
Grinde123: posts the ante 350
paleva88: posts the ante 350
nodnek111: posts the ante 350
paleva88: posts small blind 1250
nodnek111: posts big blind 2500
*** HOLE CARDS ***
Dealt to Kevin12345Mc [8s 2d]
Kevin12345Mc: folds 
strongsoler: folds 
Ivanmorosov: folds 
LeventFL: folds 
DonZordon: folds 
Grinde123: raises 2500 to 5000
paleva88: folds 
nodnek111: folds 
Uncalled bet (2500) returned to Grinde123
Grinde123 collected 9050 from pot
Grinde123: doesn't show hand 
*** SUMMARY ***
Total pot 9050 | Rake 0 
Seat 1: Kevin12345Mc folded before Flop (didn't bet)
Seat 2: strongsoler folded before Flop (didn't bet)
Seat 3: Ivanmorosov folded before Flop (didn't bet)
Seat 4: LeventFL folded before Flop (didn't bet)
Seat 5: DonZordon folded before Flop (didn't bet)
Seat 6: Grinde123 (button) collected (9050)
Seat 7: paleva88 (small blind) folded before Flop
Seat 8: nodnek111 (big blind) folded before Flop



PokerStars Hand #254991185683: Tournament #3858857107, $2.45+$2.45+$0.60 USD Hold'em No Limit - Level XVIII (1500/3000) - 2025/02/22 20:09:47 WET [2025/02/22 15:09:47 ET]
Table '3858857107 78' 8-max Seat #7 is the button
Seat 1: Kevin12345Mc (60087 in chips, $4.89 bounty) 
Seat 2: strongsoler (349776 in chips, $9.47 bounty) 
Seat 3: Ivanmorosov (166132 in chips, $7.94 bounty) 
Seat 4: LeventFL (104121 in chips, $4.89 bounty) 
Seat 5: DonZordon (53488 in chips, $2.45 bounty) 
Seat 6: Grinde123 (81865 in chips, $2.45 bounty) 
Seat 7: paleva88 (47523 in chips, $13.13 bounty) 
Seat 8: nodnek111 (130135 in chips, $7.94 bounty) 
Kevin12345Mc: posts the ante 400
strongsoler: posts the ante 400
Ivanmorosov: posts the ante 400
LeventFL: posts the ante 400
DonZordon: posts the ante 400
Grinde123: posts the ante 400
paleva88: posts the ante 400
nodnek111: posts the ante 400
nodnek111: posts small blind 1500
Kevin12345Mc: posts big blind 3000
*** HOLE CARDS ***
Dealt to Kevin12345Mc [6d 3d]
strongsoler: folds 
Ivanmorosov: folds 
LeventFL: folds 
DonZordon: folds 
Grinde123: raises 3000 to 6000
paleva88: folds 
nodnek111: folds 
Kevin12345Mc: calls 3000
*** FLOP *** [5s 2d Kh]
Kevin12345Mc: checks 
Grinde123: bets 6000
Kevin12345Mc: folds 
Uncalled bet (6000) returned to Grinde123
Grinde123 collected 16700 from pot
Grinde123: doesn't show hand 
*** SUMMARY ***
Total pot 16700 | Rake 0 
Board [5s 2d Kh]
Seat 1: Kevin12345Mc (big blind) folded on the Flop
Seat 2: strongsoler folded before Flop (didn't bet)
Seat 3: Ivanmorosov folded before Flop (didn't bet)
Seat 4: LeventFL folded before Flop (didn't bet)
Seat 5: DonZordon folded before Flop (didn't bet)
Seat 6: Grinde123 collected (16700)
Seat 7: paleva88 (button) folded before Flop (didn't bet)
Seat 8: nodnek111 (small blind) folded before Flop



PokerStars Hand #254991202603: Tournament #3858857107, $2.45+$2.45+$0.60 USD Hold'em No Limit - Level XVIII (1500/3000) - 2025/02/22 20:10:46 WET [2025/02/22 15:10:46 ET]
Table '3858857107 78' 8-max Seat #8 is the button
Seat 1: Kevin12345Mc (53687 in chips, $4.89 bounty) 
Seat 2: strongsoler (349376 in chips, $9.47 bounty) 
Seat 3: Ivanmorosov (165732 in chips, $7.94 bounty) 
Seat 4: LeventFL (103721 in chips, $4.89 bounty) 
Seat 5: DonZordon (53088 in chips, $2.45 bounty) 
Seat 6: Grinde123 (92165 in chips, $2.45 bounty) 
Seat 7: paleva88 (47123 in chips, $13.13 bounty) 
Seat 8: nodnek111 (128235 in chips, $7.94 bounty) 
Kevin12345Mc: posts the ante 400
strongsoler: posts the ante 400
Ivanmorosov: posts the ante 400
LeventFL: posts the ante 400
DonZordon: posts the ante 400
Grinde123: posts the ante 400
paleva88: posts the ante 400
nodnek111: posts the ante 400
Kevin12345Mc: posts small blind 1500
strongsoler: posts big blind 3000
*** HOLE CARDS ***
Dealt to Kevin12345Mc [Th 6s]
Ivanmorosov: folds 
LeventFL: folds 
DonZordon: folds 
Grinde123: folds 
paleva88: folds 
nodnek111: raises 3000 to 6000
Kevin12345Mc: folds 
strongsoler: raises 19700 to 25700
nodnek111: folds 
Uncalled bet (19700) returned to strongsoler
strongsoler collected 16700 from pot
strongsoler: doesn't show hand 
*** SUMMARY ***
Total pot 16700 | Rake 0 
Seat 1: Kevin12345Mc (small blind) folded before Flop
Seat 2: strongsoler (big blind) collected (16700)
Seat 3: Ivanmorosov folded before Flop (didn't bet)
Seat 4: LeventFL folded before Flop (didn't bet)
Seat 5: DonZordon folded before Flop (didn't bet)
Seat 6: Grinde123 folded before Flop (didn't bet)
Seat 7: paleva88 folded before Flop (didn't bet)
Seat 8: nodnek111 (button) folded before Flop



PokerStars Hand #254991212417: Tournament #3858857107, $2.45+$2.45+$0.60 USD Hold'em No Limit - Level XVIII (1500/3000) - 2025/02/22 20:11:20 WET [2025/02/22 15:11:20 ET]
Table '3858857107 78' 8-max Seat #1 is the button
Seat 1: Kevin12345Mc (51787 in chips, $4.89 bounty) 
Seat 2: strongsoler (359676 in chips, $9.47 bounty) 
Seat 3: Ivanmorosov (165332 in chips, $7.94 bounty) 
Seat 4: LeventFL (103321 in chips, $4.89 bounty) 
Seat 5: DonZordon (52688 in chips, $2.45 bounty) 
Seat 6: Grinde123 (91765 in chips, $2.45 bounty) 
Seat 7: paleva88 (46723 in chips, $13.13 bounty) 
Seat 8: nodnek111 (121835 in chips, $7.94 bounty) 
Kevin12345Mc: posts the ante 400
strongsoler: posts the ante 400
Ivanmorosov: posts the ante 400
LeventFL: posts the ante 400
DonZordon: posts the ante 400
Grinde123: posts the ante 400
paleva88: posts the ante 400
nodnek111: posts the ante 400
strongsoler: posts small blind 1500
Ivanmorosov: posts big blind 3000
*** HOLE CARDS ***
Dealt to Kevin12345Mc [2h Ks]
LeventFL: folds 
DonZordon: folds 
Grinde123: folds 
paleva88: folds 
nodnek111: folds 
Kevin12345Mc: folds 
strongsoler: raises 5100 to 8100
Ivanmorosov: calls 5100
*** FLOP *** [6d Jh 2s]
strongsoler: checks 
Ivanmorosov: checks 
*** TURN *** [6d Jh 2s] [4h]
strongsoler: checks 
Ivanmorosov: checks 
*** RIVER *** [6d Jh 2s 4h] [As]
strongsoler: bets 13192
Ivanmorosov: folds 
Uncalled bet (13192) returned to strongsoler
strongsoler collected 19400 from pot
strongsoler: doesn't show hand 
*** SUMMARY ***
Total pot 19400 | Rake 0 
Board [6d Jh 2s 4h As]
Seat 1: Kevin12345Mc (button) folded before Flop (didn't bet)
Seat 2: strongsoler (small blind) collected (19400)
Seat 3: Ivanmorosov (big blind) folded on the River
Seat 4: LeventFL folded before Flop (didn't bet)
Seat 5: DonZordon folded before Flop (didn't bet)
Seat 6: Grinde123 folded before Flop (didn't bet)
Seat 7: paleva88 folded before Flop (didn't bet)
Seat 8: nodnek111 folded before Flop (didn't bet)



PokerStars Hand #254991222812: Tournament #3858857107, $2.45+$2.45+$0.60 USD Hold'em No Limit - Level XVIII (1500/3000) - 2025/02/22 20:11:56 WET [2025/02/22 15:11:56 ET]
Table '3858857107 78' 8-max Seat #2 is the button
Seat 1: Kevin12345Mc (51387 in chips, $4.89 bounty) 
Seat 2: strongsoler (370576 in chips, $9.47 bounty) 
Seat 3: Ivanmorosov (156832 in chips, $7.94 bounty) 
Seat 4: LeventFL (102921 in chips, $4.89 bounty) 
Seat 5: DonZordon (52288 in chips, $2.45 bounty) 
Seat 6: Grinde123 (91365 in chips, $2.45 bounty) 
Seat 7: paleva88 (46323 in chips, $13.13 bounty) 
Seat 8: nodnek111 (121435 in chips, $7.94 bounty) 
Kevin12345Mc: posts the ante 400
strongsoler: posts the ante 400
Ivanmorosov: posts the ante 400
LeventFL: posts the ante 400
DonZordon: posts the ante 400
Grinde123: posts the ante 400
paleva88: posts the ante 400
nodnek111: posts the ante 400
Ivanmorosov: posts small blind 1500
LeventFL: posts big blind 3000
*** HOLE CARDS ***
Dealt to Kevin12345Mc [Tc 9c]
DonZordon: folds 
Grinde123: folds 
paleva88: folds 
nodnek111: raises 3000 to 6000
Kevin12345Mc: folds 
strongsoler: raises 12000 to 18000
Ivanmorosov: folds 
LeventFL: folds 
nodnek111: raises 33000 to 51000
strongsoler: folds 
Uncalled bet (33000) returned to nodnek111
nodnek111 collected 43700 from pot
*** SUMMARY ***
Total pot 43700 | Rake 0 
Seat 1: Kevin12345Mc folded before Flop (didn't bet)
Seat 2: strongsoler (button) folded before Flop
Seat 3: Ivanmorosov (small blind) folded before Flop
Seat 4: LeventFL (big blind) folded before Flop
Seat 5: DonZordon folded before Flop (didn't bet)
Seat 6: Grinde123 folded before Flop (didn't bet)
Seat 7: paleva88 folded before Flop (didn't bet)
Seat 8: nodnek111 collected (43700)



PokerStars Hand #254991237919: Tournament #3858857107, $2.45+$2.45+$0.60 USD Hold'em No Limit - Level XVIII (1500/3000) - 2025/02/22 20:12:47 WET [2025/02/22 15:12:47 ET]
Table '3858857107 78' 8-max Seat #3 is the button
Seat 1: Kevin12345Mc (50987 in chips, $4.89 bounty) 
Seat 2: strongsoler (352176 in chips, $9.47 bounty) 
Seat 3: Ivanmorosov (154932 in chips, $7.94 bounty) 
Seat 4: LeventFL (99521 in chips, $4.89 bounty) 
Seat 5: DonZordon (51888 in chips, $2.45 bounty) 
Seat 6: Grinde123 (90965 in chips, $2.45 bounty) 
Seat 7: paleva88 (45923 in chips, $13.13 bounty) 
Seat 8: nodnek111 (146735 in chips, $7.94 bounty) 
Kevin12345Mc: posts the ante 400
strongsoler: posts the ante 400
Ivanmorosov: posts the ante 400
LeventFL: posts the ante 400
DonZordon: posts the ante 400
Grinde123: posts the ante 400
paleva88: posts the ante 400
nodnek111: posts the ante 400
LeventFL: posts small blind 1500
DonZordon: posts big blind 3000
*** HOLE CARDS ***
Dealt to Kevin12345Mc [7c 9c]
Grinde123: folds 
paleva88: folds 
nodnek111: folds 
Kevin12345Mc: folds 
strongsoler: folds 
Ivanmorosov: folds 
LeventFL: calls 1500
DonZordon: checks 
*** FLOP *** [Qh Jc 5c]
LeventFL: bets 3036
DonZordon: calls 3036
*** TURN *** [Qh Jc 5c] [8c]
LeventFL: bets 5040
DonZordon: calls 5040
*** RIVER *** [Qh Jc 5c 8c] [3s]
LeventFL: checks 
DonZordon: checks 
*** SHOW DOWN ***
LeventFL: shows [8h Tc] (a pair of Eights)
DonZordon: mucks hand 
LeventFL collected 25352 from pot
*** SUMMARY ***
Total pot 25352 | Rake 0 
Board [Qh Jc 5c 8c 3s]
Seat 1: Kevin12345Mc folded before Flop (didn't bet)
Seat 2: strongsoler folded before Flop (didn't bet)
Seat 3: Ivanmorosov (button) folded before Flop (didn't bet)
Seat 4: LeventFL (small blind) showed [8h Tc] and won (25352) with a pair of Eights
Seat 5: DonZordon (big blind) mucked [5s 7h]
Seat 6: Grinde123 folded before Flop (didn't bet)
Seat 7: paleva88 folded before Flop (didn't bet)
Seat 8: nodnek111 folded before Flop (didn't bet)



PokerStars Hand #254991253219: Tournament #3858857107, $2.45+$2.45+$0.60 USD Hold'em No Limit - Level XVIII (1500/3000) - 2025/02/22 20:13:40 WET [2025/02/22 15:13:40 ET]
Table '3858857107 78' 8-max Seat #4 is the button
Seat 1: Kevin12345Mc (50587 in chips, $4.89 bounty) 
Seat 2: strongsoler (351776 in chips, $9.47 bounty) 
Seat 3: Ivanmorosov (154532 in chips, $7.94 bounty) 
Seat 4: LeventFL (113397 in chips, $4.89 bounty) 
Seat 5: DonZordon (40412 in chips, $2.45 bounty) 
Seat 6: Grinde123 (90565 in chips, $2.45 bounty) 
Seat 7: paleva88 (45523 in chips, $13.13 bounty) 
Seat 8: nodnek111 (146335 in chips, $7.94 bounty) 
Kevin12345Mc: posts the ante 400
strongsoler: posts the ante 400
Ivanmorosov: posts the ante 400
LeventFL: posts the ante 400
DonZordon: posts the ante 400
Grinde123: posts the ante 400
paleva88: posts the ante 400
nodnek111: posts the ante 400
DonZordon: posts small blind 1500
Grinde123: posts big blind 3000
*** HOLE CARDS ***
Dealt to Kevin12345Mc [3c 9s]
paleva88: folds 
nodnek111: folds 
Kevin12345Mc: folds 
strongsoler: folds 
Ivanmorosov: folds 
LeventFL: folds 
DonZordon: folds 
Uncalled bet (1500) returned to Grinde123
Grinde123 collected 6200 from pot
Grinde123: doesn't show hand 
*** SUMMARY ***
Total pot 6200 | Rake 0 
Seat 1: Kevin12345Mc folded before Flop (didn't bet)
Seat 2: strongsoler folded before Flop (didn't bet)
Seat 3: Ivanmorosov folded before Flop (didn't bet)
Seat 4: LeventFL (button) folded before Flop (didn't bet)
Seat 5: DonZordon (small blind) folded before Flop
Seat 6: Grinde123 (big blind) collected (6200)
Seat 7: paleva88 folded before Flop (didn't bet)
Seat 8: nodnek111 folded before Flop (didn't bet)



PokerStars Hand #254991261289: Tournament #3858857107, $2.45+$2.45+$0.60 USD Hold'em No Limit - Level XVIII (1500/3000) - 2025/02/22 20:14:08 WET [2025/02/22 15:14:08 ET]
Table '3858857107 78' 8-max Seat #5 is the button
Seat 1: Kevin12345Mc (50187 in chips, $4.89 bounty) 
Seat 2: strongsoler (351376 in chips, $9.47 bounty) 
Seat 3: Ivanmorosov (154132 in chips, $7.94 bounty) 
Seat 4: LeventFL (112997 in chips, $4.89 bounty) 
Seat 5: DonZordon (38512 in chips, $2.45 bounty) 
Seat 6: Grinde123 (94865 in chips, $2.45 bounty) 
Seat 7: paleva88 (45123 in chips, $13.13 bounty) 
Seat 8: nodnek111 (145935 in chips, $7.94 bounty) 
Kevin12345Mc: posts the ante 400
strongsoler: posts the ante 400
Ivanmorosov: posts the ante 400
LeventFL: posts the ante 400
DonZordon: posts the ante 400
Grinde123: posts the ante 400
paleva88: posts the ante 400
nodnek111: posts the ante 400
Grinde123: posts small blind 1500
paleva88: posts big blind 3000
*** HOLE CARDS ***
Dealt to Kevin12345Mc [8d 5h]
nodnek111: folds 
Kevin12345Mc: folds 
strongsoler: raises 3000 to 6000
Ivanmorosov: folds 
LeventFL: folds 
DonZordon: folds 
Grinde123: folds 
paleva88: folds 
Uncalled bet (3000) returned to strongsoler
strongsoler collected 10700 from pot
strongsoler: doesn't show hand 
*** SUMMARY ***
Total pot 10700 | Rake 0 
Seat 1: Kevin12345Mc folded before Flop (didn't bet)
Seat 2: strongsoler collected (10700)
Seat 3: Ivanmorosov folded before Flop (didn't bet)
Seat 4: LeventFL folded before Flop (didn't bet)
Seat 5: DonZordon (button) folded before Flop (didn't bet)
Seat 6: Grinde123 (small blind) folded before Flop
Seat 7: paleva88 (big blind) folded before Flop
Seat 8: nodnek111 folded before Flop (didn't bet)



PokerStars Hand #254991269460: Tournament #3858857107, $2.45+$2.45+$0.60 USD Hold'em No Limit - Level XVIII (1500/3000) - 2025/02/22 20:14:36 WET [2025/02/22 15:14:36 ET]
Table '3858857107 78' 8-max Seat #6 is the button
Seat 1: Kevin12345Mc (49787 in chips, $4.89 bounty) 
Seat 2: strongsoler (358676 in chips, $9.47 bounty) 
Seat 3: Ivanmorosov (153732 in chips, $7.94 bounty) 
Seat 4: LeventFL (112597 in chips, $4.89 bounty) 
Seat 5: DonZordon (38112 in chips, $2.45 bounty) 
Seat 6: Grinde123 (92965 in chips, $2.45 bounty) 
Seat 7: paleva88 (41723 in chips, $13.13 bounty) 
Seat 8: nodnek111 (145535 in chips, $7.94 bounty) 
Kevin12345Mc: posts the ante 400
strongsoler: posts the ante 400
Ivanmorosov: posts the ante 400
LeventFL: posts the ante 400
DonZordon: posts the ante 400
Grinde123: posts the ante 400
paleva88: posts the ante 400
nodnek111: posts the ante 400
paleva88: posts small blind 1500
nodnek111: posts big blind 3000
*** HOLE CARDS ***
Dealt to Kevin12345Mc [3c 5h]
Kevin12345Mc: folds 
strongsoler: folds 
Ivanmorosov: folds 
LeventFL: folds 
DonZordon: folds 
Grinde123: folds 
paleva88: folds 
Uncalled bet (1500) returned to nodnek111
nodnek111 collected 6200 from pot
*** SUMMARY ***
Total pot 6200 | Rake 0 
Seat 1: Kevin12345Mc folded before Flop (didn't bet)
Seat 2: strongsoler folded before Flop (didn't bet)
Seat 3: Ivanmorosov folded before Flop (didn't bet)
Seat 4: LeventFL folded before Flop (didn't bet)
Seat 5: DonZordon folded before Flop (didn't bet)
Seat 6: Grinde123 (button) folded before Flop (didn't bet)
Seat 7: paleva88 (small blind) folded before Flop
Seat 8: nodnek111 (big blind) collected (6200)



PokerStars Hand #254991273092: Tournament #3858857107, $2.45+$2.45+$0.60 USD Hold'em No Limit - Level XVIII (1500/3000) - 2025/02/22 20:14:49 WET [2025/02/22 15:14:49 ET]
Table '3858857107 78' 8-max Seat #7 is the button
Seat 1: Kevin12345Mc (49387 in chips, $4.89 bounty) 
Seat 2: strongsoler (358276 in chips, $9.47 bounty) 
Seat 3: Ivanmorosov (153332 in chips, $7.94 bounty) 
Seat 4: LeventFL (112197 in chips, $4.89 bounty) 
Seat 5: DonZordon (37712 in chips, $2.45 bounty) 
Seat 6: Grinde123 (92565 in chips, $2.45 bounty) 
Seat 7: paleva88 (39823 in chips, $13.13 bounty) 
Seat 8: nodnek111 (149835 in chips, $7.94 bounty) 
Kevin12345Mc: posts the ante 400
strongsoler: posts the ante 400
Ivanmorosov: posts the ante 400
LeventFL: posts the ante 400
DonZordon: posts the ante 400
Grinde123: posts the ante 400
paleva88: posts the ante 400
nodnek111: posts the ante 400
nodnek111: posts small blind 1500
Kevin12345Mc: posts big blind 3000
*** HOLE CARDS ***
Dealt to Kevin12345Mc [3h 6h]
strongsoler: folds 
Ivanmorosov: folds 
LeventFL: folds 
DonZordon: folds 
Grinde123: folds 
paleva88: folds 
nodnek111: folds 
Uncalled bet (1500) returned to Kevin12345Mc
Kevin12345Mc collected 6200 from pot
Kevin12345Mc: doesn't show hand 
*** SUMMARY ***
Total pot 6200 | Rake 0 
Seat 1: Kevin12345Mc (big blind) collected (6200)
Seat 2: strongsoler folded before Flop (didn't bet)
Seat 3: Ivanmorosov folded before Flop (didn't bet)
Seat 4: LeventFL folded before Flop (didn't bet)
Seat 5: DonZordon folded before Flop (didn't bet)
Seat 6: Grinde123 folded before Flop (didn't bet)
Seat 7: paleva88 (button) folded before Flop (didn't bet)
Seat 8: nodnek111 (small blind) folded before Flop



PokerStars Hand #254991276601: Tournament #3858857107, $2.45+$2.45+$0.60 USD Hold'em No Limit - Level XVIII (1500/3000) - 2025/02/22 20:15:01 WET [2025/02/22 15:15:01 ET]
Table '3858857107 78' 8-max Seat #8 is the button
Seat 1: Kevin12345Mc (53687 in chips, $4.89 bounty) 
Seat 2: strongsoler (357876 in chips, $9.47 bounty) 
Seat 3: Ivanmorosov (152932 in chips, $7.94 bounty) 
Seat 4: LeventFL (111797 in chips, $4.89 bounty) 
Seat 5: DonZordon (37312 in chips, $2.45 bounty) 
Seat 6: Grinde123 (92165 in chips, $2.45 bounty) 
Seat 7: paleva88 (39423 in chips, $13.13 bounty) 
Seat 8: nodnek111 (147935 in chips, $7.94 bounty) 
Kevin12345Mc: posts the ante 400
strongsoler: posts the ante 400
Ivanmorosov: posts the ante 400
LeventFL: posts the ante 400
DonZordon: posts the ante 400
Grinde123: posts the ante 400
paleva88: posts the ante 400
nodnek111: posts the ante 400
Kevin12345Mc: posts small blind 1500
strongsoler: posts big blind 3000
*** HOLE CARDS ***
Dealt to Kevin12345Mc [Th Qc]
Ivanmorosov: folds 
LeventFL: folds 
DonZordon: folds 
Grinde123: folds 
paleva88: folds 
nodnek111: raises 3000 to 6000
Kevin12345Mc: calls 4500
strongsoler: calls 3000
*** FLOP *** [Js 4s 2h]
Kevin12345Mc: checks 
strongsoler: checks 
nodnek111: bets 12000
Kevin12345Mc: folds 
strongsoler: calls 12000
*** TURN *** [Js 4s 2h] [Ac]
strongsoler: checks 
nodnek111: bets 45200
strongsoler: folds 
Uncalled bet (45200) returned to nodnek111
nodnek111 collected 45200 from pot
*** SUMMARY ***
Total pot 45200 | Rake 0 
Board [Js 4s 2h Ac]
Seat 1: Kevin12345Mc (small blind) folded on the Flop
Seat 2: strongsoler (big blind) folded on the Turn
Seat 3: Ivanmorosov folded before Flop (didn't bet)
Seat 4: LeventFL folded before Flop (didn't bet)
Seat 5: DonZordon folded before Flop (didn't bet)
Seat 6: Grinde123 folded before Flop (didn't bet)
Seat 7: paleva88 folded before Flop (didn't bet)
Seat 8: nodnek111 (button) collected (45200)



PokerStars Hand #254991296552: Tournament #3858857107, $2.45+$2.45+$0.60 USD Hold'em No Limit - Level XVIII (1500/3000) - 2025/02/22 20:16:10 WET [2025/02/22 15:16:10 ET]
Table '3858857107 78' 8-max Seat #1 is the button
Seat 1: Kevin12345Mc (47287 in chips, $4.89 bounty) 
Seat 2: strongsoler (339476 in chips, $9.47 bounty) 
Seat 3: Ivanmorosov (152532 in chips, $7.94 bounty) 
Seat 4: LeventFL (111397 in chips, $4.89 bounty) 
Seat 5: DonZordon (36912 in chips, $2.45 bounty) 
Seat 6: Grinde123 (91765 in chips, $2.45 bounty) 
Seat 7: paleva88 (39023 in chips, $13.13 bounty) 
Seat 8: nodnek111 (174735 in chips, $7.94 bounty) 
Kevin12345Mc: posts the ante 400
strongsoler: posts the ante 400
Ivanmorosov: posts the ante 400
LeventFL: posts the ante 400
DonZordon: posts the ante 400
Grinde123: posts the ante 400
paleva88: posts the ante 400
nodnek111: posts the ante 400
strongsoler: posts small blind 1500
Ivanmorosov: posts big blind 3000
*** HOLE CARDS ***
Dealt to Kevin12345Mc [Th Jc]
LeventFL: folds 
DonZordon: folds 
Grinde123: folds 
paleva88: raises 35623 to 38623 and is all-in
nodnek111: raises 135712 to 174335 and is all-in
Kevin12345Mc: folds 
strongsoler: folds 
Ivanmorosov: folds 
Uncalled bet (135712) returned to nodnek111
*** FLOP *** [8d 6h 7c]
*** TURN *** [8d 6h 7c] [Ah]
*** RIVER *** [8d 6h 7c Ah] [3h]
*** SHOW DOWN ***
paleva88: shows [Qd Kd] (high card Ace)
nodnek111: shows [Tc Ac] (a pair of Aces)
nodnek111 collected 84946 from pot
nodnek111 wins $6.57 for eliminating paleva88 and their own bounty increases by $6.56 to $14.50
paleva88 finished the tournament in 921st place
*** SUMMARY ***
Total pot 84946 | Rake 0 
Board [8d 6h 7c Ah 3h]
Seat 1: Kevin12345Mc (button) folded before Flop (didn't bet)
Seat 2: strongsoler (small blind) folded before Flop
Seat 3: Ivanmorosov (big blind) folded before Flop
Seat 4: LeventFL folded before Flop (didn't bet)
Seat 5: DonZordon folded before Flop (didn't bet)
Seat 6: Grinde123 folded before Flop (didn't bet)
Seat 7: paleva88 showed [Qd Kd] and lost with high card Ace
Seat 8: nodnek111 showed [Tc Ac] and won (84946) with a pair of Aces



PokerStars Hand #254991318848: Tournament #3858857107, $2.45+$2.45+$0.60 USD Hold'em No Limit - Level XIX (2000/4000) - 2025/02/22 20:17:27 WET [2025/02/22 15:17:27 ET]
Table '3858857107 291' 8-max Seat #4 is the button
Seat 1: ber7nard (221208 in chips, $10.08 bounty) 
Seat 2: Kevin12345Mc (46887 in chips, $4.89 bounty) 
Seat 3: Eazy Money G (125580 in chips, $7.33 bounty) 
Seat 4: flushyace31 (90680 in chips, $2.45 bounty) 
Seat 5: tourrttt! (108509 in chips, $6.11 bounty) 
Seat 6: official_dapic (82481 in chips, $4.89 bounty) 
Seat 7: Chalkitup48 (72393 in chips, $2.45 bounty) 
Seat 8: EscotMe2 (53775 in chips, $9.16 bounty) 
ber7nard: posts the ante 500
Kevin12345Mc: posts the ante 500
Eazy Money G: posts the ante 500
flushyace31: posts the ante 500
tourrttt!: posts the ante 500
official_dapic: posts the ante 500
Chalkitup48: posts the ante 500
EscotMe2: posts the ante 500
tourrttt!: posts small blind 2000
official_dapic: posts big blind 4000
*** HOLE CARDS ***
Dealt to Kevin12345Mc [7c Jd]
Chalkitup48: folds 
EscotMe2: folds 
ber7nard: folds 
Kevin12345Mc: folds 
Eazy Money G: folds 
flushyace31: folds 
tourrttt!: folds 
Uncalled bet (2000) returned to official_dapic
official_dapic collected 8000 from pot
official_dapic: doesn't show hand 
*** SUMMARY ***
Total pot 8000 | Rake 0 
Seat 1: ber7nard folded before Flop (didn't bet)
Seat 2: Kevin12345Mc folded before Flop (didn't bet)
Seat 3: Eazy Money G folded before Flop (didn't bet)
Seat 4: flushyace31 (button) folded before Flop (didn't bet)
Seat 5: tourrttt! (small blind) folded before Flop
Seat 6: official_dapic (big blind) collected (8000)
Seat 7: Chalkitup48 folded before Flop (didn't bet)
Seat 8: EscotMe2 folded before Flop (didn't bet)



PokerStars Hand #254991324521: Tournament #3858857107, $2.45+$2.45+$0.60 USD Hold'em No Limit - Level XIX (2000/4000) - 2025/02/22 20:17:47 WET [2025/02/22 15:17:47 ET]
Table '3858857107 291' 8-max Seat #5 is the button
Seat 1: ber7nard (220708 in chips, $10.08 bounty) 
Seat 2: Kevin12345Mc (46387 in chips, $4.89 bounty) 
Seat 3: Eazy Money G (125080 in chips, $7.33 bounty) 
Seat 4: flushyace31 (90180 in chips, $2.45 bounty) 
Seat 5: tourrttt! (106009 in chips, $6.11 bounty) 
Seat 6: official_dapic (87981 in chips, $4.89 bounty) 
Seat 7: Chalkitup48 (71893 in chips, $2.45 bounty) 
Seat 8: EscotMe2 (53275 in chips, $9.16 bounty) 
ber7nard: posts the ante 500
Kevin12345Mc: posts the ante 500
Eazy Money G: posts the ante 500
flushyace31: posts the ante 500
tourrttt!: posts the ante 500
official_dapic: posts the ante 500
Chalkitup48: posts the ante 500
EscotMe2: posts the ante 500
official_dapic: posts small blind 2000
Chalkitup48: posts big blind 4000
*** HOLE CARDS ***
Dealt to Kevin12345Mc [7h Th]
EscotMe2: folds 
ber7nard: folds 
Kevin12345Mc: folds 
Eazy Money G: folds 
flushyace31: folds 
tourrttt!: folds 
official_dapic: raises 8000 to 12000
Chalkitup48: calls 8000
*** FLOP *** [4c 4d Ah]
official_dapic: bets 7000
Chalkitup48: folds 
Uncalled bet (7000) returned to official_dapic
official_dapic collected 28000 from pot
official_dapic: doesn't show hand 
*** SUMMARY ***
Total pot 28000 | Rake 0 
Board [4c 4d Ah]
Seat 1: ber7nard folded before Flop (didn't bet)
Seat 2: Kevin12345Mc folded before Flop (didn't bet)
Seat 3: Eazy Money G folded before Flop (didn't bet)
Seat 4: flushyace31 folded before Flop (didn't bet)
Seat 5: tourrttt! (button) folded before Flop (didn't bet)
Seat 6: official_dapic (small blind) collected (28000)
Seat 7: Chalkitup48 (big blind) folded on the Flop
Seat 8: EscotMe2 folded before Flop (didn't bet)



PokerStars Hand #254991335499: Tournament #3858857107, $2.45+$2.45+$0.60 USD Hold'em No Limit - Level XIX (2000/4000) - 2025/02/22 20:18:24 WET [2025/02/22 15:18:24 ET]
Table '3858857107 291' 8-max Seat #6 is the button
Seat 1: ber7nard (220208 in chips, $10.08 bounty) 
Seat 2: Kevin12345Mc (45887 in chips, $4.89 bounty) 
Seat 3: Eazy Money G (124580 in chips, $7.33 bounty) 
Seat 4: flushyace31 (89680 in chips, $2.45 bounty) 
Seat 5: tourrttt! (105509 in chips, $6.11 bounty) 
Seat 6: official_dapic (103481 in chips, $4.89 bounty) 
Seat 7: Chalkitup48 (59393 in chips, $2.45 bounty) 
Seat 8: EscotMe2 (52775 in chips, $9.16 bounty) 
ber7nard: posts the ante 500
Kevin12345Mc: posts the ante 500
Eazy Money G: posts the ante 500
flushyace31: posts the ante 500
tourrttt!: posts the ante 500
official_dapic: posts the ante 500
Chalkitup48: posts the ante 500
EscotMe2: posts the ante 500
Chalkitup48: posts small blind 2000
EscotMe2: posts big blind 4000
*** HOLE CARDS ***
Dealt to Kevin12345Mc [9h 7h]
ber7nard: folds 
Kevin12345Mc: folds 
Eazy Money G: raises 4000 to 8000
flushyace31: folds 
tourrttt!: calls 8000
official_dapic: folds 
Chalkitup48: folds 
EscotMe2: folds 
*** FLOP *** [Ks Qc Qd]
Eazy Money G: bets 8000
tourrttt!: calls 8000
*** TURN *** [Ks Qc Qd] [8d]
Eazy Money G: checks 
tourrttt!: checks 
*** RIVER *** [Ks Qc Qd 8d] [2h]
Eazy Money G: checks 
tourrttt!: bets 14700
Eazy Money G: calls 14700
*** SHOW DOWN ***
tourrttt!: shows [Kh Ah] (two pair, Kings and Queens)
Eazy Money G: mucks hand 
tourrttt! collected 71400 from pot
*** SUMMARY ***
Total pot 71400 | Rake 0 
Board [Ks Qc Qd 8d 2h]
Seat 1: ber7nard folded before Flop (didn't bet)
Seat 2: Kevin12345Mc folded before Flop (didn't bet)
Seat 3: Eazy Money G mucked [4c 4d]
Seat 4: flushyace31 folded before Flop (didn't bet)
Seat 5: tourrttt! showed [Kh Ah] and won (71400) with two pair, Kings and Queens
Seat 6: official_dapic (button) folded before Flop (didn't bet)
Seat 7: Chalkitup48 (small blind) folded before Flop
Seat 8: EscotMe2 (big blind) folded before Flop



PokerStars Hand #254991347166: Tournament #3858857107, $2.45+$2.45+$0.60 USD Hold'em No Limit - Level XIX (2000/4000) - 2025/02/22 20:19:05 WET [2025/02/22 15:19:05 ET]
Table '3858857107 291' 8-max Seat #7 is the button
Seat 1: ber7nard (219708 in chips, $10.08 bounty) 
Seat 2: Kevin12345Mc (45387 in chips, $4.89 bounty) 
Seat 3: Eazy Money G (93380 in chips, $7.33 bounty) 
Seat 4: flushyace31 (89180 in chips, $2.45 bounty) 
Seat 5: tourrttt! (145709 in chips, $6.11 bounty) 
Seat 6: official_dapic (102981 in chips, $4.89 bounty) 
Seat 7: Chalkitup48 (56893 in chips, $2.45 bounty) 
Seat 8: EscotMe2 (48275 in chips, $9.16 bounty) 
ber7nard: posts the ante 500
Kevin12345Mc: posts the ante 500
Eazy Money G: posts the ante 500
flushyace31: posts the ante 500
tourrttt!: posts the ante 500
official_dapic: posts the ante 500
Chalkitup48: posts the ante 500
EscotMe2: posts the ante 500
EscotMe2: posts small blind 2000
ber7nard: posts big blind 4000
*** HOLE CARDS ***
Dealt to Kevin12345Mc [9c 2h]
Kevin12345Mc: folds 
Eazy Money G: folds 
flushyace31: folds 
tourrttt!: folds 
official_dapic: folds 
Chalkitup48: folds 
EscotMe2: raises 43775 to 47775 and is all-in
ber7nard: folds 
Uncalled bet (43775) returned to EscotMe2
EscotMe2 collected 12000 from pot
EscotMe2: doesn't show hand 
*** SUMMARY ***
Total pot 12000 | Rake 0 
Seat 1: ber7nard (big blind) folded before Flop
Seat 2: Kevin12345Mc folded before Flop (didn't bet)
Seat 3: Eazy Money G folded before Flop (didn't bet)
Seat 4: flushyace31 folded before Flop (didn't bet)
Seat 5: tourrttt! folded before Flop (didn't bet)
Seat 6: official_dapic folded before Flop (didn't bet)
Seat 7: Chalkitup48 (button) folded before Flop (didn't bet)
Seat 8: EscotMe2 (small blind) collected (12000)



PokerStars Hand #254991354517: Tournament #3858857107, $2.45+$2.45+$0.60 USD Hold'em No Limit - Level XIX (2000/4000) - 2025/02/22 20:19:30 WET [2025/02/22 15:19:30 ET]
Table '3858857107 291' 8-max Seat #8 is the button
Seat 1: ber7nard (215208 in chips, $10.08 bounty) 
Seat 2: Kevin12345Mc (44887 in chips, $4.89 bounty) 
Seat 3: Eazy Money G (92880 in chips, $7.33 bounty) 
Seat 4: flushyace31 (88680 in chips, $2.45 bounty) 
Seat 5: tourrttt! (145209 in chips, $6.11 bounty) 
Seat 6: official_dapic (102481 in chips, $4.89 bounty) 
Seat 7: Chalkitup48 (56393 in chips, $2.45 bounty) 
Seat 8: EscotMe2 (55775 in chips, $9.16 bounty) 
ber7nard: posts the ante 500
Kevin12345Mc: posts the ante 500
Eazy Money G: posts the ante 500
flushyace31: posts the ante 500
tourrttt!: posts the ante 500
official_dapic: posts the ante 500
Chalkitup48: posts the ante 500
EscotMe2: posts the ante 500
ber7nard: posts small blind 2000
Kevin12345Mc: posts big blind 4000
*** HOLE CARDS ***
Dealt to Kevin12345Mc [Th 8d]
Eazy Money G: raises 8000 to 12000
flushyace31: folds 
tourrttt!: folds 
official_dapic: folds 
Chalkitup48: folds 
EscotMe2: folds 
ber7nard: folds 
Kevin12345Mc: folds 
Uncalled bet (8000) returned to Eazy Money G
Eazy Money G collected 14000 from pot
*** SUMMARY ***
Total pot 14000 | Rake 0 
Seat 1: ber7nard (small blind) folded before Flop
Seat 2: Kevin12345Mc (big blind) folded before Flop
Seat 3: Eazy Money G collected (14000)
Seat 4: flushyace31 folded before Flop (didn't bet)
Seat 5: tourrttt! folded before Flop (didn't bet)
Seat 6: official_dapic folded before Flop (didn't bet)
Seat 7: Chalkitup48 folded before Flop (didn't bet)
Seat 8: EscotMe2 (button) folded before Flop (didn't bet)



PokerStars Hand #254991359141: Tournament #3858857107, $2.45+$2.45+$0.60 USD Hold'em No Limit - Level XIX (2000/4000) - 2025/02/22 20:19:46 WET [2025/02/22 15:19:46 ET]
Table '3858857107 291' 8-max Seat #1 is the button
Seat 1: ber7nard (212708 in chips, $10.08 bounty) 
Seat 2: Kevin12345Mc (40387 in chips, $4.89 bounty) 
Seat 3: Eazy Money G (102380 in chips, $7.33 bounty) 
Seat 4: flushyace31 (88180 in chips, $2.45 bounty) 
Seat 5: tourrttt! (144709 in chips, $6.11 bounty) 
Seat 6: official_dapic (101981 in chips, $4.89 bounty) 
Seat 7: Chalkitup48 (55893 in chips, $2.45 bounty) 
Seat 8: EscotMe2 (55275 in chips, $9.16 bounty) 
ber7nard: posts the ante 500
Kevin12345Mc: posts the ante 500
Eazy Money G: posts the ante 500
flushyace31: posts the ante 500
tourrttt!: posts the ante 500
official_dapic: posts the ante 500
Chalkitup48: posts the ante 500
EscotMe2: posts the ante 500
Kevin12345Mc: posts small blind 2000
Eazy Money G: posts big blind 4000
*** HOLE CARDS ***
Dealt to Kevin12345Mc [5h 4d]
flushyace31: folds 
tourrttt!: folds 
official_dapic: folds 
Chalkitup48: folds 
EscotMe2: folds 
ber7nard: folds 
Kevin12345Mc: folds 
Uncalled bet (2000) returned to Eazy Money G
Eazy Money G collected 8000 from pot
*** SUMMARY ***
Total pot 8000 | Rake 0 
Seat 1: ber7nard (button) folded before Flop (didn't bet)
Seat 2: Kevin12345Mc (small blind) folded before Flop
Seat 3: Eazy Money G (big blind) collected (8000)
Seat 4: flushyace31 folded before Flop (didn't bet)
Seat 5: tourrttt! folded before Flop (didn't bet)
Seat 6: official_dapic folded before Flop (didn't bet)
Seat 7: Chalkitup48 folded before Flop (didn't bet)
Seat 8: EscotMe2 folded before Flop (didn't bet)



PokerStars Hand #254991365103: Tournament #3858857107, $2.45+$2.45+$0.60 USD Hold'em No Limit - Level XIX (2000/4000) - 2025/02/22 20:20:06 WET [2025/02/22 15:20:06 ET]
Table '3858857107 291' 8-max Seat #2 is the button
Seat 1: ber7nard (212208 in chips, $10.08 bounty) 
Seat 2: Kevin12345Mc (37887 in chips, $4.89 bounty) 
Seat 3: Eazy Money G (107880 in chips, $7.33 bounty) 
Seat 4: flushyace31 (87680 in chips, $2.45 bounty) 
Seat 5: tourrttt! (144209 in chips, $6.11 bounty) 
Seat 6: official_dapic (101481 in chips, $4.89 bounty) 
Seat 7: Chalkitup48 (55393 in chips, $2.45 bounty) 
Seat 8: EscotMe2 (54775 in chips, $9.16 bounty) 
ber7nard: posts the ante 500
Kevin12345Mc: posts the ante 500
Eazy Money G: posts the ante 500
flushyace31: posts the ante 500
tourrttt!: posts the ante 500
official_dapic: posts the ante 500
Chalkitup48: posts the ante 500
EscotMe2: posts the ante 500
Eazy Money G: posts small blind 2000
flushyace31: posts big blind 4000
*** HOLE CARDS ***
Dealt to Kevin12345Mc [9d Kc]
tourrttt!: folds 
official_dapic: folds 
Chalkitup48: folds 
EscotMe2: folds 
ber7nard: folds 
Kevin12345Mc: raises 33387 to 37387 and is all-in
Eazy Money G: folds 
flushyace31: folds 
Uncalled bet (33387) returned to Kevin12345Mc
Kevin12345Mc collected 14000 from pot
Kevin12345Mc: doesn't show hand 
*** SUMMARY ***
Total pot 14000 | Rake 0 
Seat 1: ber7nard folded before Flop (didn't bet)
Seat 2: Kevin12345Mc (button) collected (14000)
Seat 3: Eazy Money G (small blind) folded before Flop
Seat 4: flushyace31 (big blind) folded before Flop
Seat 5: tourrttt! folded before Flop (didn't bet)
Seat 6: official_dapic folded before Flop (didn't bet)
Seat 7: Chalkitup48 folded before Flop (didn't bet)
Seat 8: EscotMe2 folded before Flop (didn't bet)



PokerStars Hand #254991374041: Tournament #3858857107, $2.45+$2.45+$0.60 USD Hold'em No Limit - Level XIX (2000/4000) - 2025/02/22 20:20:37 WET [2025/02/22 15:20:37 ET]
Table '3858857107 291' 8-max Seat #3 is the button
Seat 1: ber7nard (211708 in chips, $10.08 bounty) 
Seat 2: Kevin12345Mc (47387 in chips, $4.89 bounty) 
Seat 3: Eazy Money G (105380 in chips, $7.33 bounty) 
Seat 4: flushyace31 (83180 in chips, $2.45 bounty) 
Seat 5: tourrttt! (143709 in chips, $6.11 bounty) 
Seat 6: official_dapic (100981 in chips, $4.89 bounty) 
Seat 7: Chalkitup48 (54893 in chips, $2.45 bounty) 
Seat 8: EscotMe2 (54275 in chips, $9.16 bounty) 
ber7nard: posts the ante 500
Kevin12345Mc: posts the ante 500
Eazy Money G: posts the ante 500
flushyace31: posts the ante 500
tourrttt!: posts the ante 500
official_dapic: posts the ante 500
Chalkitup48: posts the ante 500
EscotMe2: posts the ante 500
flushyace31: posts small blind 2000
tourrttt!: posts big blind 4000
*** HOLE CARDS ***
Dealt to Kevin12345Mc [8s Kh]
official_dapic: folds 
Chalkitup48: raises 4000 to 8000
EscotMe2: folds 
ber7nard: folds 
Kevin12345Mc: folds 
Eazy Money G: calls 8000
flushyace31: folds 
tourrttt!: folds 
*** FLOP *** [9s Jh Qh]
Chalkitup48: bets 13000
Eazy Money G: calls 13000
*** TURN *** [9s Jh Qh] [8c]
Chalkitup48: checks 
Eazy Money G: bets 52000
Chalkitup48: folds [Js]
Uncalled bet (52000) returned to Eazy Money G
Eazy Money G collected 52000 from pot
*** SUMMARY ***
Total pot 52000 | Rake 0 
Board [9s Jh Qh 8c]
Seat 1: ber7nard folded before Flop (didn't bet)
Seat 2: Kevin12345Mc folded before Flop (didn't bet)
Seat 3: Eazy Money G (button) collected (52000)
Seat 4: flushyace31 (small blind) folded before Flop
Seat 5: tourrttt! (big blind) folded before Flop
Seat 6: official_dapic folded before Flop (didn't bet)
Seat 7: Chalkitup48 folded on the Turn
Seat 8: EscotMe2 folded before Flop (didn't bet)



PokerStars Hand #254991386822: Tournament #3858857107, $2.45+$2.45+$0.60 USD Hold'em No Limit - Level XIX (2000/4000) - 2025/02/22 20:21:22 WET [2025/02/22 15:21:22 ET]
Table '3858857107 291' 8-max Seat #4 is the button
Seat 1: ber7nard (211208 in chips, $10.08 bounty) 
Seat 2: Kevin12345Mc (46887 in chips, $4.89 bounty) 
Seat 3: Eazy Money G (135880 in chips, $7.33 bounty) 
Seat 4: flushyace31 (80680 in chips, $2.45 bounty) 
Seat 5: tourrttt! (139209 in chips, $6.11 bounty) 
Seat 6: official_dapic (100481 in chips, $4.89 bounty) 
Seat 7: Chalkitup48 (33393 in chips, $2.45 bounty) 
Seat 8: EscotMe2 (53775 in chips, $9.16 bounty) 
ber7nard: posts the ante 500
Kevin12345Mc: posts the ante 500
Eazy Money G: posts the ante 500
flushyace31: posts the ante 500
tourrttt!: posts the ante 500
official_dapic: posts the ante 500
Chalkitup48: posts the ante 500
EscotMe2: posts the ante 500
tourrttt!: posts small blind 2000
official_dapic: posts big blind 4000
*** HOLE CARDS ***
Dealt to Kevin12345Mc [5s 7h]
Chalkitup48: folds 
EscotMe2: folds 
ber7nard: folds 
Kevin12345Mc: folds 
Eazy Money G: folds 
flushyace31: folds 
tourrttt!: calls 2000
official_dapic: checks 
*** FLOP *** [9h Qs Tc]
tourrttt!: checks 
official_dapic: checks 
*** TURN *** [9h Qs Tc] [2h]
tourrttt!: bets 4200
official_dapic: calls 4200
*** RIVER *** [9h Qs Tc 2h] [7d]
tourrttt!: checks 
official_dapic: checks 
*** SHOW DOWN ***
tourrttt!: shows [3c Ah] (high card Ace)
official_dapic: shows [Ks 2d] (a pair of Deuces)
official_dapic collected 20400 from pot
*** SUMMARY ***
Total pot 20400 | Rake 0 
Board [9h Qs Tc 2h 7d]
Seat 1: ber7nard folded before Flop (didn't bet)
Seat 2: Kevin12345Mc folded before Flop (didn't bet)
Seat 3: Eazy Money G folded before Flop (didn't bet)
Seat 4: flushyace31 (button) folded before Flop (didn't bet)
Seat 5: tourrttt! (small blind) showed [3c Ah] and lost with high card Ace
Seat 6: official_dapic (big blind) showed [Ks 2d] and won (20400) with a pair of Deuces
Seat 7: Chalkitup48 folded before Flop (didn't bet)
Seat 8: EscotMe2 folded before Flop (didn't bet)



PokerStars Hand #254991401987: Tournament #3858857107, $2.45+$2.45+$0.60 USD Hold'em No Limit - Level XIX (2000/4000) - 2025/02/22 20:22:14 WET [2025/02/22 15:22:14 ET]
Table '3858857107 291' 8-max Seat #5 is the button
Seat 1: ber7nard (210708 in chips, $10.08 bounty) 
Seat 2: Kevin12345Mc (46387 in chips, $4.89 bounty) 
Seat 3: Eazy Money G (135380 in chips, $7.33 bounty) 
Seat 4: flushyace31 (80180 in chips, $2.45 bounty) 
Seat 5: tourrttt! (130509 in chips, $6.11 bounty) 
Seat 6: official_dapic (112181 in chips, $4.89 bounty) 
Seat 7: Chalkitup48 (32893 in chips, $2.45 bounty) 
Seat 8: EscotMe2 (53275 in chips, $9.16 bounty) 
ber7nard: posts the ante 500
Kevin12345Mc: posts the ante 500
Eazy Money G: posts the ante 500
flushyace31: posts the ante 500
tourrttt!: posts the ante 500
official_dapic: posts the ante 500
Chalkitup48: posts the ante 500
EscotMe2: posts the ante 500
official_dapic: posts small blind 2000
Chalkitup48: posts big blind 4000
*** HOLE CARDS ***
Dealt to Kevin12345Mc [Kh Ac]
EscotMe2: folds 
ber7nard: folds 
Kevin12345Mc: raises 41887 to 45887 and is all-in
Eazy Money G: folds 
flushyace31: folds 
tourrttt!: folds 
official_dapic: raises 65794 to 111681 and is all-in
Chalkitup48: folds 
Uncalled bet (65794) returned to official_dapic
*** FLOP *** [Jh Ts 8h]
*** TURN *** [Jh Ts 8h] [6s]
*** RIVER *** [Jh Ts 8h 6s] [Ad]
*** SHOW DOWN ***
official_dapic: shows [As Jc] (two pair, Aces and Jacks)
Kevin12345Mc: shows [Kh Ac] (a pair of Aces)
official_dapic collected 99774 from pot
official_dapic wins $2.45 for eliminating Kevin12345Mc and their own bounty increases by $2.44 to $7.33
Kevin12345Mc finished the tournament in 825th place
*** SUMMARY ***
Total pot 99774 | Rake 0 
Board [Jh Ts 8h 6s Ad]
Seat 1: ber7nard folded before Flop (didn't bet)
Seat 2: Kevin12345Mc showed [Kh Ac] and lost with a pair of Aces
Seat 3: Eazy Money G folded before Flop (didn't bet)
Seat 4: flushyace31 folded before Flop (didn't bet)
Seat 5: tourrttt! (button) folded before Flop (didn't bet)
Seat 6: official_dapic (small blind) showed [As Jc] and won (99774) with two pair, Aces and Jacks
Seat 7: Chalkitup48 (big blind) folded before Flop
Seat 8: EscotMe2 folded before Flop (didn't bet)



