PokerStars Hand #254863113239: Tournament #3856223586, $2.45+$2.45+$0.60 USD Hold'em No Limit - Level I (100/200) - 2025/02/14 17:29:48 WET [2025/02/14 12:29:48 ET]
Table '3856223586 32' 8-max Seat #1 is the button
Seat 1: SAm1otis (25000 in chips, $2.45 bounty) 
Seat 2: hsvmz69 (25000 in chips, $2.45 bounty) 
Seat 3: boidoidu (25000 in chips, $2.45 bounty) 
Seat 4: Dimipkpk (25000 in chips, $2.45 bounty) 
Seat 5: roby_ro29 (25000 in chips, $2.45 bounty) 
Seat 6: Kevin12345Mc (25000 in chips, $2.45 bounty) 
Seat 7: Parduotuve (25000 in chips, $2.45 bounty) 
Seat 8: skillhunter13 (25000 in chips, $2.45 bounty) 
SAm1otis: posts the ante 25
hsvmz69: posts the ante 25
boidoidu: posts the ante 25
Dimipkpk: posts the ante 25
roby_ro29: posts the ante 25
Kevin12345Mc: posts the ante 25
Parduotuve: posts the ante 25
skillhunter13: posts the ante 25
hsvmz69: posts small blind 100
boidoidu: posts big blind 200
*** HOLE CARDS ***
Dealt to Kevin12345Mc [4s 5c]
Dimipkpk: raises 300 to 500
roby_ro29: calls 500
Kevin12345Mc: folds 
Parduotuve: folds 
skillhunter13: folds 
SAm1otis: raises 1700 to 2200
hsvmz69: folds 
boidoidu: folds 
Dimipkpk: folds 
roby_ro29: calls 1700
*** FLOP *** [4d Kc 8s]
roby_ro29: checks 
SAm1otis: bets 1404
roby_ro29: calls 1404
*** TURN *** [4d Kc 8s] [7c]
roby_ro29: checks 
SAm1otis: bets 6320
roby_ro29: calls 6320
*** RIVER *** [4d Kc 8s 7c] [Qd]
roby_ro29: bets 10424
SAm1otis: folds 
Uncalled bet (10424) returned to roby_ro29
roby_ro29 collected 20848 from pot
roby_ro29: doesn't show hand 
*** SUMMARY ***
Total pot 20848 | Rake 0 
Board [4d Kc 8s 7c Qd]
Seat 1: SAm1otis (button) folded on the River
Seat 2: hsvmz69 (small blind) folded before Flop
Seat 3: boidoidu (big blind) folded before Flop
Seat 4: Dimipkpk folded before Flop
Seat 5: roby_ro29 collected (20848)
Seat 6: Kevin12345Mc folded before Flop (didn't bet)
Seat 7: Parduotuve folded before Flop (didn't bet)
Seat 8: skillhunter13 folded before Flop (didn't bet)



PokerStars Hand #254863137301: Tournament #3856223586, $2.45+$2.45+$0.60 USD Hold'em No Limit - Level I (100/200) - 2025/02/14 17:31:26 WET [2025/02/14 12:31:26 ET]
Table '3856223586 32' 8-max Seat #2 is the button
Seat 1: SAm1otis (15051 in chips, $2.45 bounty) 
Seat 2: hsvmz69 (24875 in chips, $2.45 bounty) 
Seat 3: boidoidu (24775 in chips, $2.45 bounty) 
Seat 4: Dimipkpk (24475 in chips, $2.45 bounty) 
Seat 5: roby_ro29 (35899 in chips, $2.45 bounty) 
Seat 6: Kevin12345Mc (24975 in chips, $2.45 bounty) 
Seat 7: Parduotuve (24975 in chips, $2.45 bounty) 
Seat 8: skillhunter13 (24975 in chips, $2.45 bounty) 
SAm1otis: posts the ante 25
hsvmz69: posts the ante 25
boidoidu: posts the ante 25
Dimipkpk: posts the ante 25
roby_ro29: posts the ante 25
Kevin12345Mc: posts the ante 25
Parduotuve: posts the ante 25
skillhunter13: posts the ante 25
boidoidu: posts small blind 100
Dimipkpk: posts big blind 200
*** HOLE CARDS ***
Dealt to Kevin12345Mc [Kh As]
roby_ro29: folds 
Kevin12345Mc: raises 260 to 460
Parduotuve: calls 460
skillhunter13: folds 
SAm1otis: calls 460
hsvmz69: folds 
boidoidu: calls 360
Dimipkpk: raises 23990 to 24450 and is all-in
Kevin12345Mc: raises 500 to 24950 and is all-in
Parduotuve: folds 
SAm1otis: folds 
boidoidu is disconnected 
boidoidu is connected 
boidoidu is connected 
boidoidu: folds 
Uncalled bet (500) returned to Kevin12345Mc
*** FLOP *** [9c Js Qd]
*** TURN *** [9c Js Qd] [6h]
*** RIVER *** [9c Js Qd 6h] [Kc]
*** SHOW DOWN ***
Dimipkpk: shows [Ks Ac] (a pair of Kings)
Kevin12345Mc: shows [Kh As] (a pair of Kings)
Dimipkpk collected 25240 from pot
Kevin12345Mc collected 25240 from pot
*** SUMMARY ***
Total pot 50480 | Rake 0 
Board [9c Js Qd 6h Kc]
Seat 1: SAm1otis folded before Flop
Seat 2: hsvmz69 (button) folded before Flop (didn't bet)
Seat 3: boidoidu (small blind) folded before Flop
Seat 4: Dimipkpk (big blind) showed [Ks Ac] and won (25240) with a pair of Kings
Seat 5: roby_ro29 folded before Flop (didn't bet)
Seat 6: Kevin12345Mc showed [Kh As] and won (25240) with a pair of Kings
Seat 7: Parduotuve folded before Flop
Seat 8: skillhunter13 folded before Flop (didn't bet)



PokerStars Hand #254863155317: Tournament #3856223586, $2.45+$2.45+$0.60 USD Hold'em No Limit - Level I (100/200) - 2025/02/14 17:32:39 WET [2025/02/14 12:32:39 ET]
Table '3856223586 32' 8-max Seat #3 is the button
Seat 1: SAm1otis (14566 in chips, $2.45 bounty) 
Seat 2: hsvmz69 (24850 in chips, $2.45 bounty) 
Seat 3: boidoidu (24290 in chips, $2.45 bounty) 
Seat 4: Dimipkpk (25240 in chips, $2.45 bounty) 
Seat 6: Kevin12345Mc (25740 in chips, $2.45 bounty) 
Seat 7: Parduotuve (24490 in chips, $2.45 bounty) 
Seat 8: skillhunter13 (24950 in chips, $2.45 bounty) 
SAm1otis: posts the ante 25
hsvmz69: posts the ante 25
boidoidu: posts the ante 25
Dimipkpk: posts the ante 25
Kevin12345Mc: posts the ante 25
Parduotuve: posts the ante 25
skillhunter13: posts the ante 25
Dimipkpk: posts small blind 100
Kevin12345Mc: posts big blind 200
*** HOLE CARDS ***
Dealt to Kevin12345Mc [9d 2c]
neowolffi is disconnected 
Parduotuve: calls 200
skillhunter13: folds 
SAm1otis: raises 1200 to 1400
hsvmz69: folds 
boidoidu: folds 
Dimipkpk: folds 
Kevin12345Mc: folds 
Parduotuve: calls 1200
*** FLOP *** [4d 8c Kd]
Parduotuve: checks 
SAm1otis: bets 1274
Parduotuve: folds 
Uncalled bet (1274) returned to SAm1otis
SAm1otis collected 3275 from pot
*** SUMMARY ***
Total pot 3275 | Rake 0 
Board [4d 8c Kd]
Seat 1: SAm1otis collected (3275)
Seat 2: hsvmz69 folded before Flop (didn't bet)
Seat 3: boidoidu (button) folded before Flop (didn't bet)
Seat 4: Dimipkpk (small blind) folded before Flop
Seat 6: Kevin12345Mc (big blind) folded before Flop
Seat 7: Parduotuve folded on the Flop
Seat 8: skillhunter13 folded before Flop (didn't bet)



PokerStars Hand #254863168947: Tournament #3856223586, $2.45+$2.45+$0.60 USD Hold'em No Limit - Level I (100/200) - 2025/02/14 17:33:34 WET [2025/02/14 12:33:34 ET]
Table '3856223586 32' 8-max Seat #4 is the button
Seat 1: SAm1otis (16416 in chips, $2.45 bounty) 
Seat 2: hsvmz69 (24825 in chips, $2.45 bounty) 
Seat 3: boidoidu (24265 in chips, $2.45 bounty) 
Seat 4: Dimipkpk (25115 in chips, $2.45 bounty) 
Seat 5: neowolffi (25000 in chips) out of hand (moved from another table into small blind)
Seat 6: Kevin12345Mc (25515 in chips, $2.45 bounty) 
Seat 7: Parduotuve (23065 in chips, $2.45 bounty) 
Seat 8: skillhunter13 (24925 in chips, $2.45 bounty) 
neowolffi will be allowed to play after the button
SAm1otis: posts the ante 25
hsvmz69: posts the ante 25
boidoidu: posts the ante 25
Dimipkpk: posts the ante 25
Kevin12345Mc: posts the ante 25
Parduotuve: posts the ante 25
skillhunter13: posts the ante 25
Kevin12345Mc: posts small blind 100
Parduotuve: posts big blind 200
*** HOLE CARDS ***
Dealt to Kevin12345Mc [Qs 4s]
skillhunter13: folds 
SAm1otis: calls 200
hsvmz69: folds 
boidoidu: folds 
Dimipkpk: folds 
Kevin12345Mc: calls 100
Parduotuve: raises 1000 to 1200
SAm1otis: calls 1000
Kevin12345Mc: folds 
*** FLOP *** [4d Jd Qd]
Parduotuve: bets 2775
SAm1otis: folds 
Uncalled bet (2775) returned to Parduotuve
Parduotuve collected 2775 from pot
Parduotuve: doesn't show hand 
*** SUMMARY ***
Total pot 2775 | Rake 0 
Board [4d Jd Qd]
Seat 1: SAm1otis folded on the Flop
Seat 2: hsvmz69 folded before Flop (didn't bet)
Seat 3: boidoidu folded before Flop (didn't bet)
Seat 4: Dimipkpk (button) folded before Flop (didn't bet)
Seat 6: Kevin12345Mc (small blind) folded before Flop
Seat 7: Parduotuve (big blind) collected (2775)
Seat 8: skillhunter13 folded before Flop (didn't bet)



PokerStars Hand #254863178353: Tournament #3856223586, $2.45+$2.45+$0.60 USD Hold'em No Limit - Level I (100/200) - 2025/02/14 17:34:13 WET [2025/02/14 12:34:13 ET]
Table '3856223586 32' 8-max Seat #6 is the button
Seat 1: SAm1otis (15191 in chips, $2.45 bounty) 
Seat 2: hsvmz69 (24800 in chips, $2.45 bounty) 
Seat 3: boidoidu (24240 in chips, $2.45 bounty) 
Seat 4: Dimipkpk (25090 in chips, $2.45 bounty) 
Seat 5: neowolffi (25000 in chips, $2.45 bounty) 
Seat 6: Kevin12345Mc (25290 in chips, $2.45 bounty) 
Seat 7: Parduotuve (24615 in chips, $2.45 bounty) 
SAm1otis: posts the ante 25
hsvmz69: posts the ante 25
boidoidu: posts the ante 25
Dimipkpk: posts the ante 25
neowolffi: posts the ante 25
Kevin12345Mc: posts the ante 25
Parduotuve: posts the ante 25
Parduotuve: posts small blind 100
SAm1otis: posts big blind 200
*** HOLE CARDS ***
Dealt to Kevin12345Mc [3c 6d]
hsvmz69: folds 
igor okumura is disconnected 
boidoidu: folds 
Dimipkpk: folds 
neowolffi: folds 
Kevin12345Mc: folds 
Parduotuve: folds 
Uncalled bet (100) returned to SAm1otis
SAm1otis collected 375 from pot
*** SUMMARY ***
Total pot 375 | Rake 0 
Seat 1: SAm1otis (big blind) collected (375)
Seat 2: hsvmz69 folded before Flop (didn't bet)
Seat 3: boidoidu folded before Flop (didn't bet)
Seat 4: Dimipkpk folded before Flop (didn't bet)
Seat 5: neowolffi folded before Flop (didn't bet)
Seat 6: Kevin12345Mc (button) folded before Flop (didn't bet)
Seat 7: Parduotuve (small blind) folded before Flop



PokerStars Hand #254863181610: Tournament #3856223586, $2.45+$2.45+$0.60 USD Hold'em No Limit - Level I (100/200) - 2025/02/14 17:34:26 WET [2025/02/14 12:34:26 ET]
Table '3856223586 32' 8-max Seat #7 is the button
Seat 1: SAm1otis (15441 in chips, $2.45 bounty) 
Seat 3: boidoidu (24215 in chips, $2.45 bounty) 
Seat 4: Dimipkpk (25065 in chips, $2.45 bounty) 
Seat 5: neowolffi (24975 in chips, $2.45 bounty) 
Seat 6: Kevin12345Mc (25265 in chips, $2.45 bounty) 
Seat 7: Parduotuve (24490 in chips, $2.45 bounty) 
Seat 8: igor okumura (25000 in chips) out of hand (moved from another table into small blind)
igor okumura will be allowed to play after the button
SAm1otis: posts the ante 25
boidoidu: posts the ante 25
Dimipkpk: posts the ante 25
neowolffi: posts the ante 25
Kevin12345Mc: posts the ante 25
Parduotuve: posts the ante 25
SAm1otis: posts small blind 100
boidoidu: posts big blind 200
*** HOLE CARDS ***
Dealt to Kevin12345Mc [As Qd]
Dimipkpk: folds 
neowolffi: folds 
Kevin12345Mc: raises 260 to 460
Parduotuve: folds 
SAm1otis: raises 1300 to 1760
boidoidu: folds 
Kevin12345Mc: calls 1300
*** FLOP *** [8c Td 3d]
SAm1otis: bets 1006
Kevin12345Mc: calls 1006
*** TURN *** [8c Td 3d] [2s]
SAm1otis: bets 3640
Kevin12345Mc: folds 
Uncalled bet (3640) returned to SAm1otis
SAm1otis collected 5882 from pot
*** SUMMARY ***
Total pot 5882 | Rake 0 
Board [8c Td 3d 2s]
Seat 1: SAm1otis (small blind) collected (5882)
Seat 3: boidoidu (big blind) folded before Flop
Seat 4: Dimipkpk folded before Flop (didn't bet)
Seat 5: neowolffi folded before Flop (didn't bet)
Seat 6: Kevin12345Mc folded on the Turn
Seat 7: Parduotuve (button) folded before Flop (didn't bet)



PokerStars Hand #254863197551: Tournament #3856223586, $2.45+$2.45+$0.60 USD Hold'em No Limit - Level I (100/200) - 2025/02/14 17:35:32 WET [2025/02/14 12:35:32 ET]
Table '3856223586 32' 8-max Seat #1 is the button
Seat 1: SAm1otis (18532 in chips, $2.45 bounty) 
Seat 2: zambrotahagi (25000 in chips) out of hand (moved from another table into small blind)
Seat 3: boidoidu (23990 in chips, $2.45 bounty) 
Seat 4: Dimipkpk (25040 in chips, $2.45 bounty) 
Seat 5: neowolffi (24950 in chips, $2.45 bounty) 
Seat 6: Kevin12345Mc (22474 in chips, $2.45 bounty) 
Seat 7: Parduotuve (24465 in chips, $2.45 bounty) 
Seat 8: igor okumura (25000 in chips, $2.45 bounty) 
zambrotahagi will be allowed to play after the button
SAm1otis: posts the ante 25
boidoidu: posts the ante 25
Dimipkpk: posts the ante 25
neowolffi: posts the ante 25
Kevin12345Mc: posts the ante 25
Parduotuve: posts the ante 25
igor okumura: posts the ante 25
boidoidu: posts small blind 100
Dimipkpk: posts big blind 200
*** HOLE CARDS ***
Dealt to Kevin12345Mc [6h Qc]
neowolffi: calls 200
Kevin12345Mc: folds 
Parduotuve: folds 
igor okumura: folds 
SAm1otis: calls 200
boidoidu: calls 100
Dimipkpk: checks 
*** FLOP *** [Jc 6s 4s]
boidoidu: checks 
Dimipkpk: checks 
neowolffi: checks 
SAm1otis: bets 751
boidoidu: folds 
Dimipkpk: folds 
neowolffi: calls 751
*** TURN *** [Jc 6s 4s] [9c]
neowolffi: checks 
SAm1otis: bets 1907
neowolffi: calls 1907
*** RIVER *** [Jc 6s 4s 9c] [3h]
neowolffi: checks 
SAm1otis: checks 
*** SHOW DOWN ***
neowolffi: shows [Qs Ah] (high card Ace)
SAm1otis: shows [Ac 6d] (a pair of Sixes)
SAm1otis collected 6291 from pot
*** SUMMARY ***
Total pot 6291 | Rake 0 
Board [Jc 6s 4s 9c 3h]
Seat 1: SAm1otis (button) showed [Ac 6d] and won (6291) with a pair of Sixes
Seat 3: boidoidu (small blind) folded on the Flop
Seat 4: Dimipkpk (big blind) folded on the Flop
Seat 5: neowolffi showed [Qs Ah] and lost with high card Ace
Seat 6: Kevin12345Mc folded before Flop (didn't bet)
Seat 7: Parduotuve folded before Flop (didn't bet)
Seat 8: igor okumura folded before Flop (didn't bet)



PokerStars Hand #254863219305: Tournament #3856223586, $2.45+$2.45+$0.60 USD Hold'em No Limit - Level I (100/200) - 2025/02/14 17:37:01 WET [2025/02/14 12:37:01 ET]
Table '3856223586 32' 8-max Seat #3 is the button
Seat 1: SAm1otis (21940 in chips, $2.45 bounty) 
Seat 2: zambrotahagi (25000 in chips, $2.45 bounty) 
Seat 3: boidoidu (23765 in chips, $2.45 bounty) 
Seat 4: Dimipkpk (24815 in chips, $2.45 bounty) 
Seat 5: neowolffi (22067 in chips, $2.45 bounty) 
Seat 6: Kevin12345Mc (22449 in chips, $2.45 bounty) 
Seat 7: Parduotuve (24440 in chips, $2.45 bounty) 
Seat 8: igor okumura (24975 in chips, $2.45 bounty) 
SAm1otis: posts the ante 25
zambrotahagi: posts the ante 25
boidoidu: posts the ante 25
Dimipkpk: posts the ante 25
neowolffi: posts the ante 25
Kevin12345Mc: posts the ante 25
Parduotuve: posts the ante 25
igor okumura: posts the ante 25
Dimipkpk: posts small blind 100
neowolffi: posts big blind 200
*** HOLE CARDS ***
Dealt to Kevin12345Mc [3h 9d]
Kevin12345Mc: folds 
Parduotuve: folds 
igor okumura: raises 200 to 400
SAm1otis: folds 
zambrotahagi: raises 1300 to 1700
boidoidu: folds 
Dimipkpk: folds 
neowolffi: calls 1500
igor okumura: calls 1300
*** FLOP *** [5h 4s Js]
neowolffi: checks 
igor okumura: checks 
zambrotahagi: bets 2700
neowolffi: calls 2700
igor okumura: folds 
*** TURN *** [5h 4s Js] [Jd]
neowolffi: checks 
zambrotahagi: checks 
*** RIVER *** [5h 4s Js Jd] [3c]
neowolffi: bets 5400
zambrotahagi: calls 5400
*** SHOW DOWN ***
neowolffi: shows [Jh Kc] (three of a kind, Jacks)
zambrotahagi: mucks hand 
neowolffi collected 21600 from pot
*** SUMMARY ***
Total pot 21600 | Rake 0 
Board [5h 4s Js Jd 3c]
Seat 1: SAm1otis folded before Flop (didn't bet)
Seat 2: zambrotahagi mucked [As Ad]
Seat 3: boidoidu (button) folded before Flop (didn't bet)
Seat 4: Dimipkpk (small blind) folded before Flop
Seat 5: neowolffi (big blind) showed [Jh Kc] and won (21600) with three of a kind, Jacks
Seat 6: Kevin12345Mc folded before Flop (didn't bet)
Seat 7: Parduotuve folded before Flop (didn't bet)
Seat 8: igor okumura folded on the Flop



PokerStars Hand #254863236265: Tournament #3856223586, $2.45+$2.45+$0.60 USD Hold'em No Limit - Level II (125/250) - 2025/02/14 17:38:11 WET [2025/02/14 12:38:11 ET]
Table '3856223586 32' 8-max Seat #4 is the button
Seat 1: SAm1otis (21915 in chips, $2.45 bounty) 
Seat 2: zambrotahagi (15175 in chips, $2.45 bounty) 
Seat 3: boidoidu (23740 in chips, $2.45 bounty) 
Seat 4: Dimipkpk (24690 in chips, $2.45 bounty) 
Seat 5: neowolffi (33842 in chips, $2.45 bounty) 
Seat 6: Kevin12345Mc (22424 in chips, $2.45 bounty) 
Seat 7: Parduotuve (24415 in chips, $2.45 bounty) 
Seat 8: igor okumura (23250 in chips, $2.45 bounty) 
SAm1otis: posts the ante 30
zambrotahagi: posts the ante 30
boidoidu: posts the ante 30
Dimipkpk: posts the ante 30
neowolffi: posts the ante 30
Kevin12345Mc: posts the ante 30
Parduotuve: posts the ante 30
igor okumura: posts the ante 30
neowolffi: posts small blind 125
Kevin12345Mc: posts big blind 250
*** HOLE CARDS ***
Dealt to Kevin12345Mc [Th 5s]
Parduotuve: folds 
igor okumura: folds 
SAm1otis: folds 
zambrotahagi: folds 
boidoidu: raises 250 to 500
Dimipkpk: raises 1212 to 1712
neowolffi: folds 
Kevin12345Mc: folds 
boidoidu: calls 1212
*** FLOP *** [7h 2h 7s]
boidoidu: checks 
Dimipkpk: bets 1285
boidoidu: calls 1285
*** TURN *** [7h 2h 7s] [9d]
boidoidu: checks 
Dimipkpk: bets 4664
boidoidu: folds 
Uncalled bet (4664) returned to Dimipkpk
Dimipkpk collected 6609 from pot
Dimipkpk: doesn't show hand 
*** SUMMARY ***
Total pot 6609 | Rake 0 
Board [7h 2h 7s 9d]
Seat 1: SAm1otis folded before Flop (didn't bet)
Seat 2: zambrotahagi folded before Flop (didn't bet)
Seat 3: boidoidu folded on the Turn
Seat 4: Dimipkpk (button) collected (6609)
Seat 5: neowolffi (small blind) folded before Flop
Seat 6: Kevin12345Mc (big blind) folded before Flop
Seat 7: Parduotuve folded before Flop (didn't bet)
Seat 8: igor okumura folded before Flop (didn't bet)



PokerStars Hand #254863253656: Tournament #3856223586, $2.45+$2.45+$0.60 USD Hold'em No Limit - Level II (125/250) - 2025/02/14 17:39:22 WET [2025/02/14 12:39:22 ET]
Table '3856223586 32' 8-max Seat #5 is the button
Seat 1: SAm1otis (21885 in chips, $2.45 bounty) 
Seat 2: zambrotahagi (15145 in chips, $2.45 bounty) 
Seat 3: boidoidu (20713 in chips, $2.45 bounty) 
Seat 4: Dimipkpk (28272 in chips, $2.45 bounty) 
Seat 5: neowolffi (33687 in chips, $2.45 bounty) 
Seat 6: Kevin12345Mc (22144 in chips, $2.45 bounty) 
Seat 7: Parduotuve (24385 in chips, $2.45 bounty) 
Seat 8: igor okumura (23220 in chips, $2.45 bounty) 
SAm1otis: posts the ante 30
zambrotahagi: posts the ante 30
boidoidu: posts the ante 30
Dimipkpk: posts the ante 30
neowolffi: posts the ante 30
Kevin12345Mc: posts the ante 30
Parduotuve: posts the ante 30
igor okumura: posts the ante 30
Kevin12345Mc: posts small blind 125
Parduotuve: posts big blind 250
*** HOLE CARDS ***
Dealt to Kevin12345Mc [2h 5h]
igor okumura: folds 
SAm1otis: raises 250 to 500
zambrotahagi: folds 
boidoidu: calls 500
Dimipkpk: folds 
neowolffi: calls 500
Kevin12345Mc: folds 
Parduotuve: raises 2500 to 3000
SAm1otis: folds 
boidoidu: folds 
neowolffi: calls 2500
*** FLOP *** [6c 3s Kd]
Parduotuve: bets 7365
neowolffi: calls 7365
*** TURN *** [6c 3s Kd] [3h]
Parduotuve: bets 13990 and is all-in
neowolffi: calls 13990
*** RIVER *** [6c 3s Kd 3h] [As]
*** SHOW DOWN ***
Parduotuve: shows [Ks Ah] (two pair, Aces and Kings)
neowolffi: shows [9c Kc] (two pair, Kings and Threes)
Parduotuve collected 50075 from pot
*** SUMMARY ***
Total pot 50075 | Rake 0 
Board [6c 3s Kd 3h As]
Seat 1: SAm1otis folded before Flop
Seat 2: zambrotahagi folded before Flop (didn't bet)
Seat 3: boidoidu folded before Flop
Seat 4: Dimipkpk folded before Flop (didn't bet)
Seat 5: neowolffi (button) showed [9c Kc] and lost with two pair, Kings and Threes
Seat 6: Kevin12345Mc (small blind) folded before Flop
Seat 7: Parduotuve (big blind) showed [Ks Ah] and won (50075) with two pair, Aces and Kings
Seat 8: igor okumura folded before Flop (didn't bet)



PokerStars Hand #254863267914: Tournament #3856223586, $2.45+$2.45+$0.60 USD Hold'em No Limit - Level II (125/250) - 2025/02/14 17:40:22 WET [2025/02/14 12:40:22 ET]
Table '3856223586 32' 8-max Seat #6 is the button
Seat 1: SAm1otis (21355 in chips, $2.45 bounty) 
Seat 2: zambrotahagi (15115 in chips, $2.45 bounty) 
Seat 3: boidoidu (20183 in chips, $2.45 bounty) 
Seat 4: Dimipkpk (28242 in chips, $2.45 bounty) 
Seat 5: neowolffi (9302 in chips, $2.45 bounty) 
Seat 6: Kevin12345Mc (21989 in chips, $2.45 bounty) 
Seat 7: Parduotuve (50075 in chips, $2.45 bounty) 
Seat 8: igor okumura (23190 in chips, $2.45 bounty) 
SAm1otis: posts the ante 30
zambrotahagi: posts the ante 30
boidoidu: posts the ante 30
Dimipkpk: posts the ante 30
neowolffi: posts the ante 30
Kevin12345Mc: posts the ante 30
Parduotuve: posts the ante 30
igor okumura: posts the ante 30
Parduotuve: posts small blind 125
igor okumura: posts big blind 250
*** HOLE CARDS ***
Dealt to Kevin12345Mc [4s Ts]
SAm1otis: folds 
zambrotahagi: folds 
boidoidu: folds 
Dimipkpk: folds 
neowolffi: raises 9022 to 9272 and is all-in
Kevin12345Mc: folds 
Parduotuve: calls 9147
igor okumura: folds 
*** FLOP *** [4c As 6s]
*** TURN *** [4c As 6s] [Th]
*** RIVER *** [4c As 6s Th] [Kh]
*** SHOW DOWN ***
Parduotuve: shows [Ah 5h] (a pair of Aces)
neowolffi: shows [Ad Qh] (a pair of Aces - King+Queen kicker)
neowolffi collected 19034 from pot
*** SUMMARY ***
Total pot 19034 | Rake 0 
Board [4c As 6s Th Kh]
Seat 1: SAm1otis folded before Flop (didn't bet)
Seat 2: zambrotahagi folded before Flop (didn't bet)
Seat 3: boidoidu folded before Flop (didn't bet)
Seat 4: Dimipkpk folded before Flop (didn't bet)
Seat 5: neowolffi showed [Ad Qh] and won (19034) with a pair of Aces
Seat 6: Kevin12345Mc (button) folded before Flop (didn't bet)
Seat 7: Parduotuve (small blind) showed [Ah 5h] and lost with a pair of Aces
Seat 8: igor okumura (big blind) folded before Flop



PokerStars Hand #254863276782: Tournament #3856223586, $2.45+$2.45+$0.60 USD Hold'em No Limit - Level II (125/250) - 2025/02/14 17:40:58 WET [2025/02/14 12:40:58 ET]
Table '3856223586 32' 8-max Seat #7 is the button
Seat 1: SAm1otis (21325 in chips, $2.45 bounty) 
Seat 2: zambrotahagi (15085 in chips, $2.45 bounty) 
Seat 3: boidoidu (20153 in chips, $2.45 bounty) 
Seat 4: Dimipkpk (28212 in chips, $2.45 bounty) 
Seat 5: neowolffi (19034 in chips, $2.45 bounty) 
Seat 6: Kevin12345Mc (21959 in chips, $2.45 bounty) 
Seat 7: Parduotuve (40773 in chips, $2.45 bounty) 
Seat 8: igor okumura (22910 in chips, $2.45 bounty) 
SAm1otis: posts the ante 30
zambrotahagi: posts the ante 30
boidoidu: posts the ante 30
Dimipkpk: posts the ante 30
neowolffi: posts the ante 30
Kevin12345Mc: posts the ante 30
Parduotuve: posts the ante 30
igor okumura: posts the ante 30
igor okumura: posts small blind 125
SAm1otis: posts big blind 250
*** HOLE CARDS ***
Dealt to Kevin12345Mc [Ac 2s]
zambrotahagi: folds 
boidoidu: folds 
Dimipkpk: folds 
neowolffi: folds 
Kevin12345Mc: folds 
Parduotuve: folds 
igor okumura: calls 125
SAm1otis: raises 500 to 750
igor okumura: calls 500
*** FLOP *** [5s Td 3h]
igor okumura: checks 
SAm1otis: bets 452
igor okumura: calls 452
*** TURN *** [5s Td 3h] [8h]
igor okumura: checks 
SAm1otis: bets 1190
igor okumura: calls 1190
*** RIVER *** [5s Td 3h 8h] [Qc]
igor okumura: checks 
SAm1otis: checks 
*** SHOW DOWN ***
igor okumura: shows [4s Ts] (a pair of Tens)
SAm1otis: mucks hand 
igor okumura collected 5024 from pot
*** SUMMARY ***
Total pot 5024 | Rake 0 
Board [5s Td 3h 8h Qc]
Seat 1: SAm1otis (big blind) mucked [Kh 8s]
Seat 2: zambrotahagi folded before Flop (didn't bet)
Seat 3: boidoidu folded before Flop (didn't bet)
Seat 4: Dimipkpk folded before Flop (didn't bet)
Seat 5: neowolffi folded before Flop (didn't bet)
Seat 6: Kevin12345Mc folded before Flop (didn't bet)
Seat 7: Parduotuve (button) folded before Flop (didn't bet)
Seat 8: igor okumura (small blind) showed [4s Ts] and won (5024) with a pair of Tens



PokerStars Hand #254863297748: Tournament #3856223586, $2.45+$2.45+$0.60 USD Hold'em No Limit - Level II (125/250) - 2025/02/14 17:42:24 WET [2025/02/14 12:42:24 ET]
Table '3856223586 32' 8-max Seat #8 is the button
Seat 1: SAm1otis (18903 in chips, $2.45 bounty) 
Seat 2: zambrotahagi (15055 in chips, $2.45 bounty) 
Seat 3: boidoidu (20123 in chips, $2.45 bounty) 
Seat 4: Dimipkpk (28182 in chips, $2.45 bounty) 
Seat 5: neowolffi (19004 in chips, $2.45 bounty) 
Seat 6: Kevin12345Mc (21929 in chips, $2.45 bounty) 
Seat 7: Parduotuve (40743 in chips, $2.45 bounty) 
Seat 8: igor okumura (25512 in chips, $2.45 bounty) 
SAm1otis: posts the ante 30
zambrotahagi: posts the ante 30
boidoidu: posts the ante 30
Dimipkpk: posts the ante 30
neowolffi: posts the ante 30
Kevin12345Mc: posts the ante 30
Parduotuve: posts the ante 30
igor okumura: posts the ante 30
SAm1otis: posts small blind 125
zambrotahagi: posts big blind 250
*** HOLE CARDS ***
Dealt to Kevin12345Mc [4h 2s]
boidoidu: folds 
Dimipkpk: folds 
neowolffi: calls 250
Kevin12345Mc: folds 
Parduotuve: calls 250
igor okumura: folds 
SAm1otis: raises 1500 to 1750
zambrotahagi: folds 
neowolffi: calls 1500
Parduotuve: folds 
*** FLOP *** [5h 8h Jc]
SAm1otis: bets 1102
neowolffi: raises 1102 to 2204
SAm1otis: raises 1102 to 3306
neowolffi: raises 13918 to 17224 and is all-in
SAm1otis: calls 13817 and is all-in
Uncalled bet (101) returned to neowolffi
*** TURN *** [5h 8h Jc] [Ts]
*** RIVER *** [5h 8h Jc Ts] [Jd]
*** SHOW DOWN ***
SAm1otis: shows [Qc Ad] (a pair of Jacks)
neowolffi: shows [Js Kc] (three of a kind, Jacks)
neowolffi collected 38486 from pot
neowolffi wins $1.23 for eliminating SAm1otis and their own bounty increases by $1.22 to $3.67
SAm1otis finished the tournament
*** SUMMARY ***
Total pot 38486 | Rake 0 
Board [5h 8h Jc Ts Jd]
Seat 1: SAm1otis (small blind) showed [Qc Ad] and lost with a pair of Jacks
Seat 2: zambrotahagi (big blind) folded before Flop
Seat 3: boidoidu folded before Flop (didn't bet)
Seat 4: Dimipkpk folded before Flop (didn't bet)
Seat 5: neowolffi showed [Js Kc] and won (38486) with three of a kind, Jacks
Seat 6: Kevin12345Mc folded before Flop (didn't bet)
Seat 7: Parduotuve folded before Flop
Seat 8: igor okumura (button) folded before Flop (didn't bet)



PokerStars Hand #254863312002: Tournament #3856223586, $2.45+$2.45+$0.60 USD Hold'em No Limit - Level II (125/250) - 2025/02/14 17:43:22 WET [2025/02/14 12:43:22 ET]
Table '3856223586 32' 8-max Seat #2 is the button
Seat 2: zambrotahagi (14775 in chips, $2.45 bounty) 
Seat 3: boidoidu (20093 in chips, $2.45 bounty) 
Seat 4: Dimipkpk (28152 in chips, $2.45 bounty) 
Seat 5: neowolffi (38587 in chips, $3.67 bounty) 
Seat 6: Kevin12345Mc (21899 in chips, $2.45 bounty) 
Seat 7: Parduotuve (40463 in chips, $2.45 bounty) 
Seat 8: igor okumura (25482 in chips, $2.45 bounty) 
zambrotahagi: posts the ante 30
boidoidu: posts the ante 30
Dimipkpk: posts the ante 30
neowolffi: posts the ante 30
Kevin12345Mc: posts the ante 30
Parduotuve: posts the ante 30
igor okumura: posts the ante 30
boidoidu: posts small blind 125
Dimipkpk: posts big blind 250
*** HOLE CARDS ***
Dealt to Kevin12345Mc [Kc Jh]
neowolffi: folds 
Kevin12345Mc: raises 325 to 575
posetuta is disconnected 
Parduotuve: folds 
igor okumura: folds 
zambrotahagi: folds 
boidoidu: folds 
Dimipkpk: calls 325
*** FLOP *** [Tc 2h 9h]
Dimipkpk: checks 
Kevin12345Mc: checks 
*** TURN *** [Tc 2h 9h] [7h]
Dimipkpk: bets 520
Kevin12345Mc: calls 520
*** RIVER *** [Tc 2h 9h 7h] [7d]
Dimipkpk: bets 884
Kevin12345Mc: folds 
Uncalled bet (884) returned to Dimipkpk
Dimipkpk collected 2525 from pot
Dimipkpk: doesn't show hand 
*** SUMMARY ***
Total pot 2525 | Rake 0 
Board [Tc 2h 9h 7h 7d]
Seat 2: zambrotahagi (button) folded before Flop (didn't bet)
Seat 3: boidoidu (small blind) folded before Flop
Seat 4: Dimipkpk (big blind) collected (2525)
Seat 5: neowolffi folded before Flop (didn't bet)
Seat 6: Kevin12345Mc folded on the River
Seat 7: Parduotuve folded before Flop (didn't bet)
Seat 8: igor okumura folded before Flop (didn't bet)



PokerStars Hand #254863333574: Tournament #3856223586, $2.45+$2.45+$0.60 USD Hold'em No Limit - Level II (125/250) - 2025/02/14 17:44:51 WET [2025/02/14 12:44:51 ET]
Table '3856223586 32' 8-max Seat #3 is the button
Seat 1: posetuta (25000 in chips, $2.45 bounty) 
Seat 2: zambrotahagi (14745 in chips, $2.45 bounty) 
Seat 3: boidoidu (19938 in chips, $2.45 bounty) 
Seat 4: Dimipkpk (29552 in chips, $2.45 bounty) 
Seat 6: Kevin12345Mc (20774 in chips, $2.45 bounty) 
Seat 7: Parduotuve (40433 in chips, $2.45 bounty) 
Seat 8: igor okumura (25452 in chips, $2.45 bounty) 
posetuta: posts the ante 30
zambrotahagi: posts the ante 30
boidoidu: posts the ante 30
Dimipkpk: posts the ante 30
Kevin12345Mc: posts the ante 30
Parduotuve: posts the ante 30
igor okumura: posts the ante 30
Dimipkpk: posts small blind 125
Kevin12345Mc: posts big blind 250
*** HOLE CARDS ***
Dealt to Kevin12345Mc [2d Tc]
KECAKUATL is disconnected 
Parduotuve: calls 250
igor okumura: folds 
posetuta: folds 
zambrotahagi: folds 
boidoidu: raises 1085 to 1335
Dimipkpk: folds 
Kevin12345Mc: folds 
Parduotuve: calls 1085
*** FLOP *** [Ts 7d 4d]
Parduotuve: bets 39068 and is all-in
boidoidu: calls 18573 and is all-in
Uncalled bet (20495) returned to Parduotuve
*** TURN *** [Ts 7d 4d] [4c]
*** RIVER *** [Ts 7d 4d 4c] [Ac]
*** SHOW DOWN ***
Parduotuve: shows [7s 6s] (two pair, Sevens and Fours)
boidoidu: shows [7h Ad] (two pair, Aces and Sevens)
boidoidu collected 40401 from pot
*** SUMMARY ***
Total pot 40401 | Rake 0 
Board [Ts 7d 4d 4c Ac]
Seat 1: posetuta folded before Flop (didn't bet)
Seat 2: zambrotahagi folded before Flop (didn't bet)
Seat 3: boidoidu (button) showed [7h Ad] and won (40401) with two pair, Aces and Sevens
Seat 4: Dimipkpk (small blind) folded before Flop
Seat 6: Kevin12345Mc (big blind) folded before Flop
Seat 7: Parduotuve showed [7s 6s] and lost with two pair, Sevens and Fours
Seat 8: igor okumura folded before Flop (didn't bet)



PokerStars Hand #254863349870: Tournament #3856223586, $2.45+$2.45+$0.60 USD Hold'em No Limit - Level III (150/300) - 2025/02/14 17:45:56 WET [2025/02/14 12:45:56 ET]
Table '3856223586 32' 8-max Seat #4 is the button
Seat 1: posetuta (24970 in chips, $2.45 bounty) 
Seat 2: zambrotahagi (14715 in chips, $2.45 bounty) 
Seat 3: boidoidu (40401 in chips, $2.45 bounty) 
Seat 4: Dimipkpk (29397 in chips, $2.45 bounty) 
Seat 5: KECAKUATL (25000 in chips) out of hand (moved from another table into small blind)
Seat 6: Kevin12345Mc (20494 in chips, $2.45 bounty) 
Seat 7: Parduotuve (20495 in chips, $2.45 bounty) 
Seat 8: igor okumura (25422 in chips, $2.45 bounty) 
KECAKUATL will be allowed to play after the button
posetuta: posts the ante 40
zambrotahagi: posts the ante 40
boidoidu: posts the ante 40
Dimipkpk: posts the ante 40
Kevin12345Mc: posts the ante 40
Parduotuve: posts the ante 40
igor okumura: posts the ante 40
Kevin12345Mc: posts small blind 150
Parduotuve: posts big blind 300
*** HOLE CARDS ***
Dealt to Kevin12345Mc [4d 6h]
igor okumura: folds 
posetuta: folds 
zambrotahagi: folds 
boidoidu: folds 
Dimipkpk: raises 450 to 750
Kevin12345Mc: folds 
Parduotuve: raises 19705 to 20455 and is all-in
Dimipkpk: folds 
Uncalled bet (19705) returned to Parduotuve
Parduotuve collected 1930 from pot
Parduotuve: doesn't show hand 
*** SUMMARY ***
Total pot 1930 | Rake 0 
Seat 1: posetuta folded before Flop (didn't bet)
Seat 2: zambrotahagi folded before Flop (didn't bet)
Seat 3: boidoidu folded before Flop (didn't bet)
Seat 4: Dimipkpk (button) folded before Flop
Seat 6: Kevin12345Mc (small blind) folded before Flop
Seat 7: Parduotuve (big blind) collected (1930)
Seat 8: igor okumura folded before Flop (didn't bet)



PokerStars Hand #254863364195: Tournament #3856223586, $2.45+$2.45+$0.60 USD Hold'em No Limit - Level III (150/300) - 2025/02/14 17:46:54 WET [2025/02/14 12:46:54 ET]
Table '3856223586 32' 8-max Seat #6 is the button
Seat 1: posetuta (24930 in chips, $2.45 bounty) 
Seat 2: zambrotahagi (14675 in chips, $2.45 bounty) 
Seat 3: boidoidu (40361 in chips, $2.45 bounty) 
Seat 4: Dimipkpk (28607 in chips, $2.45 bounty) 
Seat 5: KECAKUATL (25000 in chips, $2.45 bounty) 
Seat 6: Kevin12345Mc (20304 in chips, $2.45 bounty) 
Seat 7: Parduotuve (21635 in chips, $2.45 bounty) 
Seat 8: igor okumura (25382 in chips, $2.45 bounty) 
posetuta: posts the ante 40
zambrotahagi: posts the ante 40
boidoidu: posts the ante 40
Dimipkpk: posts the ante 40
KECAKUATL: posts the ante 40
Kevin12345Mc: posts the ante 40
Parduotuve: posts the ante 40
igor okumura: posts the ante 40
Parduotuve: posts small blind 150
igor okumura: posts big blind 300
*** HOLE CARDS ***
Dealt to Kevin12345Mc [4h 6h]
posetuta: folds 
zambrotahagi: folds 
boidoidu: folds 
Dimipkpk: folds 
KECAKUATL: raises 300 to 600
Kevin12345Mc: folds 
Parduotuve: folds 
igor okumura: calls 300
*** FLOP *** [Qd 3d Jd]
igor okumura: checks 
KECAKUATL: checks 
*** TURN *** [Qd 3d Jd] [9d]
igor okumura: bets 1253
KECAKUATL: folds 
Uncalled bet (1253) returned to igor okumura
igor okumura collected 1670 from pot
igor okumura: doesn't show hand 
*** SUMMARY ***
Total pot 1670 | Rake 0 
Board [Qd 3d Jd 9d]
Seat 1: posetuta folded before Flop (didn't bet)
Seat 2: zambrotahagi folded before Flop (didn't bet)
Seat 3: boidoidu folded before Flop (didn't bet)
Seat 4: Dimipkpk folded before Flop (didn't bet)
Seat 5: KECAKUATL folded on the Turn
Seat 6: Kevin12345Mc (button) folded before Flop (didn't bet)
Seat 7: Parduotuve (small blind) folded before Flop
Seat 8: igor okumura (big blind) collected (1670)



PokerStars Hand #254863377151: Tournament #3856223586, $2.45+$2.45+$0.60 USD Hold'em No Limit - Level III (150/300) - 2025/02/14 17:47:46 WET [2025/02/14 12:47:46 ET]
Table '3856223586 32' 8-max Seat #7 is the button
Seat 1: posetuta (24890 in chips, $2.45 bounty) 
Seat 2: zambrotahagi (14635 in chips, $2.45 bounty) 
Seat 3: boidoidu (40321 in chips, $2.45 bounty) 
Seat 4: Dimipkpk (28567 in chips, $2.45 bounty) 
Seat 5: KECAKUATL (24360 in chips, $2.45 bounty) 
Seat 6: Kevin12345Mc (20264 in chips, $2.45 bounty) 
Seat 7: Parduotuve (21445 in chips, $2.45 bounty) 
Seat 8: igor okumura (26412 in chips, $2.45 bounty) 
posetuta: posts the ante 40
zambrotahagi: posts the ante 40
boidoidu: posts the ante 40
Dimipkpk: posts the ante 40
KECAKUATL: posts the ante 40
Kevin12345Mc: posts the ante 40
Parduotuve: posts the ante 40
igor okumura: posts the ante 40
igor okumura: posts small blind 150
posetuta: posts big blind 300
*** HOLE CARDS ***
Dealt to Kevin12345Mc [6c 5s]
zambrotahagi: raises 300 to 600
boidoidu: raises 2300 to 2900
Dimipkpk: folds 
KECAKUATL: folds 
Kevin12345Mc: folds 
Parduotuve: raises 18505 to 21405 and is all-in
igor okumura: folds 
posetuta: folds 
zambrotahagi: folds 
boidoidu: calls 18505
*** FLOP *** [Ks 5c 4s]
*** TURN *** [Ks 5c 4s] [Tc]
*** RIVER *** [Ks 5c 4s Tc] [Qh]
*** SHOW DOWN ***
boidoidu: shows [Qd As] (a pair of Queens)
Parduotuve: shows [Ts Js] (a pair of Tens)
boidoidu collected 44180 from pot
boidoidu wins $1.23 for eliminating Parduotuve and their own bounty increases by $1.22 to $3.67
Parduotuve finished the tournament
*** SUMMARY ***
Total pot 44180 | Rake 0 
Board [Ks 5c 4s Tc Qh]
Seat 1: posetuta (big blind) folded before Flop
Seat 2: zambrotahagi folded before Flop
Seat 3: boidoidu showed [Qd As] and won (44180) with a pair of Queens
Seat 4: Dimipkpk folded before Flop (didn't bet)
Seat 5: KECAKUATL folded before Flop (didn't bet)
Seat 6: Kevin12345Mc folded before Flop (didn't bet)
Seat 7: Parduotuve (button) showed [Ts Js] and lost with a pair of Tens
Seat 8: igor okumura (small blind) folded before Flop



PokerStars Hand #254863386789: Tournament #3856223586, $2.45+$2.45+$0.60 USD Hold'em No Limit - Level III (150/300) - 2025/02/14 17:48:25 WET [2025/02/14 12:48:25 ET]
Table '3856223586 32' 8-max Seat #8 is the button
Seat 1: posetuta (24550 in chips, $2.45 bounty) 
Seat 3: boidoidu (63056 in chips, $3.67 bounty) 
Seat 4: Dimipkpk (28527 in chips, $2.45 bounty) 
Seat 5: KECAKUATL (24320 in chips, $2.45 bounty) 
Seat 6: Kevin12345Mc (20224 in chips, $2.45 bounty) 
Seat 8: igor okumura (26222 in chips, $2.45 bounty) 
posetuta: posts the ante 40
boidoidu: posts the ante 40
Dimipkpk: posts the ante 40
KECAKUATL: posts the ante 40
Kevin12345Mc: posts the ante 40
igor okumura: posts the ante 40
posetuta: posts small blind 150
boidoidu: posts big blind 300
*** HOLE CARDS ***
Dealt to Kevin12345Mc [Qd Ts]
Quickfinger1 is disconnected 
Dimipkpk: folds 
KECAKUATL: folds 
Kevin12345Mc: raises 390 to 690
igor okumura: folds 
posetuta: folds 
boidoidu: calls 390
*** FLOP *** [Qs 3c 6c]
boidoidu: checks 
Kevin12345Mc: bets 584
boidoidu: calls 584
*** TURN *** [Qs 3c 6c] [7s]
boidoidu: checks 
Kevin12345Mc: bets 1939
boidoidu: calls 1939
*** RIVER *** [Qs 3c 6c 7s] [9c]
boidoidu: checks 
Kevin12345Mc: checks 
*** SHOW DOWN ***
boidoidu: shows [3s 5s] (a pair of Threes)
Kevin12345Mc: shows [Qd Ts] (a pair of Queens)
Kevin12345Mc collected 6816 from pot
*** SUMMARY ***
Total pot 6816 | Rake 0 
Board [Qs 3c 6c 7s 9c]
Seat 1: posetuta (small blind) folded before Flop
Seat 3: boidoidu (big blind) showed [3s 5s] and lost with a pair of Threes
Seat 4: Dimipkpk folded before Flop (didn't bet)
Seat 5: KECAKUATL folded before Flop (didn't bet)
Seat 6: Kevin12345Mc showed [Qd Ts] and won (6816) with a pair of Queens
Seat 8: igor okumura (button) folded before Flop (didn't bet)



PokerStars Hand #254863402571: Tournament #3856223586, $2.45+$2.45+$0.60 USD Hold'em No Limit - Level III (150/300) - 2025/02/14 17:49:29 WET [2025/02/14 12:49:29 ET]
Table '3856223586 32' 8-max Seat #1 is the button
Seat 1: posetuta (24360 in chips, $2.45 bounty) 
Seat 2: CassUK (25000 in chips) out of hand (moved from another table into small blind)
Seat 3: boidoidu (59803 in chips, $3.67 bounty) 
Seat 4: Dimipkpk (28487 in chips, $2.45 bounty) 
Seat 5: KECAKUATL (24280 in chips, $2.45 bounty) 
Seat 6: Kevin12345Mc (23787 in chips, $2.45 bounty) 
Seat 7: Quickfinger1 (23685 in chips, $2.45 bounty) 
Seat 8: igor okumura (26182 in chips, $2.45 bounty) 
CassUK will be allowed to play after the button
posetuta: posts the ante 40
boidoidu: posts the ante 40
Dimipkpk: posts the ante 40
KECAKUATL: posts the ante 40
Kevin12345Mc: posts the ante 40
Quickfinger1: posts the ante 40
igor okumura: posts the ante 40
boidoidu: posts small blind 150
Dimipkpk: posts big blind 300
*** HOLE CARDS ***
Dealt to Kevin12345Mc [4c Kc]
KECAKUATL: folds 
Kevin12345Mc: folds 
Quickfinger1: folds 
igor okumura: folds 
posetuta: folds 
boidoidu: raises 300 to 600
Dimipkpk: calls 300
*** FLOP *** [6c Jd 8h]
boidoidu: checks 
Dimipkpk: bets 518
boidoidu: calls 518
*** TURN *** [6c Jd 8h] [2h]
boidoidu: checks 
Dimipkpk: bets 1031
boidoidu: folds 
Uncalled bet (1031) returned to Dimipkpk
Dimipkpk collected 2516 from pot
Dimipkpk: doesn't show hand 
*** SUMMARY ***
Total pot 2516 | Rake 0 
Board [6c Jd 8h 2h]
Seat 1: posetuta (button) folded before Flop (didn't bet)
Seat 3: boidoidu (small blind) folded on the Turn
Seat 4: Dimipkpk (big blind) collected (2516)
Seat 5: KECAKUATL folded before Flop (didn't bet)
Seat 6: Kevin12345Mc folded before Flop (didn't bet)
Seat 7: Quickfinger1 folded before Flop (didn't bet)
Seat 8: igor okumura folded before Flop (didn't bet)



PokerStars Hand #254863416871: Tournament #3856223586, $2.45+$2.45+$0.60 USD Hold'em No Limit - Level III (150/300) - 2025/02/14 17:50:27 WET [2025/02/14 12:50:27 ET]
Table '3856223586 32' 8-max Seat #3 is the button
Seat 1: posetuta (24320 in chips, $2.45 bounty) 
Seat 2: CassUK (25000 in chips, $2.45 bounty) 
Seat 3: boidoidu (58645 in chips, $3.67 bounty) 
Seat 4: Dimipkpk (29845 in chips, $2.45 bounty) 
Seat 5: KECAKUATL (24240 in chips, $2.45 bounty) 
Seat 6: Kevin12345Mc (23747 in chips, $2.45 bounty) 
Seat 7: Quickfinger1 (23645 in chips, $2.45 bounty) 
Seat 8: igor okumura (26142 in chips, $2.45 bounty) 
posetuta: posts the ante 40
CassUK: posts the ante 40
boidoidu: posts the ante 40
Dimipkpk: posts the ante 40
KECAKUATL: posts the ante 40
Kevin12345Mc: posts the ante 40
Quickfinger1: posts the ante 40
igor okumura: posts the ante 40
Dimipkpk: posts small blind 150
KECAKUATL: posts big blind 300
*** HOLE CARDS ***
Dealt to Kevin12345Mc [3c Jh]
Kevin12345Mc: folds 
Quickfinger1: folds 
igor okumura: folds 
posetuta: folds 
CassUK: folds 
boidoidu: raises 600 to 900
Dimipkpk: folds 
KECAKUATL: folds 
Uncalled bet (600) returned to boidoidu
boidoidu collected 1070 from pot
boidoidu: doesn't show hand 
*** SUMMARY ***
Total pot 1070 | Rake 0 
Seat 1: posetuta folded before Flop (didn't bet)
Seat 2: CassUK folded before Flop (didn't bet)
Seat 3: boidoidu (button) collected (1070)
Seat 4: Dimipkpk (small blind) folded before Flop
Seat 5: KECAKUATL (big blind) folded before Flop
Seat 6: Kevin12345Mc folded before Flop (didn't bet)
Seat 7: Quickfinger1 folded before Flop (didn't bet)
Seat 8: igor okumura folded before Flop (didn't bet)



PokerStars Hand #254863426708: Tournament #3856223586, $2.45+$2.45+$0.60 USD Hold'em No Limit - Level III (150/300) - 2025/02/14 17:51:06 WET [2025/02/14 12:51:06 ET]
Table '3856223586 32' 8-max Seat #4 is the button
Seat 1: posetuta (24280 in chips, $2.45 bounty) 
Seat 2: CassUK (24960 in chips, $2.45 bounty) 
Seat 3: boidoidu (59375 in chips, $3.67 bounty) 
Seat 4: Dimipkpk (29655 in chips, $2.45 bounty) 
Seat 5: KECAKUATL (23900 in chips, $2.45 bounty) 
Seat 6: Kevin12345Mc (23707 in chips, $2.45 bounty) 
Seat 7: Quickfinger1 (23605 in chips, $2.45 bounty) 
Seat 8: igor okumura (26102 in chips, $2.45 bounty) 
posetuta: posts the ante 40
CassUK: posts the ante 40
boidoidu: posts the ante 40
Dimipkpk: posts the ante 40
KECAKUATL: posts the ante 40
Kevin12345Mc: posts the ante 40
Quickfinger1: posts the ante 40
igor okumura: posts the ante 40
KECAKUATL: posts small blind 150
Kevin12345Mc: posts big blind 300
*** HOLE CARDS ***
Dealt to Kevin12345Mc [6d Qs]
Quickfinger1: raises 300 to 600
igor okumura: folds 
posetuta: raises 1500 to 2100
CassUK: folds 
boidoidu: folds 
Dimipkpk: folds 
KECAKUATL: folds 
Kevin12345Mc: folds 
Quickfinger1: raises 4200 to 6300
posetuta: calls 4200
*** FLOP *** [Qd Jd Kh]
Quickfinger1: bets 17265 and is all-in
posetuta: calls 17265
*** TURN *** [Qd Jd Kh] [Jc]
*** RIVER *** [Qd Jd Kh Jc] [4s]
*** SHOW DOWN ***
Quickfinger1: shows [Ac Ah] (two pair, Aces and Jacks)
posetuta: shows [Jh Js] (four of a kind, Jacks)
posetuta collected 47900 from pot
posetuta wins $1.23 for eliminating Quickfinger1 and their own bounty increases by $1.22 to $3.67
Quickfinger1 finished the tournament
*** SUMMARY ***
Total pot 47900 | Rake 0 
Board [Qd Jd Kh Jc 4s]
Seat 1: posetuta showed [Jh Js] and won (47900) with four of a kind, Jacks
Seat 2: CassUK folded before Flop (didn't bet)
Seat 3: boidoidu folded before Flop (didn't bet)
Seat 4: Dimipkpk (button) folded before Flop (didn't bet)
Seat 5: KECAKUATL (small blind) folded before Flop
Seat 6: Kevin12345Mc (big blind) folded before Flop
Seat 7: Quickfinger1 showed [Ac Ah] and lost with two pair, Aces and Jacks
Seat 8: igor okumura folded before Flop (didn't bet)



PokerStars Hand #254863439201: Tournament #3856223586, $2.45+$2.45+$0.60 USD Hold'em No Limit - Level III (150/300) - 2025/02/14 17:51:57 WET [2025/02/14 12:51:57 ET]
Table '3856223586 32' 8-max Seat #5 is the button
Seat 1: posetuta (48575 in chips, $3.67 bounty) 
Seat 2: CassUK (24920 in chips, $2.45 bounty) 
Seat 3: boidoidu (59335 in chips, $3.67 bounty) 
Seat 4: Dimipkpk (29615 in chips, $2.45 bounty) 
Seat 5: KECAKUATL (23710 in chips, $2.45 bounty) 
Seat 6: Kevin12345Mc (23367 in chips, $2.45 bounty) 
Seat 8: igor okumura (26062 in chips, $2.45 bounty) 
posetuta: posts the ante 40
CassUK: posts the ante 40
boidoidu: posts the ante 40
Dimipkpk: posts the ante 40
KECAKUATL: posts the ante 40
Kevin12345Mc: posts the ante 40
igor okumura: posts the ante 40
Kevin12345Mc: posts small blind 150
igor okumura: posts big blind 300
*** HOLE CARDS ***
Dealt to Kevin12345Mc [4c Ac]
posetuta: raises 450 to 750
CassUK: folds 
boidoidu: calls 750
Dimipkpk: raises 2250 to 3000
KECAKUATL: folds 
Kevin12345Mc: folds 
igor okumura: folds 
posetuta: folds 
boidoidu: folds 
Uncalled bet (2250) returned to Dimipkpk
Dimipkpk collected 2980 from pot
Dimipkpk: doesn't show hand 
*** SUMMARY ***
Total pot 2980 | Rake 0 
Seat 1: posetuta folded before Flop
Seat 2: CassUK folded before Flop (didn't bet)
Seat 3: boidoidu folded before Flop
Seat 4: Dimipkpk collected (2980)
Seat 5: KECAKUATL (button) folded before Flop (didn't bet)
Seat 6: Kevin12345Mc (small blind) folded before Flop
Seat 8: igor okumura (big blind) folded before Flop



PokerStars Hand #254863453896: Tournament #3856223586, $2.45+$2.45+$0.60 USD Hold'em No Limit - Level III (150/300) - 2025/02/14 17:52:56 WET [2025/02/14 12:52:56 ET]
Table '3856223586 32' 8-max Seat #6 is the button
Seat 1: posetuta (47785 in chips, $3.67 bounty) 
Seat 2: CassUK (24880 in chips, $2.45 bounty) 
Seat 3: boidoidu (58545 in chips, $3.67 bounty) 
Seat 4: Dimipkpk (31805 in chips, $2.45 bounty) 
Seat 5: KECAKUATL (23670 in chips, $2.45 bounty) 
Seat 6: Kevin12345Mc (23177 in chips, $2.45 bounty) 
Seat 7: walakos (25000 in chips) out of hand (moved from another table into small blind)
Seat 8: igor okumura (25722 in chips, $2.45 bounty) 
walakos will be allowed to play after the button
posetuta: posts the ante 40
CassUK: posts the ante 40
boidoidu: posts the ante 40
Dimipkpk: posts the ante 40
KECAKUATL: posts the ante 40
Kevin12345Mc: posts the ante 40
igor okumura: posts the ante 40
igor okumura: posts small blind 150
posetuta: posts big blind 300
*** HOLE CARDS ***
Dealt to Kevin12345Mc [Qs 4h]
CassUK: folds 
boidoidu: folds 
Dimipkpk: folds 
KECAKUATL: raises 300 to 600
Kevin12345Mc: folds 
igor okumura: calls 450
posetuta: folds 
*** FLOP *** [4c 2d 9c]
igor okumura: checks 
KECAKUATL: checks 
*** TURN *** [4c 2d 9c] [2h]
igor okumura: bets 1335
KECAKUATL: calls 1335
*** RIVER *** [4c 2d 9c 2h] [Th]
igor okumura: bets 4500
KECAKUATL: folds 
Uncalled bet (4500) returned to igor okumura
igor okumura collected 4450 from pot
igor okumura: doesn't show hand 
*** SUMMARY ***
Total pot 4450 | Rake 0 
Board [4c 2d 9c 2h Th]
Seat 1: posetuta (big blind) folded before Flop
Seat 2: CassUK folded before Flop (didn't bet)
Seat 3: boidoidu folded before Flop (didn't bet)
Seat 4: Dimipkpk folded before Flop (didn't bet)
Seat 5: KECAKUATL folded on the River
Seat 6: Kevin12345Mc (button) folded before Flop (didn't bet)
Seat 8: igor okumura (small blind) collected (4450)



PokerStars Hand #254863473342: Tournament #3856223586, $2.45+$2.45+$0.60 USD Hold'em No Limit - Level IV (175/350) - 2025/02/14 17:54:15 WET [2025/02/14 12:54:15 ET]
Table '3856223586 32' 8-max Seat #8 is the button
Seat 1: posetuta (47445 in chips, $3.67 bounty) 
Seat 2: CassUK (24840 in chips, $2.45 bounty) 
Seat 3: boidoidu (58505 in chips, $3.67 bounty) 
Seat 4: Dimipkpk (31765 in chips, $2.45 bounty) 
Seat 5: KECAKUATL (21695 in chips, $2.45 bounty) 
Seat 6: Kevin12345Mc (23137 in chips, $2.45 bounty) 
Seat 7: walakos (25000 in chips, $2.45 bounty) 
Seat 8: igor okumura (28197 in chips, $2.45 bounty) 
posetuta: posts the ante 50
CassUK: posts the ante 50
boidoidu: posts the ante 50
Dimipkpk: posts the ante 50
KECAKUATL: posts the ante 50
Kevin12345Mc: posts the ante 50
walakos: posts the ante 50
igor okumura: posts the ante 50
posetuta: posts small blind 175
CassUK: posts big blind 350
*** HOLE CARDS ***
Dealt to Kevin12345Mc [9c Ks]
boidoidu: folds 
Dimipkpk: folds 
KECAKUATL: folds 
Kevin12345Mc: folds 
walakos: folds 
igor okumura: raises 350 to 700
posetuta: folds 
CassUK: folds 
Uncalled bet (350) returned to igor okumura
igor okumura collected 1275 from pot
igor okumura: doesn't show hand 
*** SUMMARY ***
Total pot 1275 | Rake 0 
Seat 1: posetuta (small blind) folded before Flop
Seat 2: CassUK (big blind) folded before Flop
Seat 3: boidoidu folded before Flop (didn't bet)
Seat 4: Dimipkpk folded before Flop (didn't bet)
Seat 5: KECAKUATL folded before Flop (didn't bet)
Seat 6: Kevin12345Mc folded before Flop (didn't bet)
Seat 7: walakos folded before Flop (didn't bet)
Seat 8: igor okumura (button) collected (1275)



PokerStars Hand #254863484118: Tournament #3856223586, $2.45+$2.45+$0.60 USD Hold'em No Limit - Level IV (175/350) - 2025/02/14 17:54:59 WET [2025/02/14 12:54:59 ET]
Table '3856223586 32' 8-max Seat #1 is the button
Seat 1: posetuta (47220 in chips, $3.67 bounty) 
Seat 2: CassUK (24440 in chips, $2.45 bounty) 
Seat 3: boidoidu (58455 in chips, $3.67 bounty) 
Seat 4: Dimipkpk (31715 in chips, $2.45 bounty) 
Seat 5: KECAKUATL (21645 in chips, $2.45 bounty) 
Seat 6: Kevin12345Mc (23087 in chips, $2.45 bounty) 
Seat 7: walakos (24950 in chips, $2.45 bounty) 
Seat 8: igor okumura (29072 in chips, $2.45 bounty) 
posetuta: posts the ante 50
CassUK: posts the ante 50
boidoidu: posts the ante 50
Dimipkpk: posts the ante 50
KECAKUATL: posts the ante 50
Kevin12345Mc: posts the ante 50
walakos: posts the ante 50
igor okumura: posts the ante 50
CassUK: posts small blind 175
boidoidu: posts big blind 350
*** HOLE CARDS ***
Dealt to Kevin12345Mc [4h Qs]
Dimipkpk: folds 
KECAKUATL: folds 
Kevin12345Mc: folds 
walakos: raises 350 to 700
igor okumura: folds 
posetuta: folds 
CassUK: folds 
boidoidu: raises 1975 to 2675
walakos: raises 1975 to 4650
boidoidu: raises 53755 to 58405 and is all-in
walakos: calls 20250 and is all-in
Uncalled bet (33505) returned to boidoidu
*** FLOP *** [6h 8h 4c]
*** TURN *** [6h 8h 4c] [7s]
*** RIVER *** [6h 8h 4c 7s] [3s]
*** SHOW DOWN ***
boidoidu: shows [Qd Qh] (a pair of Queens)
walakos: shows [Ah As] (a pair of Aces)
walakos collected 50375 from pot
*** SUMMARY ***
Total pot 50375 | Rake 0 
Board [6h 8h 4c 7s 3s]
Seat 1: posetuta (button) folded before Flop (didn't bet)
Seat 2: CassUK (small blind) folded before Flop
Seat 3: boidoidu (big blind) showed [Qd Qh] and lost with a pair of Queens
Seat 4: Dimipkpk folded before Flop (didn't bet)
Seat 5: KECAKUATL folded before Flop (didn't bet)
Seat 6: Kevin12345Mc folded before Flop (didn't bet)
Seat 7: walakos showed [Ah As] and won (50375) with a pair of Aces
Seat 8: igor okumura folded before Flop (didn't bet)



PokerStars Hand #254863573517: Tournament #3856223586, $2.45+$2.45+$0.60 USD Hold'em No Limit - Level IV (175/350) - 2025/02/14 18:02:39 WET [2025/02/14 13:02:39 ET]
Table '3856223586 32' 8-max Seat #2 is the button
Seat 1: posetuta (47170 in chips, $3.67 bounty) 
Seat 2: CassUK (24215 in chips, $2.45 bounty) 
Seat 3: boidoidu (33505 in chips, $3.67 bounty) 
Seat 4: Dimipkpk (31665 in chips, $2.45 bounty) 
Seat 5: KECAKUATL (21595 in chips, $2.45 bounty) 
Seat 6: Kevin12345Mc (23037 in chips, $2.45 bounty) 
Seat 7: walakos (50375 in chips, $2.45 bounty) 
Seat 8: igor okumura (29022 in chips, $2.45 bounty) 
posetuta: posts the ante 50
CassUK: posts the ante 50
boidoidu: posts the ante 50
Dimipkpk: posts the ante 50
KECAKUATL: posts the ante 50
Kevin12345Mc: posts the ante 50
walakos: posts the ante 50
igor okumura: posts the ante 50
boidoidu: posts small blind 175
Dimipkpk: posts big blind 350
*** HOLE CARDS ***
Dealt to Kevin12345Mc [5s Jd]
KECAKUATL: folds 
Kevin12345Mc: folds 
walakos: calls 350
igor okumura: raises 700 to 1050
CassUK is disconnected 
posetuta: calls 1050
CassUK has timed out while disconnected
CassUK: folds 
CassUK is sitting out
boidoidu: folds 
Dimipkpk: folds 
walakos: calls 700
*** FLOP *** [Jh 6c 5h]
walakos: checks 
igor okumura: checks 
posetuta: checks 
*** TURN *** [Jh 6c 5h] [As]
walakos: checks 
igor okumura: bets 2706
posetuta: folds 
walakos: calls 2706
*** RIVER *** [Jh 6c 5h As] [Td]
walakos: checks 
igor okumura: bets 11200
walakos: calls 11200
*** SHOW DOWN ***
igor okumura: shows [Ad Th] (two pair, Aces and Tens)
walakos: mucks hand 
igor okumura collected 31887 from pot
*** SUMMARY ***
Total pot 31887 | Rake 0 
Board [Jh 6c 5h As Td]
Seat 1: posetuta folded on the Turn
Seat 2: CassUK (button) folded before Flop (didn't bet)
Seat 3: boidoidu (small blind) folded before Flop
Seat 4: Dimipkpk (big blind) folded before Flop
Seat 5: KECAKUATL folded before Flop (didn't bet)
Seat 6: Kevin12345Mc folded before Flop (didn't bet)
Seat 7: walakos mucked [Ah 3c]
Seat 8: igor okumura showed [Ad Th] and won (31887) with two pair, Aces and Tens



PokerStars Hand #254863599025: Tournament #3856223586, $2.45+$2.45+$0.60 USD Hold'em No Limit - Level IV (175/350) - 2025/02/14 18:04:23 WET [2025/02/14 13:04:23 ET]
Table '3856223586 32' 8-max Seat #3 is the button
Seat 1: posetuta (46070 in chips, $3.67 bounty) 
Seat 2: CassUK (24165 in chips, $2.45 bounty) is sitting out
Seat 3: boidoidu (33280 in chips, $3.67 bounty) 
Seat 4: Dimipkpk (31265 in chips, $2.45 bounty) 
Seat 5: KECAKUATL (21545 in chips, $2.45 bounty) 
Seat 6: Kevin12345Mc (22987 in chips, $2.45 bounty) 
Seat 7: walakos (35369 in chips, $2.45 bounty) 
Seat 8: igor okumura (45903 in chips, $2.45 bounty) 
posetuta: posts the ante 50
CassUK: posts the ante 50
boidoidu: posts the ante 50
Dimipkpk: posts the ante 50
KECAKUATL: posts the ante 50
Kevin12345Mc: posts the ante 50
walakos: posts the ante 50
igor okumura: posts the ante 50
Dimipkpk: posts small blind 175
KECAKUATL: posts big blind 350
*** HOLE CARDS ***
Dealt to Kevin12345Mc [8d 9d]
Kevin12345Mc: raises 455 to 805
walakos: folds 
igor okumura: folds 
posetuta: folds 
CassUK: folds 
boidoidu: folds 
Dimipkpk: folds 
KECAKUATL: folds 
Uncalled bet (455) returned to Kevin12345Mc
Kevin12345Mc collected 1275 from pot
Kevin12345Mc: doesn't show hand 
*** SUMMARY ***
Total pot 1275 | Rake 0 
Seat 1: posetuta folded before Flop (didn't bet)
Seat 2: CassUK folded before Flop (didn't bet)
Seat 3: boidoidu (button) folded before Flop (didn't bet)
Seat 4: Dimipkpk (small blind) folded before Flop
Seat 5: KECAKUATL (big blind) folded before Flop
Seat 6: Kevin12345Mc collected (1275)
Seat 7: walakos folded before Flop (didn't bet)
Seat 8: igor okumura folded before Flop (didn't bet)



PokerStars Hand #254863609829: Tournament #3856223586, $2.45+$2.45+$0.60 USD Hold'em No Limit - Level IV (175/350) - 2025/02/14 18:05:06 WET [2025/02/14 13:05:06 ET]
Table '3856223586 32' 8-max Seat #4 is the button
Seat 1: posetuta (46020 in chips, $3.67 bounty) 
Seat 2: CassUK (24115 in chips, $2.45 bounty) is sitting out
Seat 3: boidoidu (33230 in chips, $3.67 bounty) 
Seat 4: Dimipkpk (31040 in chips, $2.45 bounty) 
Seat 5: KECAKUATL (21145 in chips, $2.45 bounty) 
Seat 6: Kevin12345Mc (23862 in chips, $2.45 bounty) 
Seat 7: walakos (35319 in chips, $2.45 bounty) 
Seat 8: igor okumura (45853 in chips, $2.45 bounty) 
posetuta: posts the ante 50
CassUK: posts the ante 50
boidoidu: posts the ante 50
Dimipkpk: posts the ante 50
KECAKUATL: posts the ante 50
Kevin12345Mc: posts the ante 50
walakos: posts the ante 50
igor okumura: posts the ante 50
KECAKUATL: posts small blind 175
Kevin12345Mc: posts big blind 350
*** HOLE CARDS ***
Dealt to Kevin12345Mc [9c 6c]
walakos: calls 350
igor okumura: raises 700 to 1050
posetuta: folds 
CassUK: folds 
boidoidu: folds 
Dimipkpk: folds 
KECAKUATL: folds 
Kevin12345Mc: folds 
walakos: calls 700
*** FLOP *** [5s Qs 6d]
walakos: checks 
igor okumura: bets 998
walakos: calls 998
*** TURN *** [5s Qs 6d] [8h]
walakos: checks 
igor okumura: checks 
*** RIVER *** [5s Qs 6d 8h] [Td]
walakos: checks 
igor okumura: checks 
*** SHOW DOWN ***
walakos: shows [3d 3c] (a pair of Threes)
igor okumura: mucks hand 
walakos collected 5021 from pot
*** SUMMARY ***
Total pot 5021 | Rake 0 
Board [5s Qs 6d 8h Td]
Seat 1: posetuta folded before Flop (didn't bet)
Seat 2: CassUK folded before Flop (didn't bet)
Seat 3: boidoidu folded before Flop (didn't bet)
Seat 4: Dimipkpk (button) folded before Flop (didn't bet)
Seat 5: KECAKUATL (small blind) folded before Flop
Seat 6: Kevin12345Mc (big blind) folded before Flop
Seat 7: walakos showed [3d 3c] and won (5021) with a pair of Threes
Seat 8: igor okumura mucked [Jh As]



PokerStars Hand #254863622477: Tournament #3856223586, $2.45+$2.45+$0.60 USD Hold'em No Limit - Level IV (175/350) - 2025/02/14 18:05:57 WET [2025/02/14 13:05:57 ET]
Table '3856223586 32' 8-max Seat #5 is the button
Seat 1: posetuta (45970 in chips, $3.67 bounty) 
Seat 2: CassUK (24065 in chips, $2.45 bounty) is sitting out
Seat 3: boidoidu (33180 in chips, $3.67 bounty) 
Seat 4: Dimipkpk (30990 in chips, $2.45 bounty) 
Seat 5: KECAKUATL (20920 in chips, $2.45 bounty) 
Seat 6: Kevin12345Mc (23462 in chips, $2.45 bounty) 
Seat 7: walakos (38242 in chips, $2.45 bounty) 
Seat 8: igor okumura (43755 in chips, $2.45 bounty) 
posetuta: posts the ante 50
CassUK: posts the ante 50
boidoidu: posts the ante 50
Dimipkpk: posts the ante 50
KECAKUATL: posts the ante 50
Kevin12345Mc: posts the ante 50
walakos: posts the ante 50
igor okumura: posts the ante 50
Kevin12345Mc: posts small blind 175
walakos: posts big blind 350
*** HOLE CARDS ***
Dealt to Kevin12345Mc [Ac 3s]
igor okumura: folds 
posetuta: raises 350 to 700
CassUK: folds 
boidoidu: folds 
Dimipkpk: calls 700
KECAKUATL: folds 
Kevin12345Mc: folds 
walakos: folds 
*** FLOP *** [Kd 7d 4s]
posetuta: bets 700
Dimipkpk: calls 700
*** TURN *** [Kd 7d 4s] [Ah]
posetuta: bets 2570
Dimipkpk: calls 2570
*** RIVER *** [Kd 7d 4s Ah] [9d]
posetuta: checks 
Dimipkpk: checks 
*** SHOW DOWN ***
posetuta: shows [Qh Js] (high card Ace)
Dimipkpk: shows [8s As] (a pair of Aces)
Dimipkpk collected 8865 from pot
*** SUMMARY ***
Total pot 8865 | Rake 0 
Board [Kd 7d 4s Ah 9d]
Seat 1: posetuta showed [Qh Js] and lost with high card Ace
Seat 2: CassUK folded before Flop (didn't bet)
Seat 3: boidoidu folded before Flop (didn't bet)
Seat 4: Dimipkpk showed [8s As] and won (8865) with a pair of Aces
Seat 5: KECAKUATL (button) folded before Flop (didn't bet)
Seat 6: Kevin12345Mc (small blind) folded before Flop
Seat 7: walakos (big blind) folded before Flop
Seat 8: igor okumura folded before Flop (didn't bet)



PokerStars Hand #254863641376: Tournament #3856223586, $2.45+$2.45+$0.60 USD Hold'em No Limit - Level IV (175/350) - 2025/02/14 18:07:14 WET [2025/02/14 13:07:14 ET]
Table '3856223586 32' 8-max Seat #6 is the button
Seat 1: posetuta (41950 in chips, $3.67 bounty) 
Seat 2: CassUK (24015 in chips, $2.45 bounty) is sitting out
Seat 3: boidoidu (33130 in chips, $3.67 bounty) 
Seat 4: Dimipkpk (35835 in chips, $2.45 bounty) 
Seat 5: KECAKUATL (20870 in chips, $2.45 bounty) 
Seat 6: Kevin12345Mc (23237 in chips, $2.45 bounty) 
Seat 7: walakos (37842 in chips, $2.45 bounty) 
Seat 8: igor okumura (43705 in chips, $2.45 bounty) 
posetuta: posts the ante 50
CassUK: posts the ante 50
boidoidu: posts the ante 50
Dimipkpk: posts the ante 50
KECAKUATL: posts the ante 50
Kevin12345Mc: posts the ante 50
walakos: posts the ante 50
igor okumura: posts the ante 50
walakos: posts small blind 175
igor okumura: posts big blind 350
*** HOLE CARDS ***
Dealt to Kevin12345Mc [5d Jc]
posetuta: folds 
CassUK: folds 
boidoidu: folds 
Dimipkpk: folds 
KECAKUATL: folds 
Kevin12345Mc: folds 
walakos: folds 
Uncalled bet (175) returned to igor okumura
igor okumura collected 750 from pot
igor okumura: doesn't show hand 
*** SUMMARY ***
Total pot 750 | Rake 0 
Seat 1: posetuta folded before Flop (didn't bet)
Seat 2: CassUK folded before Flop (didn't bet)
Seat 3: boidoidu folded before Flop (didn't bet)
Seat 4: Dimipkpk folded before Flop (didn't bet)
Seat 5: KECAKUATL folded before Flop (didn't bet)
Seat 6: Kevin12345Mc (button) folded before Flop (didn't bet)
Seat 7: walakos (small blind) folded before Flop
Seat 8: igor okumura (big blind) collected (750)



PokerStars Hand #254863646314: Tournament #3856223586, $2.45+$2.45+$0.60 USD Hold'em No Limit - Level IV (175/350) - 2025/02/14 18:07:33 WET [2025/02/14 13:07:33 ET]
Table '3856223586 32' 8-max Seat #7 is the button
Seat 1: posetuta (41900 in chips, $3.67 bounty) 
Seat 2: CassUK (23965 in chips, $2.45 bounty) is sitting out
Seat 3: boidoidu (33080 in chips, $3.67 bounty) 
Seat 4: Dimipkpk (35785 in chips, $2.45 bounty) 
Seat 5: KECAKUATL (20820 in chips, $2.45 bounty) 
Seat 6: Kevin12345Mc (23187 in chips, $2.45 bounty) 
Seat 7: walakos (37617 in chips, $2.45 bounty) 
Seat 8: igor okumura (44230 in chips, $2.45 bounty) 
posetuta: posts the ante 50
CassUK: posts the ante 50
boidoidu: posts the ante 50
Dimipkpk: posts the ante 50
KECAKUATL: posts the ante 50
Kevin12345Mc: posts the ante 50
walakos: posts the ante 50
igor okumura: posts the ante 50
igor okumura: posts small blind 175
posetuta: posts big blind 350
*** HOLE CARDS ***
Dealt to Kevin12345Mc [7s 7h]
CassUK: folds 
boidoidu: folds 
Dimipkpk: raises 420 to 770
KECAKUATL: calls 770
Kevin12345Mc: calls 770
walakos: folds 
igor okumura: folds 
posetuta: folds 
*** FLOP *** [Jc 2h 8h]
Dimipkpk: checks 
KECAKUATL: checks 
CassUK is disconnected 
CassUK has returned
Kevin12345Mc: checks 
*** TURN *** [Jc 2h 8h] [3h]
Dimipkpk: checks 
KECAKUATL: bets 1400
Kevin12345Mc: folds 
Dimipkpk: folds 
Uncalled bet (1400) returned to KECAKUATL
KECAKUATL collected 3235 from pot
KECAKUATL: doesn't show hand 
*** SUMMARY ***
Total pot 3235 | Rake 0 
Board [Jc 2h 8h 3h]
Seat 1: posetuta (big blind) folded before Flop
Seat 2: CassUK folded before Flop (didn't bet)
Seat 3: boidoidu folded before Flop (didn't bet)
Seat 4: Dimipkpk folded on the Turn
Seat 5: KECAKUATL collected (3235)
Seat 6: Kevin12345Mc folded on the Turn
Seat 7: walakos (button) folded before Flop (didn't bet)
Seat 8: igor okumura (small blind) folded before Flop



PokerStars Hand #254863670133: Tournament #3856223586, $2.45+$2.45+$0.60 USD Hold'em No Limit - Level IV (175/350) - 2025/02/14 18:09:10 WET [2025/02/14 13:09:10 ET]
Table '3856223586 32' 8-max Seat #8 is the button
Seat 1: posetuta (41500 in chips, $3.67 bounty) 
Seat 2: CassUK (23915 in chips, $2.45 bounty) 
Seat 3: boidoidu (33030 in chips, $3.67 bounty) 
Seat 4: Dimipkpk (34965 in chips, $2.45 bounty) 
Seat 5: KECAKUATL (23235 in chips, $2.45 bounty) 
Seat 6: Kevin12345Mc (22367 in chips, $2.45 bounty) 
Seat 7: walakos (37567 in chips, $2.45 bounty) 
Seat 8: igor okumura (44005 in chips, $2.45 bounty) 
posetuta: posts the ante 50
CassUK: posts the ante 50
boidoidu: posts the ante 50
Dimipkpk: posts the ante 50
KECAKUATL: posts the ante 50
Kevin12345Mc: posts the ante 50
walakos: posts the ante 50
igor okumura: posts the ante 50
posetuta: posts small blind 175
CassUK: posts big blind 350
*** HOLE CARDS ***
Dealt to Kevin12345Mc [7c 9c]
boidoidu: folds 
Dimipkpk: folds 
KECAKUATL: folds 
Kevin12345Mc: folds 
walakos: folds 
igor okumura: folds 
posetuta: calls 175
CassUK: checks 
*** FLOP *** [Ks 4c 9s]
posetuta: checks 
CassUK: checks 
*** TURN *** [Ks 4c 9s] [3h]
posetuta: bets 525
CassUK: folds 
Uncalled bet (525) returned to posetuta
posetuta collected 1100 from pot
posetuta: doesn't show hand 
*** SUMMARY ***
Total pot 1100 | Rake 0 
Board [Ks 4c 9s 3h]
Seat 1: posetuta (small blind) collected (1100)
Seat 2: CassUK (big blind) folded on the Turn
Seat 3: boidoidu folded before Flop (didn't bet)
Seat 4: Dimipkpk folded before Flop (didn't bet)
Seat 5: KECAKUATL folded before Flop (didn't bet)
Seat 6: Kevin12345Mc folded before Flop (didn't bet)
Seat 7: walakos folded before Flop (didn't bet)
Seat 8: igor okumura (button) folded before Flop (didn't bet)



PokerStars Hand #254863685420: Tournament #3856223586, $2.45+$2.45+$0.60 USD Hold'em No Limit - Level V (200/400) - 2025/02/14 18:10:12 WET [2025/02/14 13:10:12 ET]
Table '3856223586 32' 8-max Seat #1 is the button
Seat 1: posetuta (42200 in chips, $3.67 bounty) 
Seat 2: CassUK (23515 in chips, $2.45 bounty) 
Seat 3: boidoidu (32980 in chips, $3.67 bounty) 
Seat 4: Dimipkpk (34915 in chips, $2.45 bounty) 
Seat 5: KECAKUATL (23185 in chips, $2.45 bounty) 
Seat 6: Kevin12345Mc (22317 in chips, $2.45 bounty) 
Seat 7: walakos (37517 in chips, $2.45 bounty) 
Seat 8: igor okumura (43955 in chips, $2.45 bounty) 
posetuta: posts the ante 60
CassUK: posts the ante 60
boidoidu: posts the ante 60
Dimipkpk: posts the ante 60
KECAKUATL: posts the ante 60
Kevin12345Mc: posts the ante 60
walakos: posts the ante 60
igor okumura: posts the ante 60
CassUK: posts small blind 200
boidoidu: posts big blind 400
*** HOLE CARDS ***
Dealt to Kevin12345Mc [Ah 9c]
Dimipkpk: raises 600 to 1000
KECAKUATL: folds 
Kevin12345Mc: folds 
walakos: folds 
igor okumura: folds 
posetuta: folds 
CassUK: folds 
boidoidu: calls 600
*** FLOP *** [Kd 2c 7s]
boidoidu: checks 
Dimipkpk: bets 800
boidoidu: folds 
Uncalled bet (800) returned to Dimipkpk
Dimipkpk collected 2680 from pot
Dimipkpk: doesn't show hand 
*** SUMMARY ***
Total pot 2680 | Rake 0 
Board [Kd 2c 7s]
Seat 1: posetuta (button) folded before Flop (didn't bet)
Seat 2: CassUK (small blind) folded before Flop
Seat 3: boidoidu (big blind) folded on the Flop
Seat 4: Dimipkpk collected (2680)
Seat 5: KECAKUATL folded before Flop (didn't bet)
Seat 6: Kevin12345Mc folded before Flop (didn't bet)
Seat 7: walakos folded before Flop (didn't bet)
Seat 8: igor okumura folded before Flop (didn't bet)



PokerStars Hand #254863709150: Tournament #3856223586, $2.45+$2.45+$0.60 USD Hold'em No Limit - Level V (200/400) - 2025/02/14 18:11:48 WET [2025/02/14 13:11:48 ET]
Table '3856223586 32' 8-max Seat #2 is the button
Seat 1: posetuta (42140 in chips, $3.67 bounty) 
Seat 2: CassUK (23255 in chips, $2.45 bounty) 
Seat 3: boidoidu (31920 in chips, $3.67 bounty) 
Seat 4: Dimipkpk (36535 in chips, $2.45 bounty) 
Seat 5: KECAKUATL (23125 in chips, $2.45 bounty) 
Seat 6: Kevin12345Mc (22257 in chips, $2.45 bounty) 
Seat 7: walakos (37457 in chips, $2.45 bounty) 
Seat 8: igor okumura (43895 in chips, $2.45 bounty) 
posetuta: posts the ante 60
CassUK: posts the ante 60
boidoidu: posts the ante 60
Dimipkpk: posts the ante 60
KECAKUATL: posts the ante 60
Kevin12345Mc: posts the ante 60
walakos: posts the ante 60
igor okumura: posts the ante 60
boidoidu: posts small blind 200
Dimipkpk: posts big blind 400
*** HOLE CARDS ***
Dealt to Kevin12345Mc [5c 5d]
KECAKUATL: folds 
Kevin12345Mc: raises 520 to 920
walakos: folds 
igor okumura: folds 
posetuta: folds 
CassUK: folds 
boidoidu: folds 
Dimipkpk: calls 520
*** FLOP *** [2c 8s Js]
Dimipkpk: checks 
Kevin12345Mc: checks 
*** TURN *** [2c 8s Js] [6d]
Dimipkpk: bets 882
Kevin12345Mc: calls 882
*** RIVER *** [2c 8s Js 6d] [3c]
Dimipkpk: bets 1499
Kevin12345Mc: calls 1499
*** SHOW DOWN ***
Dimipkpk: shows [Ah 6c] (a pair of Sixes)
Kevin12345Mc: mucks hand 
Dimipkpk collected 7282 from pot
*** SUMMARY ***
Total pot 7282 | Rake 0 
Board [2c 8s Js 6d 3c]
Seat 1: posetuta folded before Flop (didn't bet)
Seat 2: CassUK (button) folded before Flop (didn't bet)
Seat 3: boidoidu (small blind) folded before Flop
Seat 4: Dimipkpk (big blind) showed [Ah 6c] and won (7282) with a pair of Sixes
Seat 5: KECAKUATL folded before Flop (didn't bet)
Seat 6: Kevin12345Mc mucked [5c 5d]
Seat 7: walakos folded before Flop (didn't bet)
Seat 8: igor okumura folded before Flop (didn't bet)



PokerStars Hand #254863738164: Tournament #3856223586, $2.45+$2.45+$0.60 USD Hold'em No Limit - Level V (200/400) - 2025/02/14 18:13:44 WET [2025/02/14 13:13:44 ET]
Table '3856223586 32' 8-max Seat #3 is the button
Seat 1: posetuta (42080 in chips, $3.67 bounty) 
Seat 2: CassUK (23195 in chips, $2.45 bounty) 
Seat 3: boidoidu (31660 in chips, $3.67 bounty) 
Seat 4: Dimipkpk (40456 in chips, $2.45 bounty) 
Seat 5: KECAKUATL (23065 in chips, $2.45 bounty) 
Seat 6: Kevin12345Mc (18896 in chips, $2.45 bounty) 
Seat 7: walakos (37397 in chips, $2.45 bounty) 
Seat 8: igor okumura (43835 in chips, $2.45 bounty) 
posetuta: posts the ante 60
CassUK: posts the ante 60
boidoidu: posts the ante 60
Dimipkpk: posts the ante 60
KECAKUATL: posts the ante 60
Kevin12345Mc: posts the ante 60
walakos: posts the ante 60
igor okumura: posts the ante 60
Dimipkpk: posts small blind 200
KECAKUATL: posts big blind 400
*** HOLE CARDS ***
Dealt to Kevin12345Mc [Ah 9s]
Kevin12345Mc: folds 
walakos: folds 
igor okumura: folds 
posetuta: raises 800 to 1200
CassUK: folds 
boidoidu: calls 1200
Dimipkpk: folds 
KECAKUATL: folds 
*** FLOP *** [7c Ks 2c]
posetuta: checks 
boidoidu: bets 1740
posetuta: folds 
Uncalled bet (1740) returned to boidoidu
boidoidu collected 3480 from pot
boidoidu: doesn't show hand 
*** SUMMARY ***
Total pot 3480 | Rake 0 
Board [7c Ks 2c]
Seat 1: posetuta folded on the Flop
Seat 2: CassUK folded before Flop (didn't bet)
Seat 3: boidoidu (button) collected (3480)
Seat 4: Dimipkpk (small blind) folded before Flop
Seat 5: KECAKUATL (big blind) folded before Flop
Seat 6: Kevin12345Mc folded before Flop (didn't bet)
Seat 7: walakos folded before Flop (didn't bet)
Seat 8: igor okumura folded before Flop (didn't bet)



PokerStars Hand #254863749505: Tournament #3856223586, $2.45+$2.45+$0.60 USD Hold'em No Limit - Level V (200/400) - 2025/02/14 18:14:29 WET [2025/02/14 13:14:29 ET]
Table '3856223586 32' 8-max Seat #4 is the button
Seat 1: posetuta (40820 in chips, $3.67 bounty) 
Seat 2: CassUK (23135 in chips, $2.45 bounty) 
Seat 3: boidoidu (33880 in chips, $3.67 bounty) 
Seat 4: Dimipkpk (40196 in chips, $2.45 bounty) 
Seat 5: KECAKUATL (22605 in chips, $2.45 bounty) 
Seat 6: Kevin12345Mc (18836 in chips, $2.45 bounty) 
Seat 7: walakos (37337 in chips, $2.45 bounty) 
Seat 8: igor okumura (43775 in chips, $2.45 bounty) 
posetuta: posts the ante 60
CassUK: posts the ante 60
boidoidu: posts the ante 60
Dimipkpk: posts the ante 60
KECAKUATL: posts the ante 60
Kevin12345Mc: posts the ante 60
walakos: posts the ante 60
igor okumura: posts the ante 60
KECAKUATL: posts small blind 200
Kevin12345Mc: posts big blind 400
*** HOLE CARDS ***
Dealt to Kevin12345Mc [9s 4s]
walakos: calls 400
igor okumura: folds 
posetuta: folds 
CassUK: folds 
boidoidu: raises 1880 to 2280
Dimipkpk: folds 
KECAKUATL: folds 
Kevin12345Mc: folds 
walakos: calls 1880
*** FLOP *** [7h Kc Th]
walakos: checks 
boidoidu: bets 5640
walakos: calls 5640
*** TURN *** [7h Kc Th] [4d]
walakos: checks 
boidoidu: bets 25900 and is all-in
walakos: calls 25900
*** RIVER *** [7h Kc Th 4d] [6c]
*** SHOW DOWN ***
walakos: shows [Qd Jc] (high card King)
boidoidu: shows [Kh Ad] (a pair of Kings)
boidoidu collected 68720 from pot
*** SUMMARY ***
Total pot 68720 | Rake 0 
Board [7h Kc Th 4d 6c]
Seat 1: posetuta folded before Flop (didn't bet)
Seat 2: CassUK folded before Flop (didn't bet)
Seat 3: boidoidu showed [Kh Ad] and won (68720) with a pair of Kings
Seat 4: Dimipkpk (button) folded before Flop (didn't bet)
Seat 5: KECAKUATL (small blind) folded before Flop
Seat 6: Kevin12345Mc (big blind) folded before Flop
Seat 7: walakos showed [Qd Jc] and lost with high card King
Seat 8: igor okumura folded before Flop (didn't bet)



PokerStars Hand #254863765145: Tournament #3856223586, $2.45+$2.45+$0.60 USD Hold'em No Limit - Level V (200/400) - 2025/02/14 18:15:31 WET [2025/02/14 13:15:31 ET]
Table '3856223586 32' 8-max Seat #5 is the button
Seat 1: posetuta (40760 in chips, $3.67 bounty) 
Seat 2: CassUK (23075 in chips, $2.45 bounty) 
Seat 3: boidoidu (68720 in chips, $3.67 bounty) 
Seat 4: Dimipkpk (40136 in chips, $2.45 bounty) 
Seat 5: KECAKUATL (22345 in chips, $2.45 bounty) 
Seat 6: Kevin12345Mc (18376 in chips, $2.45 bounty) 
Seat 7: walakos (3457 in chips, $2.45 bounty) 
Seat 8: igor okumura (43715 in chips, $2.45 bounty) 
posetuta: posts the ante 60
CassUK: posts the ante 60
boidoidu: posts the ante 60
Dimipkpk: posts the ante 60
KECAKUATL: posts the ante 60
Kevin12345Mc: posts the ante 60
walakos: posts the ante 60
igor okumura: posts the ante 60
Kevin12345Mc: posts small blind 200
walakos: posts big blind 400
*** HOLE CARDS ***
Dealt to Kevin12345Mc [Th 4s]
igor okumura: folds 
posetuta: raises 480 to 880
CassUK: calls 880
boidoidu: folds 
Dimipkpk: folds 
KECAKUATL: folds 
Kevin12345Mc: folds 
walakos: folds 
*** FLOP *** [7h 7d Jd]
posetuta: bets 1278
CassUK: folds 
Uncalled bet (1278) returned to posetuta
posetuta collected 2840 from pot
posetuta: doesn't show hand 
*** SUMMARY ***
Total pot 2840 | Rake 0 
Board [7h 7d Jd]
Seat 1: posetuta collected (2840)
Seat 2: CassUK folded on the Flop
Seat 3: boidoidu folded before Flop (didn't bet)
Seat 4: Dimipkpk folded before Flop (didn't bet)
Seat 5: KECAKUATL (button) folded before Flop (didn't bet)
Seat 6: Kevin12345Mc (small blind) folded before Flop
Seat 7: walakos (big blind) folded before Flop
Seat 8: igor okumura folded before Flop (didn't bet)



PokerStars Hand #254863779541: Tournament #3856223586, $2.45+$2.45+$0.60 USD Hold'em No Limit - Level V (200/400) - 2025/02/14 18:16:29 WET [2025/02/14 13:16:29 ET]
Table '3856223586 32' 8-max Seat #6 is the button
Seat 1: posetuta (42660 in chips, $3.67 bounty) 
Seat 2: CassUK (22135 in chips, $2.45 bounty) 
Seat 3: boidoidu (68660 in chips, $3.67 bounty) 
Seat 4: Dimipkpk (40076 in chips, $2.45 bounty) 
Seat 5: KECAKUATL (22285 in chips, $2.45 bounty) 
Seat 6: Kevin12345Mc (18116 in chips, $2.45 bounty) 
Seat 7: walakos (2997 in chips, $2.45 bounty) 
Seat 8: igor okumura (43655 in chips, $2.45 bounty) 
posetuta: posts the ante 60
CassUK: posts the ante 60
boidoidu: posts the ante 60
Dimipkpk: posts the ante 60
KECAKUATL: posts the ante 60
Kevin12345Mc: posts the ante 60
walakos: posts the ante 60
igor okumura: posts the ante 60
walakos: posts small blind 200
igor okumura: posts big blind 400
*** HOLE CARDS ***
Dealt to Kevin12345Mc [Ks 4h]
posetuta: folds 
CassUK: folds 
boidoidu: folds 
Dimipkpk: raises 600 to 1000
KECAKUATL: folds 
Kevin12345Mc: folds 
walakos: calls 800
igor okumura: folds 
*** FLOP *** [Kd Qc 3c]
walakos: checks 
Dimipkpk: bets 20000
walakos: calls 1937 and is all-in
Uncalled bet (18063) returned to Dimipkpk
*** TURN *** [Kd Qc 3c] [Qh]
*** RIVER *** [Kd Qc 3c Qh] [2s]
*** SHOW DOWN ***
walakos: shows [Qd Td] (three of a kind, Queens)
Dimipkpk: shows [Jc Th] (a pair of Queens)
walakos collected 6754 from pot
*** SUMMARY ***
Total pot 6754 | Rake 0 
Board [Kd Qc 3c Qh 2s]
Seat 1: posetuta folded before Flop (didn't bet)
Seat 2: CassUK folded before Flop (didn't bet)
Seat 3: boidoidu folded before Flop (didn't bet)
Seat 4: Dimipkpk showed [Jc Th] and lost with a pair of Queens
Seat 5: KECAKUATL folded before Flop (didn't bet)
Seat 6: Kevin12345Mc (button) folded before Flop (didn't bet)
Seat 7: walakos (small blind) showed [Qd Td] and won (6754) with three of a kind, Queens
Seat 8: igor okumura (big blind) folded before Flop



PokerStars Hand #254863790585: Tournament #3856223586, $2.45+$2.45+$0.60 USD Hold'em No Limit - Level V (200/400) - 2025/02/14 18:17:13 WET [2025/02/14 13:17:13 ET]
Table '3856223586 32' 8-max Seat #7 is the button
Seat 1: posetuta (42600 in chips, $3.67 bounty) 
Seat 2: CassUK (22075 in chips, $2.45 bounty) 
Seat 3: boidoidu (68600 in chips, $3.67 bounty) 
Seat 4: Dimipkpk (37079 in chips, $2.45 bounty) 
Seat 5: KECAKUATL (22225 in chips, $2.45 bounty) 
Seat 6: Kevin12345Mc (18056 in chips, $2.45 bounty) 
Seat 7: walakos (6754 in chips, $2.45 bounty) 
Seat 8: igor okumura (43195 in chips, $2.45 bounty) 
posetuta: posts the ante 60
CassUK: posts the ante 60
boidoidu: posts the ante 60
Dimipkpk: posts the ante 60
KECAKUATL: posts the ante 60
Kevin12345Mc: posts the ante 60
walakos: posts the ante 60
igor okumura: posts the ante 60
igor okumura: posts small blind 200
posetuta: posts big blind 400
*** HOLE CARDS ***
Dealt to Kevin12345Mc [9d Th]
CassUK: folds 
boidoidu: folds 
Dimipkpk: raises 480 to 880
KECAKUATL: folds 
Kevin12345Mc: folds 
walakos: calls 880
igor okumura: folds 
posetuta: calls 480
*** FLOP *** [5c 8s 8h]
posetuta: checks 
Dimipkpk: bets 830
walakos: folds 
posetuta: calls 830
*** TURN *** [5c 8s 8h] [5h]
posetuta: checks 
Dimipkpk: checks 
*** RIVER *** [5c 8s 8h 5h] [7s]
posetuta: bets 3752
Dimipkpk: folds 
Uncalled bet (3752) returned to posetuta
posetuta collected 4980 from pot
posetuta: doesn't show hand 
*** SUMMARY ***
Total pot 4980 | Rake 0 
Board [5c 8s 8h 5h 7s]
Seat 1: posetuta (big blind) collected (4980)
Seat 2: CassUK folded before Flop (didn't bet)
Seat 3: boidoidu folded before Flop (didn't bet)
Seat 4: Dimipkpk folded on the River
Seat 5: KECAKUATL folded before Flop (didn't bet)
Seat 6: Kevin12345Mc folded before Flop (didn't bet)
Seat 7: walakos (button) folded on the Flop
Seat 8: igor okumura (small blind) folded before Flop



PokerStars Hand #254863815380: Tournament #3856223586, $2.45+$2.45+$0.60 USD Hold'em No Limit - Level VI (250/500) - 2025/02/14 18:18:53 WET [2025/02/14 13:18:53 ET]
Table '3856223586 32' 8-max Seat #8 is the button
Seat 1: posetuta (45810 in chips, $3.67 bounty) 
Seat 2: CassUK (22015 in chips, $2.45 bounty) 
Seat 3: boidoidu (68540 in chips, $3.67 bounty) 
Seat 4: Dimipkpk (35309 in chips, $2.45 bounty) 
Seat 5: KECAKUATL (22165 in chips, $2.45 bounty) 
Seat 6: Kevin12345Mc (17996 in chips, $2.45 bounty) 
Seat 7: walakos (5814 in chips, $2.45 bounty) 
Seat 8: igor okumura (42935 in chips, $2.45 bounty) 
posetuta: posts the ante 70
CassUK: posts the ante 70
boidoidu: posts the ante 70
Dimipkpk: posts the ante 70
KECAKUATL: posts the ante 70
Kevin12345Mc: posts the ante 70
walakos: posts the ante 70
igor okumura: posts the ante 70
posetuta: posts small blind 250
CassUK: posts big blind 500
*** HOLE CARDS ***
Dealt to Kevin12345Mc [Qs 2d]
boidoidu: folds 
Dimipkpk: folds 
KECAKUATL: folds 
Kevin12345Mc: folds 
walakos: calls 500
igor okumura: folds 
posetuta: folds 
CassUK: raises 1000 to 1500
walakos: calls 1000
*** FLOP *** [3s 6h 9c]
CassUK: bets 1905
walakos: calls 1905
*** TURN *** [3s 6h 9c] [Qc]
CassUK: bets 3810
walakos: calls 2339 and is all-in
Uncalled bet (1471) returned to CassUK
*** RIVER *** [3s 6h 9c Qc] [5s]
*** SHOW DOWN ***
CassUK: shows [Kc Kd] (a pair of Kings)
walakos: shows [Ah Ks] (high card Ace)
CassUK collected 12298 from pot
CassUK wins $1.23 for eliminating walakos and their own bounty increases by $1.22 to $3.67
walakos finished the tournament
*** SUMMARY ***
Total pot 12298 | Rake 0 
Board [3s 6h 9c Qc 5s]
Seat 1: posetuta (small blind) folded before Flop
Seat 2: CassUK (big blind) showed [Kc Kd] and won (12298) with a pair of Kings
Seat 3: boidoidu folded before Flop (didn't bet)
Seat 4: Dimipkpk folded before Flop (didn't bet)
Seat 5: KECAKUATL folded before Flop (didn't bet)
Seat 6: Kevin12345Mc folded before Flop (didn't bet)
Seat 7: walakos showed [Ah Ks] and lost with high card Ace
Seat 8: igor okumura (button) folded before Flop (didn't bet)



PokerStars Hand #254863834986: Tournament #3856223586, $2.45+$2.45+$0.60 USD Hold'em No Limit - Level VI (250/500) - 2025/02/14 18:20:12 WET [2025/02/14 13:20:12 ET]
Table '3856223586 32' 8-max Seat #1 is the button
Seat 1: posetuta (45490 in chips, $3.67 bounty) 
Seat 2: CassUK (28499 in chips, $3.67 bounty) 
Seat 3: boidoidu (68470 in chips, $3.67 bounty) 
Seat 4: Dimipkpk (35239 in chips, $2.45 bounty) 
Seat 5: KECAKUATL (22095 in chips, $2.45 bounty) 
Seat 6: Kevin12345Mc (17926 in chips, $2.45 bounty) 
Seat 8: igor okumura (42865 in chips, $2.45 bounty) 
posetuta: posts the ante 70
CassUK: posts the ante 70
boidoidu: posts the ante 70
Dimipkpk: posts the ante 70
KECAKUATL: posts the ante 70
Kevin12345Mc: posts the ante 70
igor okumura: posts the ante 70
CassUK: posts small blind 250
boidoidu: posts big blind 500
*** HOLE CARDS ***
Dealt to Kevin12345Mc [Tc Jc]
Tess_4444 is disconnected 
Dimipkpk: folds 
KECAKUATL: folds 
Kevin12345Mc: raises 600 to 1100
igor okumura: folds 
posetuta: folds 
CassUK: folds 
boidoidu: calls 600
*** FLOP *** [Ks 7s Qs]
boidoidu: checks 
Kevin12345Mc: bets 970
boidoidu: calls 970
*** TURN *** [Ks 7s Qs] [8s]
boidoidu: checks 
Kevin12345Mc: checks 
*** RIVER *** [Ks 7s Qs 8s] [Qc]
boidoidu: checks 
Kevin12345Mc: checks 
*** SHOW DOWN ***
boidoidu: shows [Qh 4h] (three of a kind, Queens)
Kevin12345Mc: mucks hand 
boidoidu collected 4880 from pot
*** SUMMARY ***
Total pot 4880 | Rake 0 
Board [Ks 7s Qs 8s Qc]
Seat 1: posetuta (button) folded before Flop (didn't bet)
Seat 2: CassUK (small blind) folded before Flop
Seat 3: boidoidu (big blind) showed [Qh 4h] and won (4880) with three of a kind, Queens
Seat 4: Dimipkpk folded before Flop (didn't bet)
Seat 5: KECAKUATL folded before Flop (didn't bet)
Seat 6: Kevin12345Mc mucked [Tc Jc]
Seat 8: igor okumura folded before Flop (didn't bet)



PokerStars Hand #254863849462: Tournament #3856223586, $2.45+$2.45+$0.60 USD Hold'em No Limit - Level VI (250/500) - 2025/02/14 18:21:10 WET [2025/02/14 13:21:10 ET]
Table '3856223586 32' 8-max Seat #2 is the button
Seat 1: posetuta (45420 in chips, $3.67 bounty) 
Seat 2: CassUK (28179 in chips, $3.67 bounty) 
Seat 3: boidoidu (71210 in chips, $3.67 bounty) 
Seat 4: Dimipkpk (35169 in chips, $2.45 bounty) 
Seat 5: KECAKUATL (22025 in chips, $2.45 bounty) 
Seat 6: Kevin12345Mc (15786 in chips, $2.45 bounty) 
Seat 7: Tess_4444 (25000 in chips, $2.45 bounty) 
Seat 8: igor okumura (42795 in chips, $2.45 bounty) 
posetuta: posts the ante 70
CassUK: posts the ante 70
boidoidu: posts the ante 70
Dimipkpk: posts the ante 70
KECAKUATL: posts the ante 70
Kevin12345Mc: posts the ante 70
Tess_4444: posts the ante 70
igor okumura: posts the ante 70
boidoidu: posts small blind 250
Dimipkpk: posts big blind 500
*** HOLE CARDS ***
Dealt to Kevin12345Mc [Ts Kc]
KECAKUATL: folds 
Kevin12345Mc: folds 
Tess_4444: folds 
igor okumura: folds 
posetuta: folds 
CassUK: folds 
boidoidu: folds 
Uncalled bet (250) returned to Dimipkpk
Dimipkpk collected 1060 from pot
Dimipkpk: doesn't show hand 
*** SUMMARY ***
Total pot 1060 | Rake 0 
Seat 1: posetuta folded before Flop (didn't bet)
Seat 2: CassUK (button) folded before Flop (didn't bet)
Seat 3: boidoidu (small blind) folded before Flop
Seat 4: Dimipkpk (big blind) collected (1060)
Seat 5: KECAKUATL folded before Flop (didn't bet)
Seat 6: Kevin12345Mc folded before Flop (didn't bet)
Seat 7: Tess_4444 folded before Flop (didn't bet)
Seat 8: igor okumura folded before Flop (didn't bet)



PokerStars Hand #254863857781: Tournament #3856223586, $2.45+$2.45+$0.60 USD Hold'em No Limit - Level VI (250/500) - 2025/02/14 18:21:43 WET [2025/02/14 13:21:43 ET]
Table '3856223586 32' 8-max Seat #3 is the button
Seat 1: posetuta (45350 in chips, $3.67 bounty) 
Seat 2: CassUK (28109 in chips, $3.67 bounty) 
Seat 3: boidoidu (70890 in chips, $3.67 bounty) 
Seat 4: Dimipkpk (35909 in chips, $2.45 bounty) 
Seat 5: KECAKUATL (21955 in chips, $2.45 bounty) 
Seat 6: Kevin12345Mc (15716 in chips, $2.45 bounty) 
Seat 7: Tess_4444 (24930 in chips, $2.45 bounty) 
Seat 8: igor okumura (42725 in chips, $2.45 bounty) 
posetuta: posts the ante 70
CassUK: posts the ante 70
boidoidu: posts the ante 70
Dimipkpk: posts the ante 70
KECAKUATL: posts the ante 70
Kevin12345Mc: posts the ante 70
Tess_4444: posts the ante 70
igor okumura: posts the ante 70
Dimipkpk: posts small blind 250
KECAKUATL: posts big blind 500
*** HOLE CARDS ***
Dealt to Kevin12345Mc [8d Jh]
Kevin12345Mc: folds 
Tess_4444: raises 1000 to 1500
igor okumura: folds 
posetuta: folds 
CassUK: folds 
boidoidu: calls 1500
Dimipkpk: calls 1250
KECAKUATL: calls 1000
*** FLOP *** [6c 2c Ad]
Dimipkpk: checks 
KECAKUATL: checks 
Tess_4444: bets 3280
boidoidu: folds 
Dimipkpk: calls 3280
KECAKUATL: folds 
*** TURN *** [6c 2c Ad] [Kc]
Dimipkpk: checks 
Tess_4444: bets 6560
Dimipkpk: folds 
Uncalled bet (6560) returned to Tess_4444
Tess_4444 collected 13120 from pot
*** SUMMARY ***
Total pot 13120 | Rake 0 
Board [6c 2c Ad Kc]
Seat 1: posetuta folded before Flop (didn't bet)
Seat 2: CassUK folded before Flop (didn't bet)
Seat 3: boidoidu (button) folded on the Flop
Seat 4: Dimipkpk (small blind) folded on the Turn
Seat 5: KECAKUATL (big blind) folded on the Flop
Seat 6: Kevin12345Mc folded before Flop (didn't bet)
Seat 7: Tess_4444 collected (13120)
Seat 8: igor okumura folded before Flop (didn't bet)



PokerStars Hand #254863882629: Tournament #3856223586, $2.45+$2.45+$0.60 USD Hold'em No Limit - Level VI (250/500) - 2025/02/14 18:23:22 WET [2025/02/14 13:23:22 ET]
Table '3856223586 32' 8-max Seat #4 is the button
Seat 1: posetuta (45280 in chips, $3.67 bounty) 
Seat 2: CassUK (28039 in chips, $3.67 bounty) 
Seat 3: boidoidu (69320 in chips, $3.67 bounty) 
Seat 4: Dimipkpk (31059 in chips, $2.45 bounty) 
Seat 5: KECAKUATL (20385 in chips, $2.45 bounty) 
Seat 6: Kevin12345Mc (15646 in chips, $2.45 bounty) 
Seat 7: Tess_4444 (33200 in chips, $2.45 bounty) 
Seat 8: igor okumura (42655 in chips, $2.45 bounty) 
posetuta: posts the ante 70
CassUK: posts the ante 70
boidoidu: posts the ante 70
Dimipkpk: posts the ante 70
KECAKUATL: posts the ante 70
Kevin12345Mc: posts the ante 70
Tess_4444: posts the ante 70
igor okumura: posts the ante 70
KECAKUATL: posts small blind 250
Kevin12345Mc: posts big blind 500
*** HOLE CARDS ***
Dealt to Kevin12345Mc [9d Qd]
Tess_4444: folds 
igor okumura: folds 
posetuta: folds 
CassUK: folds 
boidoidu: folds 
Dimipkpk: raises 750 to 1250
KECAKUATL: calls 1000
Kevin12345Mc: calls 750
*** FLOP *** [5s 7c 4s]
KECAKUATL: checks 
Kevin12345Mc: checks 
Dimipkpk: checks 
*** TURN *** [5s 7c 4s] [3d]
KECAKUATL: checks 
Kevin12345Mc: checks 
Dimipkpk: checks 
*** RIVER *** [5s 7c 4s 3d] [2d]
KECAKUATL: checks 
Kevin12345Mc: checks 
Dimipkpk: checks 
*** SHOW DOWN ***
KECAKUATL: shows [Td Tc] (a pair of Tens)
Kevin12345Mc: mucks hand 
Dimipkpk: mucks hand 
KECAKUATL collected 4310 from pot
*** SUMMARY ***
Total pot 4310 | Rake 0 
Board [5s 7c 4s 3d 2d]
Seat 1: posetuta folded before Flop (didn't bet)
Seat 2: CassUK folded before Flop (didn't bet)
Seat 3: boidoidu folded before Flop (didn't bet)
Seat 4: Dimipkpk (button) mucked [9h Kd]
Seat 5: KECAKUATL (small blind) showed [Td Tc] and won (4310) with a pair of Tens
Seat 6: Kevin12345Mc (big blind) mucked [9d Qd]
Seat 7: Tess_4444 folded before Flop (didn't bet)
Seat 8: igor okumura folded before Flop (didn't bet)



PokerStars Hand #254863900563: Tournament #3856223586, $2.45+$2.45+$0.60 USD Hold'em No Limit - Level VI (250/500) - 2025/02/14 18:24:33 WET [2025/02/14 13:24:33 ET]
Table '3856223586 32' 8-max Seat #5 is the button
Seat 1: posetuta (45210 in chips, $3.67 bounty) 
Seat 2: CassUK (27969 in chips, $3.67 bounty) 
Seat 3: boidoidu (69250 in chips, $3.67 bounty) 
Seat 4: Dimipkpk (29739 in chips, $2.45 bounty) 
Seat 5: KECAKUATL (23375 in chips, $2.45 bounty) 
Seat 6: Kevin12345Mc (14326 in chips, $2.45 bounty) 
Seat 7: Tess_4444 (33130 in chips, $2.45 bounty) 
Seat 8: igor okumura (42585 in chips, $2.45 bounty) 
posetuta: posts the ante 70
CassUK: posts the ante 70
boidoidu: posts the ante 70
Dimipkpk: posts the ante 70
KECAKUATL: posts the ante 70
Kevin12345Mc: posts the ante 70
Tess_4444: posts the ante 70
igor okumura: posts the ante 70
Kevin12345Mc: posts small blind 250
Tess_4444: posts big blind 500
*** HOLE CARDS ***
Dealt to Kevin12345Mc [Th 9c]
igor okumura: folds 
posetuta: folds 
CassUK: folds 
boidoidu: folds 
Dimipkpk: folds 
KECAKUATL: raises 500 to 1000
Kevin12345Mc: folds 
Tess_4444: calls 500
*** FLOP *** [Jd Tc 4s]
Tess_4444: checks 
KECAKUATL: bets 1405
Tess_4444: calls 1405
*** TURN *** [Jd Tc 4s] [Qc]
Tess_4444: checks 
KECAKUATL: bets 3500
Tess_4444: folds 
Uncalled bet (3500) returned to KECAKUATL
KECAKUATL collected 5620 from pot
KECAKUATL: doesn't show hand 
*** SUMMARY ***
Total pot 5620 | Rake 0 
Board [Jd Tc 4s Qc]
Seat 1: posetuta folded before Flop (didn't bet)
Seat 2: CassUK folded before Flop (didn't bet)
Seat 3: boidoidu folded before Flop (didn't bet)
Seat 4: Dimipkpk folded before Flop (didn't bet)
Seat 5: KECAKUATL (button) collected (5620)
Seat 6: Kevin12345Mc (small blind) folded before Flop
Seat 7: Tess_4444 (big blind) folded on the Turn
Seat 8: igor okumura folded before Flop (didn't bet)



PokerStars Hand #254863917456: Tournament #3856223586, $2.45+$2.45+$0.60 USD Hold'em No Limit - Level VII (300/600) - 2025/02/14 18:25:40 WET [2025/02/14 13:25:40 ET]
Table '3856223586 32' 8-max Seat #6 is the button
Seat 1: posetuta (45140 in chips, $3.67 bounty) 
Seat 2: CassUK (27899 in chips, $3.67 bounty) 
Seat 3: boidoidu (69180 in chips, $3.67 bounty) 
Seat 4: Dimipkpk (29669 in chips, $2.45 bounty) 
Seat 5: KECAKUATL (26520 in chips, $2.45 bounty) 
Seat 6: Kevin12345Mc (14006 in chips, $2.45 bounty) 
Seat 7: Tess_4444 (30655 in chips, $2.45 bounty) 
Seat 8: igor okumura (42515 in chips, $2.45 bounty) 
posetuta: posts the ante 80
CassUK: posts the ante 80
boidoidu: posts the ante 80
Dimipkpk: posts the ante 80
KECAKUATL: posts the ante 80
Kevin12345Mc: posts the ante 80
Tess_4444: posts the ante 80
igor okumura: posts the ante 80
Tess_4444: posts small blind 300
igor okumura: posts big blind 600
*** HOLE CARDS ***
Dealt to Kevin12345Mc [Js Jd]
posetuta: folds 
CassUK: folds 
boidoidu: folds 
Dimipkpk: raises 720 to 1320
KECAKUATL: folds 
Kevin12345Mc: raises 12606 to 13926 and is all-in
Tess_4444: folds 
igor okumura: folds 
Dimipkpk: folds 
Uncalled bet (12606) returned to Kevin12345Mc
Kevin12345Mc collected 4180 from pot
Kevin12345Mc: doesn't show hand 
*** SUMMARY ***
Total pot 4180 | Rake 0 
Seat 1: posetuta folded before Flop (didn't bet)
Seat 2: CassUK folded before Flop (didn't bet)
Seat 3: boidoidu folded before Flop (didn't bet)
Seat 4: Dimipkpk folded before Flop
Seat 5: KECAKUATL folded before Flop (didn't bet)
Seat 6: Kevin12345Mc (button) collected (4180)
Seat 7: Tess_4444 (small blind) folded before Flop
Seat 8: igor okumura (big blind) folded before Flop



PokerStars Hand #254863928244: Tournament #3856223586, $2.45+$2.45+$0.60 USD Hold'em No Limit - Level VII (300/600) - 2025/02/14 18:26:23 WET [2025/02/14 13:26:23 ET]
Table '3856223586 32' 8-max Seat #7 is the button
Seat 1: posetuta (45060 in chips, $3.67 bounty) 
Seat 2: CassUK (27819 in chips, $3.67 bounty) 
Seat 3: boidoidu (69100 in chips, $3.67 bounty) 
Seat 4: Dimipkpk (28269 in chips, $2.45 bounty) 
Seat 5: KECAKUATL (26440 in chips, $2.45 bounty) 
Seat 6: Kevin12345Mc (16786 in chips, $2.45 bounty) 
Seat 7: Tess_4444 (30275 in chips, $2.45 bounty) 
Seat 8: igor okumura (41835 in chips, $2.45 bounty) 
posetuta: posts the ante 80
CassUK: posts the ante 80
boidoidu: posts the ante 80
Dimipkpk: posts the ante 80
KECAKUATL: posts the ante 80
Kevin12345Mc: posts the ante 80
Tess_4444: posts the ante 80
igor okumura: posts the ante 80
igor okumura: posts small blind 300
posetuta: posts big blind 600
*** HOLE CARDS ***
Dealt to Kevin12345Mc [5d 9c]
CassUK: folds 
boidoidu: folds 
Dimipkpk: raises 720 to 1320
KECAKUATL: calls 1320
Kevin12345Mc: folds 
Tess_4444: folds 
igor okumura: calls 1020
posetuta: folds 
*** FLOP *** [2d 4d Td]
igor okumura: checks 
Dimipkpk: checks 
KECAKUATL: checks 
*** TURN *** [2d 4d Td] [6h]
igor okumura: bets 3900
Dimipkpk: folds 
KECAKUATL: calls 3900
*** RIVER *** [2d 4d Td 6h] [3d]
igor okumura: bets 22800
KECAKUATL: folds 
Uncalled bet (22800) returned to igor okumura
igor okumura collected 13000 from pot
igor okumura: doesn't show hand 
*** SUMMARY ***
Total pot 13000 | Rake 0 
Board [2d 4d Td 6h 3d]
Seat 1: posetuta (big blind) folded before Flop
Seat 2: CassUK folded before Flop (didn't bet)
Seat 3: boidoidu folded before Flop (didn't bet)
Seat 4: Dimipkpk folded on the Turn
Seat 5: KECAKUATL folded on the River
Seat 6: Kevin12345Mc folded before Flop (didn't bet)
Seat 7: Tess_4444 (button) folded before Flop (didn't bet)
Seat 8: igor okumura (small blind) collected (13000)



PokerStars Hand #254863952898: Tournament #3856223586, $2.45+$2.45+$0.60 USD Hold'em No Limit - Level VII (300/600) - 2025/02/14 18:28:00 WET [2025/02/14 13:28:00 ET]
Table '3856223586 32' 8-max Seat #8 is the button
Seat 1: posetuta (44380 in chips, $3.67 bounty) 
Seat 2: CassUK (27739 in chips, $3.67 bounty) 
Seat 3: boidoidu (69020 in chips, $3.67 bounty) 
Seat 4: Dimipkpk (26869 in chips, $2.45 bounty) 
Seat 5: KECAKUATL (21140 in chips, $2.45 bounty) 
Seat 6: Kevin12345Mc (16706 in chips, $2.45 bounty) 
Seat 7: Tess_4444 (30195 in chips, $2.45 bounty) 
Seat 8: igor okumura (49535 in chips, $2.45 bounty) 
posetuta: posts the ante 80
CassUK: posts the ante 80
boidoidu: posts the ante 80
Dimipkpk: posts the ante 80
KECAKUATL: posts the ante 80
Kevin12345Mc: posts the ante 80
Tess_4444: posts the ante 80
igor okumura: posts the ante 80
posetuta: posts small blind 300
CassUK: posts big blind 600
*** HOLE CARDS ***
Dealt to Kevin12345Mc [6s 8h]
boidoidu: folds 
Dimipkpk: folds 
KECAKUATL: folds 
Kevin12345Mc: folds 
Tess_4444: folds 
igor okumura: raises 600 to 1200
posetuta: folds 
CassUK: calls 600
*** FLOP *** [9c 6h 4s]
CassUK: bets 600
igor okumura: calls 600
*** TURN *** [9c 6h 4s] [Qs]
CassUK: checks 
igor okumura: bets 3405
CassUK: calls 3405
*** RIVER *** [9c 6h 4s Qs] [5s]
CassUK: checks 
igor okumura: bets 44250 and is all-in
CassUK: folds 
Uncalled bet (44250) returned to igor okumura
igor okumura collected 11350 from pot
igor okumura: doesn't show hand 
*** SUMMARY ***
Total pot 11350 | Rake 0 
Board [9c 6h 4s Qs 5s]
Seat 1: posetuta (small blind) folded before Flop
Seat 2: CassUK (big blind) folded on the River
Seat 3: boidoidu folded before Flop (didn't bet)
Seat 4: Dimipkpk folded before Flop (didn't bet)
Seat 5: KECAKUATL folded before Flop (didn't bet)
Seat 6: Kevin12345Mc folded before Flop (didn't bet)
Seat 7: Tess_4444 folded before Flop (didn't bet)
Seat 8: igor okumura (button) collected (11350)



PokerStars Hand #254863974365: Tournament #3856223586, $2.45+$2.45+$0.60 USD Hold'em No Limit - Level VII (300/600) - 2025/02/14 18:29:25 WET [2025/02/14 13:29:25 ET]
Table '3856223586 32' 8-max Seat #1 is the button
Seat 1: posetuta (44000 in chips, $3.67 bounty) 
Seat 2: CassUK (22454 in chips, $3.67 bounty) 
Seat 3: boidoidu (68940 in chips, $3.67 bounty) 
Seat 4: Dimipkpk (26789 in chips, $2.45 bounty) 
Seat 5: KECAKUATL (21060 in chips, $2.45 bounty) 
Seat 6: Kevin12345Mc (16626 in chips, $2.45 bounty) 
Seat 7: Tess_4444 (30115 in chips, $2.45 bounty) 
Seat 8: igor okumura (55600 in chips, $2.45 bounty) 
posetuta: posts the ante 80
CassUK: posts the ante 80
boidoidu: posts the ante 80
Dimipkpk: posts the ante 80
KECAKUATL: posts the ante 80
Kevin12345Mc: posts the ante 80
Tess_4444: posts the ante 80
igor okumura: posts the ante 80
CassUK: posts small blind 300
boidoidu: posts big blind 600
*** HOLE CARDS ***
Dealt to Kevin12345Mc [Td 4c]
Dimipkpk: folds 
KECAKUATL: raises 600 to 1200
Kevin12345Mc: folds 
Tess_4444: folds 
igor okumura: folds 
posetuta: folds 
CassUK: calls 900
boidoidu: calls 600
*** FLOP *** [7d Qd 4d]
CassUK: bets 600
boidoidu: folds 
KECAKUATL: calls 600
*** TURN *** [7d Qd 4d] [8c]
CassUK: bets 600
KECAKUATL: raises 4200 to 4800
CassUK: calls 4200
*** RIVER *** [7d Qd 4d 8c] [Ad]
CassUK: bets 15774 and is all-in
KECAKUATL: calls 14380 and is all-in
Uncalled bet (1394) returned to CassUK
*** SHOW DOWN ***
CassUK: shows [Tc Jd] (a flush, Ace high)
KECAKUATL: shows [Kd Kc] (a flush, Ace high - King higher)
KECAKUATL collected 43800 from pot
*** SUMMARY ***
Total pot 43800 | Rake 0 
Board [7d Qd 4d 8c Ad]
Seat 1: posetuta (button) folded before Flop (didn't bet)
Seat 2: CassUK (small blind) showed [Tc Jd] and lost with a flush, Ace high
Seat 3: boidoidu (big blind) folded on the Flop
Seat 4: Dimipkpk folded before Flop (didn't bet)
Seat 5: KECAKUATL showed [Kd Kc] and won (43800) with a flush, Ace high
Seat 6: Kevin12345Mc folded before Flop (didn't bet)
Seat 7: Tess_4444 folded before Flop (didn't bet)
Seat 8: igor okumura folded before Flop (didn't bet)



PokerStars Hand #254863990519: Tournament #3856223586, $2.45+$2.45+$0.60 USD Hold'em No Limit - Level VII (300/600) - 2025/02/14 18:30:28 WET [2025/02/14 13:30:28 ET]
Table '3856223586 32' 8-max Seat #2 is the button
Seat 1: posetuta (43920 in chips, $3.67 bounty) 
Seat 2: CassUK (1394 in chips, $3.67 bounty) 
Seat 3: boidoidu (67660 in chips, $3.67 bounty) 
Seat 4: Dimipkpk (26709 in chips, $2.45 bounty) 
Seat 5: KECAKUATL (43800 in chips, $2.45 bounty) 
Seat 6: Kevin12345Mc (16546 in chips, $2.45 bounty) 
Seat 7: Tess_4444 (30035 in chips, $2.45 bounty) 
Seat 8: igor okumura (55520 in chips, $2.45 bounty) 
posetuta: posts the ante 80
CassUK: posts the ante 80
boidoidu: posts the ante 80
Dimipkpk: posts the ante 80
KECAKUATL: posts the ante 80
Kevin12345Mc: posts the ante 80
Tess_4444: posts the ante 80
igor okumura: posts the ante 80
boidoidu: posts small blind 300
Dimipkpk: posts big blind 600
*** HOLE CARDS ***
Dealt to Kevin12345Mc [As Qd]
KECAKUATL: folds 
Kevin12345Mc: raises 660 to 1260
Tess_4444: folds 
igor okumura: folds 
posetuta: folds 
CassUK: folds 
boidoidu: folds 
Dimipkpk: calls 660
*** FLOP *** [7s 5s Jh]
Dimipkpk: checks 
Kevin12345Mc: bets 1142
Dimipkpk: folds 
Uncalled bet (1142) returned to Kevin12345Mc
Kevin12345Mc collected 3460 from pot
Kevin12345Mc: doesn't show hand 
*** SUMMARY ***
Total pot 3460 | Rake 0 
Board [7s 5s Jh]
Seat 1: posetuta folded before Flop (didn't bet)
Seat 2: CassUK (button) folded before Flop (didn't bet)
Seat 3: boidoidu (small blind) folded before Flop
Seat 4: Dimipkpk (big blind) folded on the Flop
Seat 5: KECAKUATL folded before Flop (didn't bet)
Seat 6: Kevin12345Mc collected (3460)
Seat 7: Tess_4444 folded before Flop (didn't bet)
Seat 8: igor okumura folded before Flop (didn't bet)



PokerStars Hand #254864007541: Tournament #3856223586, $2.45+$2.45+$0.60 USD Hold'em No Limit - Level VII (300/600) - 2025/02/14 18:31:34 WET [2025/02/14 13:31:34 ET]
Table '3856223586 32' 8-max Seat #3 is the button
Seat 1: posetuta (43840 in chips, $3.67 bounty) 
Seat 2: CassUK (1314 in chips, $3.67 bounty) 
Seat 3: boidoidu (67280 in chips, $3.67 bounty) 
Seat 4: Dimipkpk (25369 in chips, $2.45 bounty) 
Seat 5: KECAKUATL (43720 in chips, $2.45 bounty) 
Seat 6: Kevin12345Mc (18666 in chips, $2.45 bounty) 
Seat 7: Tess_4444 (29955 in chips, $2.45 bounty) 
Seat 8: igor okumura (55440 in chips, $2.45 bounty) 
posetuta: posts the ante 80
CassUK: posts the ante 80
boidoidu: posts the ante 80
Dimipkpk: posts the ante 80
KECAKUATL: posts the ante 80
Kevin12345Mc: posts the ante 80
Tess_4444: posts the ante 80
igor okumura: posts the ante 80
Dimipkpk: posts small blind 300
KECAKUATL: posts big blind 600
*** HOLE CARDS ***
Dealt to Kevin12345Mc [5c Ad]
Kevin12345Mc: folds 
Tess_4444: folds 
igor okumura: folds 
posetuta: folds 
CassUK: raises 634 to 1234 and is all-in
boidoidu: calls 1234
Dimipkpk: calls 934
KECAKUATL: calls 634
*** FLOP *** [6d Ts 9s]
Dimipkpk: checks 
KECAKUATL: bets 2788
boidoidu: folds 
Dimipkpk: calls 2788
*** TURN *** [6d Ts 9s] [7s]
Dimipkpk: bets 6245
KECAKUATL: folds 
Uncalled bet (6245) returned to Dimipkpk
*** RIVER *** [6d Ts 9s 7s] [4d]
*** SHOW DOWN ***
Dimipkpk: shows [Kc 8c] (a straight, Six to Ten)
Dimipkpk collected 5576 from side pot
CassUK: shows [8h 9h] (a straight, Six to Ten)
Dimipkpk collected 2788 from main pot
CassUK collected 2788 from main pot
*** SUMMARY ***
Total pot 11152 Main pot 5576. Side pot 5576. | Rake 0 
Board [6d Ts 9s 7s 4d]
Seat 1: posetuta folded before Flop (didn't bet)
Seat 2: CassUK showed [8h 9h] and won (2788) with a straight, Six to Ten
Seat 3: boidoidu (button) folded on the Flop
Seat 4: Dimipkpk (small blind) showed [Kc 8c] and won (8364) with a straight, Six to Ten
Seat 5: KECAKUATL (big blind) folded on the Turn
Seat 6: Kevin12345Mc folded before Flop (didn't bet)
Seat 7: Tess_4444 folded before Flop (didn't bet)
Seat 8: igor okumura folded before Flop (didn't bet)



PokerStars Hand #254864027867: Tournament #3856223586, $2.45+$2.45+$0.60 USD Hold'em No Limit - Level VII (300/600) - 2025/02/14 18:32:52 WET [2025/02/14 13:32:52 ET]
Table '3856223586 32' 8-max Seat #4 is the button
Seat 1: posetuta (43760 in chips, $3.67 bounty) 
Seat 2: CassUK (2788 in chips, $3.67 bounty) 
Seat 3: boidoidu (65966 in chips, $3.67 bounty) 
Seat 4: Dimipkpk (29631 in chips, $2.45 bounty) 
Seat 5: KECAKUATL (39618 in chips, $2.45 bounty) 
Seat 6: Kevin12345Mc (18586 in chips, $2.45 bounty) 
Seat 7: Tess_4444 (29875 in chips, $2.45 bounty) 
Seat 8: igor okumura (55360 in chips, $2.45 bounty) 
posetuta: posts the ante 80
CassUK: posts the ante 80
boidoidu: posts the ante 80
Dimipkpk: posts the ante 80
KECAKUATL: posts the ante 80
Kevin12345Mc: posts the ante 80
Tess_4444: posts the ante 80
igor okumura: posts the ante 80
KECAKUATL: posts small blind 300
Kevin12345Mc: posts big blind 600
*** HOLE CARDS ***
Dealt to Kevin12345Mc [Js Ah]
Tess_4444: folds 
igor okumura: folds 
posetuta: raises 900 to 1500
CassUK: folds 
boidoidu: folds 
Dimipkpk: folds 
KECAKUATL: folds 
Kevin12345Mc: calls 900
*** FLOP *** [3c 9c Qc]
Kevin12345Mc: checks 
posetuta: checks 
*** TURN *** [3c 9c Qc] [4c]
Kevin12345Mc: checks 
posetuta: checks 
*** RIVER *** [3c 9c Qc 4c] [Jc]
Kevin12345Mc: checks 
posetuta: checks 
*** SHOW DOWN ***
Kevin12345Mc: shows [Js Ah] (a flush, Queen high)
posetuta: shows [Th Ts] (a flush, Queen high)
Kevin12345Mc collected 1970 from pot
posetuta collected 1970 from pot
*** SUMMARY ***
Total pot 3940 | Rake 0 
Board [3c 9c Qc 4c Jc]
Seat 1: posetuta showed [Th Ts] and won (1970) with a flush, Queen high
Seat 2: CassUK folded before Flop (didn't bet)
Seat 3: boidoidu folded before Flop (didn't bet)
Seat 4: Dimipkpk (button) folded before Flop (didn't bet)
Seat 5: KECAKUATL (small blind) folded before Flop
Seat 6: Kevin12345Mc (big blind) showed [Js Ah] and won (1970) with a flush, Queen high
Seat 7: Tess_4444 folded before Flop (didn't bet)
Seat 8: igor okumura folded before Flop (didn't bet)



PokerStars Hand #254864040817: Tournament #3856223586, $2.45+$2.45+$0.60 USD Hold'em No Limit - Level VIII (350/700) - 2025/02/14 18:33:43 WET [2025/02/14 13:33:43 ET]
Table '3856223586 32' 8-max Seat #5 is the button
Seat 1: posetuta (44150 in chips, $3.67 bounty) 
Seat 2: CassUK (2708 in chips, $3.67 bounty) 
Seat 3: boidoidu (65886 in chips, $3.67 bounty) 
Seat 4: Dimipkpk (29551 in chips, $2.45 bounty) 
Seat 5: KECAKUATL (39238 in chips, $2.45 bounty) 
Seat 6: Kevin12345Mc (18976 in chips, $2.45 bounty) 
Seat 7: Tess_4444 (29795 in chips, $2.45 bounty) 
Seat 8: igor okumura (55280 in chips, $2.45 bounty) 
posetuta: posts the ante 90
CassUK: posts the ante 90
boidoidu: posts the ante 90
Dimipkpk: posts the ante 90
KECAKUATL: posts the ante 90
Kevin12345Mc: posts the ante 90
Tess_4444: posts the ante 90
igor okumura: posts the ante 90
Kevin12345Mc: posts small blind 350
Tess_4444: posts big blind 700
*** HOLE CARDS ***
Dealt to Kevin12345Mc [3d 5c]
igor okumura: folds 
posetuta: folds 
CassUK: raises 1918 to 2618 and is all-in
boidoidu: folds 
Dimipkpk: calls 2618
KECAKUATL: calls 2618
Kevin12345Mc: folds 
Tess_4444: folds 
*** FLOP *** [6d 6h Th]
Dimipkpk: checks 
KECAKUATL: checks 
*** TURN *** [6d 6h Th] [Qh]
Dimipkpk: checks 
KECAKUATL: bets 4812
Dimipkpk: folds 
Uncalled bet (4812) returned to KECAKUATL
*** RIVER *** [6d 6h Th Qh] [Jc]
*** SHOW DOWN ***
CassUK: shows [5h Ac] (a pair of Sixes)
KECAKUATL: shows [Kd Td] (two pair, Tens and Sixes)
KECAKUATL collected 9624 from pot
KECAKUATL wins $1.84 for eliminating CassUK and their own bounty increases by $1.83 to $4.28
CassUK finished the tournament
*** SUMMARY ***
Total pot 9624 | Rake 0 
Board [6d 6h Th Qh Jc]
Seat 1: posetuta folded before Flop (didn't bet)
Seat 2: CassUK showed [5h Ac] and lost with a pair of Sixes
Seat 3: boidoidu folded before Flop (didn't bet)
Seat 4: Dimipkpk folded on the Turn
Seat 5: KECAKUATL (button) showed [Kd Td] and won (9624) with two pair, Tens and Sixes
Seat 6: Kevin12345Mc (small blind) folded before Flop
Seat 7: Tess_4444 (big blind) folded before Flop
Seat 8: igor okumura folded before Flop (didn't bet)



PokerStars Hand #254864062643: Tournament #3856223586, $2.45+$2.45+$0.60 USD Hold'em No Limit - Level VIII (350/700) - 2025/02/14 18:35:06 WET [2025/02/14 13:35:06 ET]
Table '3856223586 32' 8-max Seat #6 is the button
Seat 1: posetuta (44060 in chips, $3.67 bounty) 
Seat 3: boidoidu (65796 in chips, $3.67 bounty) 
Seat 4: Dimipkpk (26843 in chips, $2.45 bounty) 
Seat 5: KECAKUATL (46154 in chips, $4.28 bounty) 
Seat 6: Kevin12345Mc (18536 in chips, $2.45 bounty) 
Seat 7: Tess_4444 (29005 in chips, $2.45 bounty) 
Seat 8: igor okumura (55190 in chips, $2.45 bounty) 
posetuta: posts the ante 90
boidoidu: posts the ante 90
Dimipkpk: posts the ante 90
KECAKUATL: posts the ante 90
Kevin12345Mc: posts the ante 90
Tess_4444: posts the ante 90
igor okumura: posts the ante 90
Tess_4444: posts small blind 350
igor okumura: posts big blind 700
*** HOLE CARDS ***
Dealt to Kevin12345Mc [7c 6h]
posetuta: folds 
boidoidu: folds 
Dimipkpk: raises 840 to 1540
KECAKUATL: folds 
Kevin12345Mc: folds 
HaWooli is disconnected 
Tess_4444: folds 
igor okumura: calls 840
*** FLOP *** [7d 8d 3d]
igor okumura: checks 
Dimipkpk: bets 1015
igor okumura: raises 2010 to 3025
Dimipkpk: folds 
Uncalled bet (2010) returned to igor okumura
igor okumura collected 6090 from pot
igor okumura: doesn't show hand 
*** SUMMARY ***
Total pot 6090 | Rake 0 
Board [7d 8d 3d]
Seat 1: posetuta folded before Flop (didn't bet)
Seat 3: boidoidu folded before Flop (didn't bet)
Seat 4: Dimipkpk folded on the Flop
Seat 5: KECAKUATL folded before Flop (didn't bet)
Seat 6: Kevin12345Mc (button) folded before Flop (didn't bet)
Seat 7: Tess_4444 (small blind) folded before Flop
Seat 8: igor okumura (big blind) collected (6090)



PokerStars Hand #254864079086: Tournament #3856223586, $2.45+$2.45+$0.60 USD Hold'em No Limit - Level VIII (350/700) - 2025/02/14 18:36:10 WET [2025/02/14 13:36:10 ET]
Table '3856223586 32' 8-max Seat #7 is the button
Seat 1: posetuta (43970 in chips, $3.67 bounty) 
Seat 2: HaWooli (51470 in chips, $2.45 bounty) 
Seat 3: boidoidu (65706 in chips, $3.67 bounty) 
Seat 4: Dimipkpk (24198 in chips, $2.45 bounty) 
Seat 5: KECAKUATL (46064 in chips, $4.28 bounty) 
Seat 6: Kevin12345Mc (18446 in chips, $2.45 bounty) 
Seat 7: Tess_4444 (28565 in chips, $2.45 bounty) 
Seat 8: igor okumura (58635 in chips, $2.45 bounty) 
posetuta: posts the ante 90
HaWooli: posts the ante 90
boidoidu: posts the ante 90
Dimipkpk: posts the ante 90
KECAKUATL: posts the ante 90
Kevin12345Mc: posts the ante 90
Tess_4444: posts the ante 90
igor okumura: posts the ante 90
igor okumura: posts small blind 350
posetuta: posts big blind 700
*** HOLE CARDS ***
Dealt to Kevin12345Mc [5d 2c]
HaWooli: folds 
boidoidu: folds 
Dimipkpk: folds 
KECAKUATL: folds 
Kevin12345Mc: folds 
Tess_4444: raises 700 to 1400
igor okumura: folds 
posetuta: calls 700
*** FLOP *** [4h 4s 8s]
posetuta: checks 
Tess_4444: bets 1935
posetuta: folds 
Uncalled bet (1935) returned to Tess_4444
Tess_4444 collected 3870 from pot
*** SUMMARY ***
Total pot 3870 | Rake 0 
Board [4h 4s 8s]
Seat 1: posetuta (big blind) folded on the Flop
Seat 2: HaWooli folded before Flop (didn't bet)
Seat 3: boidoidu folded before Flop (didn't bet)
Seat 4: Dimipkpk folded before Flop (didn't bet)
Seat 5: KECAKUATL folded before Flop (didn't bet)
Seat 6: Kevin12345Mc folded before Flop (didn't bet)
Seat 7: Tess_4444 (button) collected (3870)
Seat 8: igor okumura (small blind) folded before Flop



PokerStars Hand #254864087723: Tournament #3856223586, $2.45+$2.45+$0.60 USD Hold'em No Limit - Level VIII (350/700) - 2025/02/14 18:36:43 WET [2025/02/14 13:36:43 ET]
Table '3856223586 32' 8-max Seat #8 is the button
Seat 1: posetuta (42480 in chips, $3.67 bounty) 
Seat 2: HaWooli (51380 in chips, $2.45 bounty) 
Seat 3: boidoidu (65616 in chips, $3.67 bounty) 
Seat 4: Dimipkpk (24108 in chips, $2.45 bounty) 
Seat 5: KECAKUATL (45974 in chips, $4.28 bounty) 
Seat 6: Kevin12345Mc (18356 in chips, $2.45 bounty) 
Seat 7: Tess_4444 (30945 in chips, $2.45 bounty) 
Seat 8: igor okumura (58195 in chips, $2.45 bounty) 
posetuta: posts the ante 90
HaWooli: posts the ante 90
boidoidu: posts the ante 90
Dimipkpk: posts the ante 90
KECAKUATL: posts the ante 90
Kevin12345Mc: posts the ante 90
Tess_4444: posts the ante 90
igor okumura: posts the ante 90
posetuta: posts small blind 350
HaWooli: posts big blind 700
*** HOLE CARDS ***
Dealt to Kevin12345Mc [Qd As]
boidoidu: folds 
Dimipkpk: raises 770 to 1470
KECAKUATL: folds 
Kevin12345Mc: raises 16796 to 18266 and is all-in
Tess_4444: folds 
igor okumura: folds 
posetuta: raises 24124 to 42390 and is all-in
HaWooli: folds 
Dimipkpk: folds 
Uncalled bet (24124) returned to posetuta
*** FLOP *** [Kd Qh 9d]
*** TURN *** [Kd Qh 9d] [Qs]
*** RIVER *** [Kd Qh 9d Qs] [Ac]
*** SHOW DOWN ***
posetuta: shows [Ts Td] (two pair, Queens and Tens)
Kevin12345Mc: shows [Qd As] (a full house, Queens full of Aces)
Kevin12345Mc collected 39422 from pot
*** SUMMARY ***
Total pot 39422 | Rake 0 
Board [Kd Qh 9d Qs Ac]
Seat 1: posetuta (small blind) showed [Ts Td] and lost with two pair, Queens and Tens
Seat 2: HaWooli (big blind) folded before Flop
Seat 3: boidoidu folded before Flop (didn't bet)
Seat 4: Dimipkpk folded before Flop
Seat 5: KECAKUATL folded before Flop (didn't bet)
Seat 6: Kevin12345Mc showed [Qd As] and won (39422) with a full house, Queens full of Aces
Seat 7: Tess_4444 folded before Flop (didn't bet)
Seat 8: igor okumura (button) folded before Flop (didn't bet)



PokerStars Hand #254864108491: Tournament #3856223586, $2.45+$2.45+$0.60 USD Hold'em No Limit - Level VIII (350/700) - 2025/02/14 18:38:03 WET [2025/02/14 13:38:03 ET]
Table '3856223586 32' 8-max Seat #1 is the button
Seat 1: posetuta (24124 in chips, $3.67 bounty) 
Seat 2: HaWooli (50590 in chips, $2.45 bounty) 
Seat 3: boidoidu (65526 in chips, $3.67 bounty) 
Seat 4: Dimipkpk (22548 in chips, $2.45 bounty) 
Seat 5: KECAKUATL (45884 in chips, $4.28 bounty) 
Seat 6: Kevin12345Mc (39422 in chips, $2.45 bounty) 
Seat 7: Tess_4444 (30855 in chips, $2.45 bounty) 
Seat 8: igor okumura (58105 in chips, $2.45 bounty) 
posetuta: posts the ante 90
HaWooli: posts the ante 90
boidoidu: posts the ante 90
Dimipkpk: posts the ante 90
KECAKUATL: posts the ante 90
Kevin12345Mc: posts the ante 90
Tess_4444: posts the ante 90
igor okumura: posts the ante 90
HaWooli: posts small blind 350
boidoidu: posts big blind 700
*** HOLE CARDS ***
Dealt to Kevin12345Mc [Ks 2d]
Dimipkpk: folds 
KECAKUATL: raises 700 to 1400
Kevin12345Mc: folds 
Tess_4444: folds 
igor okumura: folds 
posetuta: folds 
HaWooli: folds 
boidoidu: calls 700
*** FLOP *** [Jc Jd Js]
boidoidu: checks 
KECAKUATL: checks 
*** TURN *** [Jc Jd Js] [4s]
boidoidu: checks 
KECAKUATL: checks 
*** RIVER *** [Jc Jd Js 4s] [7h]
boidoidu: checks 
KECAKUATL: bets 700
boidoidu: folds 
Uncalled bet (700) returned to KECAKUATL
KECAKUATL collected 3870 from pot
KECAKUATL: doesn't show hand 
*** SUMMARY ***
Total pot 3870 | Rake 0 
Board [Jc Jd Js 4s 7h]
Seat 1: posetuta (button) folded before Flop (didn't bet)
Seat 2: HaWooli (small blind) folded before Flop
Seat 3: boidoidu (big blind) folded on the River
Seat 4: Dimipkpk folded before Flop (didn't bet)
Seat 5: KECAKUATL collected (3870)
Seat 6: Kevin12345Mc folded before Flop (didn't bet)
Seat 7: Tess_4444 folded before Flop (didn't bet)
Seat 8: igor okumura folded before Flop (didn't bet)



PokerStars Hand #254864124198: Tournament #3856223586, $2.45+$2.45+$0.60 USD Hold'em No Limit - Level VIII (350/700) - 2025/02/14 18:39:04 WET [2025/02/14 13:39:04 ET]
Table '3856223586 32' 8-max Seat #2 is the button
Seat 1: posetuta (24034 in chips, $3.67 bounty) 
Seat 2: HaWooli (50150 in chips, $2.45 bounty) 
Seat 3: boidoidu (64036 in chips, $3.67 bounty) 
Seat 4: Dimipkpk (22458 in chips, $2.45 bounty) 
Seat 5: KECAKUATL (48264 in chips, $4.28 bounty) 
Seat 6: Kevin12345Mc (39332 in chips, $2.45 bounty) 
Seat 7: Tess_4444 (30765 in chips, $2.45 bounty) 
Seat 8: igor okumura (58015 in chips, $2.45 bounty) 
posetuta: posts the ante 90
HaWooli: posts the ante 90
boidoidu: posts the ante 90
Dimipkpk: posts the ante 90
KECAKUATL: posts the ante 90
Kevin12345Mc: posts the ante 90
Tess_4444: posts the ante 90
igor okumura: posts the ante 90
boidoidu: posts small blind 350
Dimipkpk: posts big blind 700
*** HOLE CARDS ***
Dealt to Kevin12345Mc [Qc 4h]
KECAKUATL: folds 
Kevin12345Mc: folds 
Tess_4444: folds 
igor okumura: folds 
posetuta: folds 
HaWooli: raises 784 to 1484
boidoidu: calls 1134
Dimipkpk: folds 
*** FLOP *** [Ah 6d Ad]
boidoidu: checks 
HaWooli: bets 1624
boidoidu: folds 
Uncalled bet (1624) returned to HaWooli
HaWooli collected 4388 from pot
HaWooli: doesn't show hand 
*** SUMMARY ***
Total pot 4388 | Rake 0 
Board [Ah 6d Ad]
Seat 1: posetuta folded before Flop (didn't bet)
Seat 2: HaWooli (button) collected (4388)
Seat 3: boidoidu (small blind) folded on the Flop
Seat 4: Dimipkpk (big blind) folded before Flop
Seat 5: KECAKUATL folded before Flop (didn't bet)
Seat 6: Kevin12345Mc folded before Flop (didn't bet)
Seat 7: Tess_4444 folded before Flop (didn't bet)
Seat 8: igor okumura folded before Flop (didn't bet)



PokerStars Hand #254864137049: Tournament #3856223586, $2.45+$2.45+$0.60 USD Hold'em No Limit - Level VIII (350/700) - 2025/02/14 18:39:54 WET [2025/02/14 13:39:54 ET]
Table '3856223586 32' 8-max Seat #3 is the button
Seat 1: posetuta (23944 in chips, $3.67 bounty) 
Seat 2: HaWooli (52964 in chips, $2.45 bounty) 
Seat 3: boidoidu (62462 in chips, $3.67 bounty) 
Seat 4: Dimipkpk (21668 in chips, $2.45 bounty) 
Seat 5: KECAKUATL (48174 in chips, $4.28 bounty) 
Seat 6: Kevin12345Mc (39242 in chips, $2.45 bounty) 
Seat 7: Tess_4444 (30675 in chips, $2.45 bounty) 
Seat 8: igor okumura (57925 in chips, $2.45 bounty) 
posetuta: posts the ante 90
HaWooli: posts the ante 90
boidoidu: posts the ante 90
Dimipkpk: posts the ante 90
KECAKUATL: posts the ante 90
Kevin12345Mc: posts the ante 90
Tess_4444: posts the ante 90
igor okumura: posts the ante 90
Dimipkpk: posts small blind 350
KECAKUATL: posts big blind 700
*** HOLE CARDS ***
Dealt to Kevin12345Mc [6c 8h]
Kevin12345Mc: folds 
Tess_4444: folds 
igor okumura: raises 700 to 1400
posetuta: folds 
HaWooli: folds 
boidoidu: folds 
Dimipkpk: folds 
KECAKUATL: folds 
Uncalled bet (700) returned to igor okumura
igor okumura collected 2470 from pot
igor okumura: doesn't show hand 
*** SUMMARY ***
Total pot 2470 | Rake 0 
Seat 1: posetuta folded before Flop (didn't bet)
Seat 2: HaWooli folded before Flop (didn't bet)
Seat 3: boidoidu (button) folded before Flop (didn't bet)
Seat 4: Dimipkpk (small blind) folded before Flop
Seat 5: KECAKUATL (big blind) folded before Flop
Seat 6: Kevin12345Mc folded before Flop (didn't bet)
Seat 7: Tess_4444 folded before Flop (didn't bet)
Seat 8: igor okumura collected (2470)



PokerStars Hand #254864151175: Tournament #3856223586, $2.45+$2.45+$0.60 USD Hold'em No Limit - Level VIII (350/700) - 2025/02/14 18:40:47 WET [2025/02/14 13:40:47 ET]
Table '3856223586 32' 8-max Seat #4 is the button
Seat 1: posetuta (23854 in chips, $3.67 bounty) 
Seat 2: HaWooli (52874 in chips, $2.45 bounty) 
Seat 3: boidoidu (62372 in chips, $3.67 bounty) 
Seat 4: Dimipkpk (21228 in chips, $2.45 bounty) 
Seat 5: KECAKUATL (47384 in chips, $4.28 bounty) 
Seat 6: Kevin12345Mc (39152 in chips, $2.45 bounty) 
Seat 7: Tess_4444 (30585 in chips, $2.45 bounty) 
Seat 8: igor okumura (59605 in chips, $2.45 bounty) 
posetuta: posts the ante 90
HaWooli: posts the ante 90
boidoidu: posts the ante 90
Dimipkpk: posts the ante 90
KECAKUATL: posts the ante 90
Kevin12345Mc: posts the ante 90
Tess_4444: posts the ante 90
igor okumura: posts the ante 90
KECAKUATL: posts small blind 350
Kevin12345Mc: posts big blind 700
*** HOLE CARDS ***
Dealt to Kevin12345Mc [Js 3s]
Tess_4444: folds 
igor okumura: raises 700 to 1400
posetuta: calls 1400
HaWooli: calls 1400
boidoidu: folds 
Dimipkpk: folds 
KECAKUATL: folds 
Kevin12345Mc: calls 700
*** FLOP *** [Qd 6s 2h]
Kevin12345Mc: checks 
igor okumura: checks 
posetuta: checks 
HaWooli: checks 
*** TURN *** [Qd 6s 2h] [As]
Kevin12345Mc: checks 
igor okumura: checks 
posetuta: bets 3002
HaWooli: calls 3002
Kevin12345Mc: calls 3002
igor okumura: folds 
*** RIVER *** [Qd 6s 2h As] [8h]
Kevin12345Mc: checks 
posetuta: checks 
HaWooli: checks 
*** SHOW DOWN ***
Kevin12345Mc: shows [Js 3s] (high card Ace)
posetuta: shows [Tc Ac] (a pair of Aces)
HaWooli: mucks hand 
posetuta collected 15676 from pot
*** SUMMARY ***
Total pot 15676 | Rake 0 
Board [Qd 6s 2h As 8h]
Seat 1: posetuta showed [Tc Ac] and won (15676) with a pair of Aces
Seat 2: HaWooli mucked [Ad 4d]
Seat 3: boidoidu folded before Flop (didn't bet)
Seat 4: Dimipkpk (button) folded before Flop (didn't bet)
Seat 5: KECAKUATL (small blind) folded before Flop
Seat 6: Kevin12345Mc (big blind) showed [Js 3s] and lost with high card Ace
Seat 7: Tess_4444 folded before Flop (didn't bet)
Seat 8: igor okumura folded on the Turn



PokerStars Hand #254864170591: Tournament #3856223586, $2.45+$2.45+$0.60 USD Hold'em No Limit - Level IX (400/800) - 2025/02/14 18:42:03 WET [2025/02/14 13:42:03 ET]
Table '3856223586 32' 8-max Seat #5 is the button
Seat 1: posetuta (35038 in chips, $3.67 bounty) 
Seat 2: HaWooli (48382 in chips, $2.45 bounty) 
Seat 3: boidoidu (62282 in chips, $3.67 bounty) 
Seat 4: Dimipkpk (21138 in chips, $2.45 bounty) 
Seat 5: KECAKUATL (46944 in chips, $4.28 bounty) 
Seat 6: Kevin12345Mc (34660 in chips, $2.45 bounty) 
Seat 7: Tess_4444 (30495 in chips, $2.45 bounty) 
Seat 8: igor okumura (58115 in chips, $2.45 bounty) 
posetuta: posts the ante 100
HaWooli: posts the ante 100
boidoidu: posts the ante 100
Dimipkpk: posts the ante 100
KECAKUATL: posts the ante 100
Kevin12345Mc: posts the ante 100
Tess_4444: posts the ante 100
igor okumura: posts the ante 100
Kevin12345Mc: posts small blind 400
Tess_4444: posts big blind 800
*** HOLE CARDS ***
Dealt to Kevin12345Mc [Jh Ts]
igor okumura: raises 800 to 1600
posetuta: folds 
HaWooli: folds 
boidoidu: folds 
Dimipkpk: folds 
KECAKUATL: calls 1600
Kevin12345Mc: folds 
Tess_4444: folds 
*** FLOP *** [Ah Qh Kd]
igor okumura: checks 
KECAKUATL: checks 
*** TURN *** [Ah Qh Kd] [Qd]
igor okumura: bets 3900
KECAKUATL: calls 3900
*** RIVER *** [Ah Qh Kd Qd] [2d]
igor okumura: bets 12000
KECAKUATL: calls 12000
*** SHOW DOWN ***
igor okumura: shows [Qc Jd] (three of a kind, Queens)
KECAKUATL: shows [6d 7d] (a flush, King high)
KECAKUATL collected 37000 from pot
*** SUMMARY ***
Total pot 37000 | Rake 0 
Board [Ah Qh Kd Qd 2d]
Seat 1: posetuta folded before Flop (didn't bet)
Seat 2: HaWooli folded before Flop (didn't bet)
Seat 3: boidoidu folded before Flop (didn't bet)
Seat 4: Dimipkpk folded before Flop (didn't bet)
Seat 5: KECAKUATL (button) showed [6d 7d] and won (37000) with a flush, King high
Seat 6: Kevin12345Mc (small blind) folded before Flop
Seat 7: Tess_4444 (big blind) folded before Flop
Seat 8: igor okumura showed [Qc Jd] and lost with three of a kind, Queens



PokerStars Hand #254864190072: Tournament #3856223586, $2.45+$2.45+$0.60 USD Hold'em No Limit - Level IX (400/800) - 2025/02/14 18:43:17 WET [2025/02/14 13:43:17 ET]
Table '3856223586 32' 8-max Seat #6 is the button
Seat 1: posetuta (34938 in chips, $3.67 bounty) 
Seat 2: HaWooli (48282 in chips, $2.45 bounty) 
Seat 3: boidoidu (62182 in chips, $3.67 bounty) 
Seat 5: KECAKUATL (66344 in chips, $4.28 bounty) 
Seat 6: Kevin12345Mc (34160 in chips, $2.45 bounty) 
Seat 7: Tess_4444 (29595 in chips, $2.45 bounty) 
Seat 8: igor okumura (40515 in chips, $2.45 bounty) 
posetuta: posts the ante 100
HaWooli: posts the ante 100
boidoidu: posts the ante 100
KECAKUATL: posts the ante 100
Kevin12345Mc: posts the ante 100
Tess_4444: posts the ante 100
igor okumura: posts the ante 100
Tess_4444: posts small blind 400
igor okumura: posts big blind 800
*** HOLE CARDS ***
Dealt to Kevin12345Mc [Kc Th]
posetuta: folds 
HaWooli: folds 
boidoidu: folds 
KECAKUATL: folds 
Kevin12345Mc: raises 1040 to 1840
Tess_4444: calls 1440
igor okumura: calls 1040
*** FLOP *** [5c 9d 2h]
Tess_4444: bets 3110
igor okumura: folds 
DerKingKalle is disconnected 
Kevin12345Mc: folds 
Uncalled bet (3110) returned to Tess_4444
Tess_4444 collected 6220 from pot
*** SUMMARY ***
Total pot 6220 | Rake 0 
Board [5c 9d 2h]
Seat 1: posetuta folded before Flop (didn't bet)
Seat 2: HaWooli folded before Flop (didn't bet)
Seat 3: boidoidu folded before Flop (didn't bet)
Seat 5: KECAKUATL folded before Flop (didn't bet)
Seat 6: Kevin12345Mc (button) folded on the Flop
Seat 7: Tess_4444 (small blind) collected (6220)
Seat 8: igor okumura (big blind) folded on the Flop



PokerStars Hand #254864202685: Tournament #3856223586, $2.45+$2.45+$0.60 USD Hold'em No Limit - Level IX (400/800) - 2025/02/14 18:44:05 WET [2025/02/14 13:44:05 ET]
Table '3856223586 32' 8-max Seat #7 is the button
Seat 1: posetuta (34838 in chips, $3.67 bounty) 
Seat 2: HaWooli (48182 in chips, $2.45 bounty) 
Seat 3: boidoidu (62082 in chips, $3.67 bounty) 
Seat 4: DerKingKalle (25000 in chips, $2.45 bounty) 
Seat 5: KECAKUATL (66244 in chips, $4.28 bounty) 
Seat 6: Kevin12345Mc (32220 in chips, $2.45 bounty) 
Seat 7: Tess_4444 (33875 in chips, $2.45 bounty) 
Seat 8: igor okumura (38575 in chips, $2.45 bounty) 
posetuta: posts the ante 100
HaWooli: posts the ante 100
boidoidu: posts the ante 100
DerKingKalle: posts the ante 100
KECAKUATL: posts the ante 100
Kevin12345Mc: posts the ante 100
Tess_4444: posts the ante 100
igor okumura: posts the ante 100
igor okumura: posts small blind 400
posetuta: posts big blind 800
*** HOLE CARDS ***
Dealt to Kevin12345Mc [7d 3s]
HaWooli: folds 
boidoidu: folds 
DerKingKalle: folds 
KECAKUATL: folds 
Kevin12345Mc: folds 
Tess_4444: raises 1600 to 2400
igor okumura: calls 2000
posetuta: calls 1600
*** FLOP *** [Js 6s 3h]
igor okumura: checks 
posetuta: bets 2640
Tess_4444: raises 6640 to 9280
igor okumura: folds 
posetuta: folds 
Uncalled bet (6640) returned to Tess_4444
Tess_4444 collected 13280 from pot
*** SUMMARY ***
Total pot 13280 | Rake 0 
Board [Js 6s 3h]
Seat 1: posetuta (big blind) folded on the Flop
Seat 2: HaWooli folded before Flop (didn't bet)
Seat 3: boidoidu folded before Flop (didn't bet)
Seat 4: DerKingKalle folded before Flop (didn't bet)
Seat 5: KECAKUATL folded before Flop (didn't bet)
Seat 6: Kevin12345Mc folded before Flop (didn't bet)
Seat 7: Tess_4444 (button) collected (13280)
Seat 8: igor okumura (small blind) folded on the Flop



PokerStars Hand #254864224188: Tournament #3856223586, $2.45+$2.45+$0.60 USD Hold'em No Limit - Level IX (400/800) - 2025/02/14 18:45:28 WET [2025/02/14 13:45:28 ET]
Table '3856223586 32' 8-max Seat #8 is the button
Seat 1: posetuta (29698 in chips, $3.67 bounty) 
Seat 2: HaWooli (48082 in chips, $2.45 bounty) 
Seat 3: boidoidu (61982 in chips, $3.67 bounty) 
Seat 4: DerKingKalle (24900 in chips, $2.45 bounty) 
Seat 5: KECAKUATL (66144 in chips, $4.28 bounty) 
Seat 6: Kevin12345Mc (32120 in chips, $2.45 bounty) 
Seat 7: Tess_4444 (42015 in chips, $2.45 bounty) 
Seat 8: igor okumura (36075 in chips, $2.45 bounty) 
posetuta: posts the ante 100
HaWooli: posts the ante 100
boidoidu: posts the ante 100
DerKingKalle: posts the ante 100
KECAKUATL: posts the ante 100
Kevin12345Mc: posts the ante 100
Tess_4444: posts the ante 100
igor okumura: posts the ante 100
posetuta: posts small blind 400
HaWooli: posts big blind 800
*** HOLE CARDS ***
Dealt to Kevin12345Mc [9s 6h]
boidoidu: folds 
DerKingKalle: folds 
KECAKUATL: folds 
Kevin12345Mc: folds 
Tess_4444: folds 
igor okumura: raises 800 to 1600
posetuta: folds 
HaWooli: folds 
Uncalled bet (800) returned to igor okumura
igor okumura collected 2800 from pot
igor okumura: doesn't show hand 
*** SUMMARY ***
Total pot 2800 | Rake 0 
Seat 1: posetuta (small blind) folded before Flop
Seat 2: HaWooli (big blind) folded before Flop
Seat 3: boidoidu folded before Flop (didn't bet)
Seat 4: DerKingKalle folded before Flop (didn't bet)
Seat 5: KECAKUATL folded before Flop (didn't bet)
Seat 6: Kevin12345Mc folded before Flop (didn't bet)
Seat 7: Tess_4444 folded before Flop (didn't bet)
Seat 8: igor okumura (button) collected (2800)



PokerStars Hand #254864236374: Tournament #3856223586, $2.45+$2.45+$0.60 USD Hold'em No Limit - Level IX (400/800) - 2025/02/14 18:46:14 WET [2025/02/14 13:46:14 ET]
Table '3856223586 32' 8-max Seat #1 is the button
Seat 1: posetuta (29198 in chips, $3.67 bounty) 
Seat 2: HaWooli (47182 in chips, $2.45 bounty) 
Seat 3: boidoidu (61882 in chips, $3.67 bounty) 
Seat 4: DerKingKalle (24800 in chips, $2.45 bounty) 
Seat 5: KECAKUATL (66044 in chips, $4.28 bounty) 
Seat 6: Kevin12345Mc (32020 in chips, $2.45 bounty) 
Seat 7: Tess_4444 (41915 in chips, $2.45 bounty) 
Seat 8: igor okumura (37975 in chips, $2.45 bounty) 
posetuta: posts the ante 100
HaWooli: posts the ante 100
boidoidu: posts the ante 100
DerKingKalle: posts the ante 100
KECAKUATL: posts the ante 100
Kevin12345Mc: posts the ante 100
Tess_4444: posts the ante 100
igor okumura: posts the ante 100
HaWooli: posts small blind 400
boidoidu: posts big blind 800
*** HOLE CARDS ***
Dealt to Kevin12345Mc [4c Ah]
DerKingKalle: folds 
KECAKUATL: folds 
Kevin12345Mc: folds 
Tess_4444: folds 
igor okumura: folds 
posetuta: folds 
HaWooli: raises 896 to 1696
boidoidu: calls 896
*** FLOP *** [Kd 8d 9h]
HaWooli: bets 1551
boidoidu: calls 1551
*** TURN *** [Kd 8d 9h] [2s]
HaWooli: bets 4960
boidoidu: folds 
Uncalled bet (4960) returned to HaWooli
HaWooli collected 7294 from pot
HaWooli: doesn't show hand 
*** SUMMARY ***
Total pot 7294 | Rake 0 
Board [Kd 8d 9h 2s]
Seat 1: posetuta (button) folded before Flop (didn't bet)
Seat 2: HaWooli (small blind) collected (7294)
Seat 3: boidoidu (big blind) folded on the Turn
Seat 4: DerKingKalle folded before Flop (didn't bet)
Seat 5: KECAKUATL folded before Flop (didn't bet)
Seat 6: Kevin12345Mc folded before Flop (didn't bet)
Seat 7: Tess_4444 folded before Flop (didn't bet)
Seat 8: igor okumura folded before Flop (didn't bet)



PokerStars Hand #254864248466: Tournament #3856223586, $2.45+$2.45+$0.60 USD Hold'em No Limit - Level IX (400/800) - 2025/02/14 18:47:00 WET [2025/02/14 13:47:00 ET]
Table '3856223586 32' 8-max Seat #2 is the button
Seat 1: posetuta (29098 in chips, $3.67 bounty) 
Seat 2: HaWooli (51129 in chips, $2.45 bounty) 
Seat 3: boidoidu (58535 in chips, $3.67 bounty) 
Seat 4: DerKingKalle (24700 in chips, $2.45 bounty) 
Seat 5: KECAKUATL (65944 in chips, $4.28 bounty) 
Seat 6: Kevin12345Mc (31920 in chips, $2.45 bounty) 
Seat 7: Tess_4444 (41815 in chips, $2.45 bounty) 
Seat 8: igor okumura (37875 in chips, $2.45 bounty) 
posetuta: posts the ante 100
HaWooli: posts the ante 100
boidoidu: posts the ante 100
DerKingKalle: posts the ante 100
KECAKUATL: posts the ante 100
Kevin12345Mc: posts the ante 100
Tess_4444: posts the ante 100
igor okumura: posts the ante 100
boidoidu: posts small blind 400
DerKingKalle: posts big blind 800
*** HOLE CARDS ***
Dealt to Kevin12345Mc [Th Ah]
KECAKUATL: folds 
Kevin12345Mc: raises 960 to 1760
Tess_4444: folds 
igor okumura: folds 
posetuta: folds 
HaWooli: folds 
boidoidu: calls 1360
DerKingKalle: folds 
*** FLOP *** [Jh 5s 6d]
boidoidu: checks 
Kevin12345Mc: bets 1690
boidoidu: calls 1690
*** TURN *** [Jh 5s 6d] [2d]
boidoidu: checks 
Kevin12345Mc: checks 
*** RIVER *** [Jh 5s 6d 2d] [As]
boidoidu: checks 
Kevin12345Mc: bets 2805
boidoidu: folds 
Uncalled bet (2805) returned to Kevin12345Mc
Kevin12345Mc collected 8500 from pot
Kevin12345Mc: doesn't show hand 
*** SUMMARY ***
Total pot 8500 | Rake 0 
Board [Jh 5s 6d 2d As]
Seat 1: posetuta folded before Flop (didn't bet)
Seat 2: HaWooli (button) folded before Flop (didn't bet)
Seat 3: boidoidu (small blind) folded on the River
Seat 4: DerKingKalle (big blind) folded before Flop
Seat 5: KECAKUATL folded before Flop (didn't bet)
Seat 6: Kevin12345Mc collected (8500)
Seat 7: Tess_4444 folded before Flop (didn't bet)
Seat 8: igor okumura folded before Flop (didn't bet)



PokerStars Hand #254864259816: Tournament #3856223586, $2.45+$2.45+$0.60 USD Hold'em No Limit - Level IX (400/800) - 2025/02/14 18:47:43 WET [2025/02/14 13:47:43 ET]
Table '3856223586 32' 8-max Seat #3 is the button
Seat 1: posetuta (28998 in chips, $3.67 bounty) 
Seat 2: HaWooli (51029 in chips, $2.45 bounty) 
Seat 3: boidoidu (54985 in chips, $3.67 bounty) 
Seat 4: DerKingKalle (23800 in chips, $2.45 bounty) 
Seat 5: KECAKUATL (65844 in chips, $4.28 bounty) 
Seat 6: Kevin12345Mc (36870 in chips, $2.45 bounty) 
Seat 7: Tess_4444 (41715 in chips, $2.45 bounty) 
Seat 8: igor okumura (37775 in chips, $2.45 bounty) 
posetuta: posts the ante 100
HaWooli: posts the ante 100
boidoidu: posts the ante 100
DerKingKalle: posts the ante 100
KECAKUATL: posts the ante 100
Kevin12345Mc: posts the ante 100
Tess_4444: posts the ante 100
igor okumura: posts the ante 100
DerKingKalle: posts small blind 400
KECAKUATL: posts big blind 800
*** HOLE CARDS ***
Dealt to Kevin12345Mc [9c 6d]
Kevin12345Mc: folds 
Tess_4444: raises 800 to 1600
igor okumura: folds 
posetuta: folds 
HaWooli: folds 
boidoidu: folds 
DerKingKalle: folds 
KECAKUATL: folds 
Uncalled bet (800) returned to Tess_4444
Tess_4444 collected 2800 from pot
*** SUMMARY ***
Total pot 2800 | Rake 0 
Seat 1: posetuta folded before Flop (didn't bet)
Seat 2: HaWooli folded before Flop (didn't bet)
Seat 3: boidoidu (button) folded before Flop (didn't bet)
Seat 4: DerKingKalle (small blind) folded before Flop
Seat 5: KECAKUATL (big blind) folded before Flop
Seat 6: Kevin12345Mc folded before Flop (didn't bet)
Seat 7: Tess_4444 collected (2800)
Seat 8: igor okumura folded before Flop (didn't bet)



PokerStars Hand #254864266266: Tournament #3856223586, $2.45+$2.45+$0.60 USD Hold'em No Limit - Level IX (400/800) - 2025/02/14 18:48:08 WET [2025/02/14 13:48:08 ET]
Table '3856223586 32' 8-max Seat #4 is the button
Seat 1: posetuta (28898 in chips, $3.67 bounty) 
Seat 2: HaWooli (50929 in chips, $2.45 bounty) 
Seat 3: boidoidu (54885 in chips, $3.67 bounty) 
Seat 4: DerKingKalle (23300 in chips, $2.45 bounty) 
Seat 5: KECAKUATL (64944 in chips, $4.28 bounty) 
Seat 6: Kevin12345Mc (36770 in chips, $2.45 bounty) 
Seat 7: Tess_4444 (43615 in chips, $2.45 bounty) 
Seat 8: igor okumura (37675 in chips, $2.45 bounty) 
posetuta: posts the ante 100
HaWooli: posts the ante 100
boidoidu: posts the ante 100
DerKingKalle: posts the ante 100
KECAKUATL: posts the ante 100
Kevin12345Mc: posts the ante 100
Tess_4444: posts the ante 100
igor okumura: posts the ante 100
KECAKUATL: posts small blind 400
Kevin12345Mc: posts big blind 800
*** HOLE CARDS ***
Dealt to Kevin12345Mc [7s Ad]
Tess_4444: folds 
igor okumura: folds 
posetuta: folds 
HaWooli: folds 
boidoidu: raises 800 to 1600
DerKingKalle: folds 
KECAKUATL: folds 
Kevin12345Mc: calls 800
*** FLOP *** [Tc 6d 3s]
Kevin12345Mc: checks 
boidoidu: bets 2200
Kevin12345Mc: folds 
Uncalled bet (2200) returned to boidoidu
boidoidu collected 4400 from pot
boidoidu: doesn't show hand 
*** SUMMARY ***
Total pot 4400 | Rake 0 
Board [Tc 6d 3s]
Seat 1: posetuta folded before Flop (didn't bet)
Seat 2: HaWooli folded before Flop (didn't bet)
Seat 3: boidoidu collected (4400)
Seat 4: DerKingKalle (button) folded before Flop (didn't bet)
Seat 5: KECAKUATL (small blind) folded before Flop
Seat 6: Kevin12345Mc (big blind) folded on the Flop
Seat 7: Tess_4444 folded before Flop (didn't bet)
Seat 8: igor okumura folded before Flop (didn't bet)



PokerStars Hand #254864274340: Tournament #3856223586, $2.45+$2.45+$0.60 USD Hold'em No Limit - Level IX (400/800) - 2025/02/14 18:48:39 WET [2025/02/14 13:48:39 ET]
Table '3856223586 32' 8-max Seat #5 is the button
Seat 1: posetuta (28798 in chips, $3.67 bounty) 
Seat 2: HaWooli (50829 in chips, $2.45 bounty) 
Seat 3: boidoidu (57585 in chips, $3.67 bounty) 
Seat 4: DerKingKalle (23200 in chips, $2.45 bounty) 
Seat 5: KECAKUATL (64444 in chips, $4.28 bounty) 
Seat 6: Kevin12345Mc (35070 in chips, $2.45 bounty) 
Seat 7: Tess_4444 (43515 in chips, $2.45 bounty) 
Seat 8: igor okumura (37575 in chips, $2.45 bounty) 
posetuta: posts the ante 100
HaWooli: posts the ante 100
boidoidu: posts the ante 100
DerKingKalle: posts the ante 100
KECAKUATL: posts the ante 100
Kevin12345Mc: posts the ante 100
Tess_4444: posts the ante 100
igor okumura: posts the ante 100
Kevin12345Mc: posts small blind 400
Tess_4444: posts big blind 800
*** HOLE CARDS ***
Dealt to Kevin12345Mc [8s Jd]
igor okumura: folds 
posetuta: raises 1200 to 2000
HaWooli: folds 
boidoidu: folds 
DerKingKalle: folds 
KECAKUATL: folds 
Kevin12345Mc: folds 
Tess_4444: folds 
Uncalled bet (1200) returned to posetuta
posetuta collected 2800 from pot
posetuta: doesn't show hand 
*** SUMMARY ***
Total pot 2800 | Rake 0 
Seat 1: posetuta collected (2800)
Seat 2: HaWooli folded before Flop (didn't bet)
Seat 3: boidoidu folded before Flop (didn't bet)
Seat 4: DerKingKalle folded before Flop (didn't bet)
Seat 5: KECAKUATL (button) folded before Flop (didn't bet)
Seat 6: Kevin12345Mc (small blind) folded before Flop
Seat 7: Tess_4444 (big blind) folded before Flop
Seat 8: igor okumura folded before Flop (didn't bet)



PokerStars Hand #254864280493: Tournament #3856223586, $2.45+$2.45+$0.60 USD Hold'em No Limit - Level IX (400/800) - 2025/02/14 18:49:02 WET [2025/02/14 13:49:02 ET]
Table '3856223586 32' 8-max Seat #6 is the button
Seat 1: posetuta (30698 in chips, $3.67 bounty) 
Seat 2: HaWooli (50729 in chips, $2.45 bounty) 
Seat 3: boidoidu (57485 in chips, $3.67 bounty) 
Seat 4: DerKingKalle (23100 in chips, $2.45 bounty) 
Seat 5: KECAKUATL (64344 in chips, $4.28 bounty) 
Seat 6: Kevin12345Mc (34570 in chips, $2.45 bounty) 
Seat 7: Tess_4444 (42615 in chips, $2.45 bounty) 
Seat 8: igor okumura (37475 in chips, $2.45 bounty) 
posetuta: posts the ante 100
HaWooli: posts the ante 100
boidoidu: posts the ante 100
DerKingKalle: posts the ante 100
KECAKUATL: posts the ante 100
Kevin12345Mc: posts the ante 100
Tess_4444: posts the ante 100
igor okumura: posts the ante 100
Tess_4444: posts small blind 400
igor okumura: posts big blind 800
*** HOLE CARDS ***
Dealt to Kevin12345Mc [6d Th]
posetuta: folds 
HaWooli: folds 
boidoidu: folds 
DerKingKalle: raises 960 to 1760
KECAKUATL: folds 
Kevin12345Mc: folds 
Tess_4444: calls 1360
igor okumura: folds 
*** FLOP *** [7s 3c As]
Tess_4444: checks 
DerKingKalle: bets 1690
Tess_4444: calls 1690
*** TURN *** [7s 3c As] [8c]
Tess_4444: checks 
DerKingKalle: checks 
*** RIVER *** [7s 3c As 8c] [Kc]
Tess_4444: checks 
DerKingKalle: bets 4800
Tess_4444: folds 
Uncalled bet (4800) returned to DerKingKalle
DerKingKalle collected 8500 from pot
DerKingKalle: doesn't show hand 
*** SUMMARY ***
Total pot 8500 | Rake 0 
Board [7s 3c As 8c Kc]
Seat 1: posetuta folded before Flop (didn't bet)
Seat 2: HaWooli folded before Flop (didn't bet)
Seat 3: boidoidu folded before Flop (didn't bet)
Seat 4: DerKingKalle collected (8500)
Seat 5: KECAKUATL folded before Flop (didn't bet)
Seat 6: Kevin12345Mc (button) folded before Flop (didn't bet)
Seat 7: Tess_4444 (small blind) folded on the River
Seat 8: igor okumura (big blind) folded before Flop



PokerStars Hand #254864306658: Tournament #3856223586, $2.45+$2.45+$0.60 USD Hold'em No Limit - Level X (450/900) - 2025/02/14 18:50:43 WET [2025/02/14 13:50:43 ET]
Table '3856223586 32' 8-max Seat #7 is the button
Seat 1: posetuta (30598 in chips, $3.67 bounty) 
Seat 2: HaWooli (50629 in chips, $2.45 bounty) 
Seat 3: boidoidu (57385 in chips, $3.67 bounty) 
Seat 4: DerKingKalle (28050 in chips, $2.45 bounty) 
Seat 5: KECAKUATL (64244 in chips, $4.28 bounty) 
Seat 6: Kevin12345Mc (34470 in chips, $2.45 bounty) 
Seat 7: Tess_4444 (39065 in chips, $2.45 bounty) 
Seat 8: igor okumura (36575 in chips, $2.45 bounty) 
posetuta: posts the ante 125
HaWooli: posts the ante 125
boidoidu: posts the ante 125
DerKingKalle: posts the ante 125
KECAKUATL: posts the ante 125
Kevin12345Mc: posts the ante 125
Tess_4444: posts the ante 125
igor okumura: posts the ante 125
igor okumura: posts small blind 450
posetuta: posts big blind 900
*** HOLE CARDS ***
Dealt to Kevin12345Mc [Kc 4d]
HaWooli: folds 
boidoidu: folds 
DerKingKalle: folds 
KECAKUATL: folds 
Kevin12345Mc: folds 
Tess_4444: raises 900 to 1800
igor okumura: folds 
posetuta: calls 900
*** FLOP *** [8c Kd Ac]
posetuta: checks 
Tess_4444: bets 2525
posetuta: folds 
Uncalled bet (2525) returned to Tess_4444
Tess_4444 collected 5050 from pot
*** SUMMARY ***
Total pot 5050 | Rake 0 
Board [8c Kd Ac]
Seat 1: posetuta (big blind) folded on the Flop
Seat 2: HaWooli folded before Flop (didn't bet)
Seat 3: boidoidu folded before Flop (didn't bet)
Seat 4: DerKingKalle folded before Flop (didn't bet)
Seat 5: KECAKUATL folded before Flop (didn't bet)
Seat 6: Kevin12345Mc folded before Flop (didn't bet)
Seat 7: Tess_4444 (button) collected (5050)
Seat 8: igor okumura (small blind) folded before Flop



PokerStars Hand #254864315026: Tournament #3856223586, $2.45+$2.45+$0.60 USD Hold'em No Limit - Level X (450/900) - 2025/02/14 18:51:16 WET [2025/02/14 13:51:16 ET]
Table '3856223586 32' 8-max Seat #8 is the button
Seat 1: posetuta (28673 in chips, $3.67 bounty) 
Seat 2: HaWooli (50504 in chips, $2.45 bounty) 
Seat 3: boidoidu (57260 in chips, $3.67 bounty) 
Seat 4: DerKingKalle (27925 in chips, $2.45 bounty) 
Seat 5: KECAKUATL (64119 in chips, $4.28 bounty) 
Seat 6: Kevin12345Mc (34345 in chips, $2.45 bounty) 
Seat 7: Tess_4444 (42190 in chips, $2.45 bounty) 
Seat 8: igor okumura (36000 in chips, $2.45 bounty) 
posetuta: posts the ante 125
HaWooli: posts the ante 125
boidoidu: posts the ante 125
DerKingKalle: posts the ante 125
KECAKUATL: posts the ante 125
Kevin12345Mc: posts the ante 125
Tess_4444: posts the ante 125
igor okumura: posts the ante 125
posetuta: posts small blind 450
HaWooli: posts big blind 900
*** HOLE CARDS ***
Dealt to Kevin12345Mc [9s 5c]
boidoidu: folds 
DerKingKalle: folds 
KECAKUATL: folds 
Kevin12345Mc: folds 
Tess_4444: folds 
igor okumura: folds 
posetuta: folds 
Uncalled bet (450) returned to HaWooli
HaWooli collected 1900 from pot
HaWooli: doesn't show hand 
*** SUMMARY ***
Total pot 1900 | Rake 0 
Seat 1: posetuta (small blind) folded before Flop
Seat 2: HaWooli (big blind) collected (1900)
Seat 3: boidoidu folded before Flop (didn't bet)
Seat 4: DerKingKalle folded before Flop (didn't bet)
Seat 5: KECAKUATL folded before Flop (didn't bet)
Seat 6: Kevin12345Mc folded before Flop (didn't bet)
Seat 7: Tess_4444 folded before Flop (didn't bet)
Seat 8: igor okumura (button) folded before Flop (didn't bet)



PokerStars Hand #254864320341: Tournament #3856223586, $2.45+$2.45+$0.60 USD Hold'em No Limit - Level X (450/900) - 2025/02/14 18:51:36 WET [2025/02/14 13:51:36 ET]
Table '3856223586 32' 8-max Seat #1 is the button
Seat 1: posetuta (28098 in chips, $3.67 bounty) 
Seat 2: HaWooli (51829 in chips, $2.45 bounty) 
Seat 3: boidoidu (57135 in chips, $3.67 bounty) 
Seat 4: DerKingKalle (27800 in chips, $2.45 bounty) 
Seat 5: KECAKUATL (63994 in chips, $4.28 bounty) 
Seat 6: Kevin12345Mc (34220 in chips, $2.45 bounty) 
Seat 7: Tess_4444 (42065 in chips, $2.45 bounty) 
Seat 8: igor okumura (35875 in chips, $2.45 bounty) 
posetuta: posts the ante 125
HaWooli: posts the ante 125
boidoidu: posts the ante 125
DerKingKalle: posts the ante 125
KECAKUATL: posts the ante 125
Kevin12345Mc: posts the ante 125
Tess_4444: posts the ante 125
igor okumura: posts the ante 125
HaWooli: posts small blind 450
boidoidu: posts big blind 900
*** HOLE CARDS ***
Dealt to Kevin12345Mc [5s Ah]
DerKingKalle: folds 
KECAKUATL: folds 
Kevin12345Mc: folds 
Tess_4444: folds 
igor okumura: raises 900 to 1800
posetuta: folds 
HaWooli: folds 
boidoidu: calls 900
*** FLOP *** [9d 8c 3s]
boidoidu: checks 
igor okumura: checks 
*** TURN *** [9d 8c 3s] [Qh]
boidoidu: checks 
igor okumura: checks 
*** RIVER *** [9d 8c 3s Qh] [9s]
boidoidu: bets 2525
igor okumura: folds 
Uncalled bet (2525) returned to boidoidu
boidoidu collected 5050 from pot
boidoidu: doesn't show hand 
*** SUMMARY ***
Total pot 5050 | Rake 0 
Board [9d 8c 3s Qh 9s]
Seat 1: posetuta (button) folded before Flop (didn't bet)
Seat 2: HaWooli (small blind) folded before Flop
Seat 3: boidoidu (big blind) collected (5050)
Seat 4: DerKingKalle folded before Flop (didn't bet)
Seat 5: KECAKUATL folded before Flop (didn't bet)
Seat 6: Kevin12345Mc folded before Flop (didn't bet)
Seat 7: Tess_4444 folded before Flop (didn't bet)
Seat 8: igor okumura folded on the River



PokerStars Hand #254864342600: Tournament #3856223586, $2.45+$2.45+$0.60 USD Hold'em No Limit - Level X (450/900) - 2025/02/14 18:53:02 WET [2025/02/14 13:53:02 ET]
Table '3856223586 32' 8-max Seat #2 is the button
Seat 1: posetuta (27973 in chips, $3.67 bounty) 
Seat 2: HaWooli (51254 in chips, $2.45 bounty) 
Seat 3: boidoidu (60260 in chips, $3.67 bounty) 
Seat 4: DerKingKalle (27675 in chips, $2.45 bounty) 
Seat 5: KECAKUATL (63869 in chips, $4.28 bounty) 
Seat 6: Kevin12345Mc (34095 in chips, $2.45 bounty) 
Seat 7: Tess_4444 (41940 in chips, $2.45 bounty) 
Seat 8: igor okumura (33950 in chips, $2.45 bounty) 
posetuta: posts the ante 125
HaWooli: posts the ante 125
boidoidu: posts the ante 125
DerKingKalle: posts the ante 125
KECAKUATL: posts the ante 125
Kevin12345Mc: posts the ante 125
Tess_4444: posts the ante 125
igor okumura: posts the ante 125
boidoidu: posts small blind 450
DerKingKalle: posts big blind 900
*** HOLE CARDS ***
Dealt to Kevin12345Mc [9c 2s]
KECAKUATL: folds 
Kevin12345Mc: folds 
Tess_4444: raises 900 to 1800
igor okumura: folds 
posetuta: folds 
HaWooli: calls 1800
boidoidu: folds 
DerKingKalle: calls 900
*** FLOP *** [7d 7c 5d]
DerKingKalle: checks 
Tess_4444: checks 
HaWooli: checks 
*** TURN *** [7d 7c 5d] [2d]
DerKingKalle: checks 
Tess_4444: checks 
HaWooli: checks 
*** RIVER *** [7d 7c 5d 2d] [6d]
DerKingKalle: checks 
Tess_4444: checks 
HaWooli: bets 6850
DerKingKalle: folds 
Tess_4444: folds 
Uncalled bet (6850) returned to HaWooli
HaWooli collected 6850 from pot
HaWooli: doesn't show hand 
*** SUMMARY ***
Total pot 6850 | Rake 0 
Board [7d 7c 5d 2d 6d]
Seat 1: posetuta folded before Flop (didn't bet)
Seat 2: HaWooli (button) collected (6850)
Seat 3: boidoidu (small blind) folded before Flop
Seat 4: DerKingKalle (big blind) folded on the River
Seat 5: KECAKUATL folded before Flop (didn't bet)
Seat 6: Kevin12345Mc folded before Flop (didn't bet)
Seat 7: Tess_4444 folded on the River
Seat 8: igor okumura folded before Flop (didn't bet)



PokerStars Hand #254864366448: Tournament #3856223586, $2.45+$2.45+$0.60 USD Hold'em No Limit - Level X (450/900) - 2025/02/14 18:54:34 WET [2025/02/14 13:54:34 ET]
Table '3856223586 32' 8-max Seat #3 is the button
Seat 1: posetuta (27848 in chips, $3.67 bounty) 
Seat 2: HaWooli (56179 in chips, $2.45 bounty) 
Seat 3: boidoidu (59685 in chips, $3.67 bounty) 
Seat 4: DerKingKalle (25750 in chips, $2.45 bounty) 
Seat 5: KECAKUATL (63744 in chips, $4.28 bounty) 
Seat 6: Kevin12345Mc (33970 in chips, $2.45 bounty) 
Seat 7: Tess_4444 (40015 in chips, $2.45 bounty) 
Seat 8: igor okumura (33825 in chips, $2.45 bounty) 
posetuta: posts the ante 125
HaWooli: posts the ante 125
boidoidu: posts the ante 125
DerKingKalle: posts the ante 125
KECAKUATL: posts the ante 125
Kevin12345Mc: posts the ante 125
Tess_4444: posts the ante 125
igor okumura: posts the ante 125
DerKingKalle: posts small blind 450
KECAKUATL: posts big blind 900
*** HOLE CARDS ***
Dealt to Kevin12345Mc [3h 2h]
Kevin12345Mc: folds 
Tess_4444: folds 
igor okumura: folds 
posetuta: folds 
HaWooli: folds 
boidoidu: folds 
DerKingKalle: raises 1350 to 2250
KECAKUATL: folds 
Uncalled bet (1350) returned to DerKingKalle
DerKingKalle collected 2800 from pot
DerKingKalle: doesn't show hand 
*** SUMMARY ***
Total pot 2800 | Rake 0 
Seat 1: posetuta folded before Flop (didn't bet)
Seat 2: HaWooli folded before Flop (didn't bet)
Seat 3: boidoidu (button) folded before Flop (didn't bet)
Seat 4: DerKingKalle (small blind) collected (2800)
Seat 5: KECAKUATL (big blind) folded before Flop
Seat 6: Kevin12345Mc folded before Flop (didn't bet)
Seat 7: Tess_4444 folded before Flop (didn't bet)
Seat 8: igor okumura folded before Flop (didn't bet)



PokerStars Hand #254864373893: Tournament #3856223586, $2.45+$2.45+$0.60 USD Hold'em No Limit - Level X (450/900) - 2025/02/14 18:55:03 WET [2025/02/14 13:55:03 ET]
Table '3856223586 32' 8-max Seat #4 is the button
Seat 1: posetuta (27723 in chips, $3.67 bounty) 
Seat 2: HaWooli (56054 in chips, $2.45 bounty) 
Seat 3: boidoidu (59560 in chips, $3.67 bounty) 
Seat 4: DerKingKalle (27525 in chips, $2.45 bounty) 
Seat 5: KECAKUATL (62719 in chips, $4.28 bounty) 
Seat 6: Kevin12345Mc (33845 in chips, $2.45 bounty) 
Seat 7: Tess_4444 (39890 in chips, $2.45 bounty) 
Seat 8: igor okumura (33700 in chips, $2.45 bounty) 
posetuta: posts the ante 125
HaWooli: posts the ante 125
boidoidu: posts the ante 125
DerKingKalle: posts the ante 125
KECAKUATL: posts the ante 125
Kevin12345Mc: posts the ante 125
Tess_4444: posts the ante 125
igor okumura: posts the ante 125
KECAKUATL: posts small blind 450
Kevin12345Mc: posts big blind 900
*** HOLE CARDS ***
Dealt to Kevin12345Mc [Ts 6d]
Tess_4444: folds 
igor okumura: raises 900 to 1800
posetuta: folds 
HaWooli: folds 
boidoidu: folds 
DerKingKalle: raises 3600 to 5400
KECAKUATL: folds 
Kevin12345Mc: folds 
igor okumura: folds 
Uncalled bet (3600) returned to DerKingKalle
DerKingKalle collected 5950 from pot
DerKingKalle: doesn't show hand 
*** SUMMARY ***
Total pot 5950 | Rake 0 
Seat 1: posetuta folded before Flop (didn't bet)
Seat 2: HaWooli folded before Flop (didn't bet)
Seat 3: boidoidu folded before Flop (didn't bet)
Seat 4: DerKingKalle (button) collected (5950)
Seat 5: KECAKUATL (small blind) folded before Flop
Seat 6: Kevin12345Mc (big blind) folded before Flop
Seat 7: Tess_4444 folded before Flop (didn't bet)
Seat 8: igor okumura folded before Flop



PokerStars Hand #254864459586: Tournament #3856223586, $2.45+$2.45+$0.60 USD Hold'em No Limit - Level X (450/900) - 2025/02/14 19:02:11 WET [2025/02/14 14:02:11 ET]
Table '3856223586 32' 8-max Seat #5 is the button
Seat 1: posetuta (27598 in chips, $3.67 bounty) 
Seat 2: HaWooli (55929 in chips, $2.45 bounty) 
Seat 3: boidoidu (59435 in chips, $3.67 bounty) 
Seat 4: DerKingKalle (31550 in chips, $2.45 bounty) is sitting out
Seat 5: KECAKUATL (62144 in chips, $4.28 bounty) 
Seat 6: Kevin12345Mc (32820 in chips, $2.45 bounty) 
Seat 7: Tess_4444 (39765 in chips, $2.45 bounty) 
Seat 8: igor okumura (31775 in chips, $2.45 bounty) 
posetuta: posts the ante 125
HaWooli: posts the ante 125
boidoidu: posts the ante 125
DerKingKalle: posts the ante 125
KECAKUATL: posts the ante 125
Kevin12345Mc: posts the ante 125
Tess_4444: posts the ante 125
igor okumura: posts the ante 125
Kevin12345Mc: posts small blind 450
Tess_4444: posts big blind 900
*** HOLE CARDS ***
Dealt to Kevin12345Mc [Ts 9s]
igor okumura: folds 
posetuta: raises 1350 to 2250
HaWooli: calls 2250
boidoidu: calls 2250
DerKingKalle: folds 
KECAKUATL: folds 
Kevin12345Mc: calls 1800
Tess_4444: folds 
*** FLOP *** [8d 4h Kh]
Kevin12345Mc: checks 
posetuta: bets 3597
HaWooli: folds 
boidoidu: raises 9047 to 12644
DerKingKalle is disconnected 
DerKingKalle has returned
Kevin12345Mc: folds 
posetuta: calls 9047
*** TURN *** [8d 4h Kh] [3c]
posetuta: bets 12579 and is all-in
boidoidu: calls 12579
*** RIVER *** [8d 4h Kh 3c] [9d]
*** SHOW DOWN ***
posetuta: shows [Ah Kc] (a pair of Kings)
boidoidu: shows [Qc Kd] (a pair of Kings - lower kicker)
posetuta collected 61346 from pot
*** SUMMARY ***
Total pot 61346 | Rake 0 
Board [8d 4h Kh 3c 9d]
Seat 1: posetuta showed [Ah Kc] and won (61346) with a pair of Kings
Seat 2: HaWooli folded on the Flop
Seat 3: boidoidu showed [Qc Kd] and lost with a pair of Kings
Seat 4: DerKingKalle folded before Flop (didn't bet)
Seat 5: KECAKUATL (button) folded before Flop (didn't bet)
Seat 6: Kevin12345Mc (small blind) folded on the Flop
Seat 7: Tess_4444 (big blind) folded before Flop
Seat 8: igor okumura folded before Flop (didn't bet)



PokerStars Hand #254864487302: Tournament #3856223586, $2.45+$2.45+$0.60 USD Hold'em No Limit - Level X (450/900) - 2025/02/14 19:03:59 WET [2025/02/14 14:03:59 ET]
Table '3856223586 32' 8-max Seat #6 is the button
Seat 1: posetuta (61346 in chips, $3.67 bounty) 
Seat 2: HaWooli (53554 in chips, $2.45 bounty) 
Seat 3: boidoidu (31837 in chips, $3.67 bounty) 
Seat 4: DerKingKalle (31425 in chips, $2.45 bounty) 
Seat 5: KECAKUATL (62019 in chips, $4.28 bounty) 
Seat 6: Kevin12345Mc (30445 in chips, $2.45 bounty) 
Seat 7: Tess_4444 (38740 in chips, $2.45 bounty) 
Seat 8: igor okumura (31650 in chips, $2.45 bounty) 
posetuta: posts the ante 125
HaWooli: posts the ante 125
boidoidu: posts the ante 125
DerKingKalle: posts the ante 125
KECAKUATL: posts the ante 125
Kevin12345Mc: posts the ante 125
Tess_4444: posts the ante 125
igor okumura: posts the ante 125
Tess_4444: posts small blind 450
igor okumura: posts big blind 900
*** HOLE CARDS ***
Dealt to Kevin12345Mc [6h Tc]
posetuta: folds 
HaWooli: folds 
boidoidu: raises 900 to 1800
DerKingKalle: folds 
KECAKUATL: folds 
Kevin12345Mc: folds 
Tess_4444: folds 
igor okumura: calls 900
*** FLOP *** [2c 8h Ad]
igor okumura: checks 
boidoidu: bets 2525
igor okumura: folds 
Uncalled bet (2525) returned to boidoidu
boidoidu collected 5050 from pot
boidoidu: doesn't show hand 
*** SUMMARY ***
Total pot 5050 | Rake 0 
Board [2c 8h Ad]
Seat 1: posetuta folded before Flop (didn't bet)
Seat 2: HaWooli folded before Flop (didn't bet)
Seat 3: boidoidu collected (5050)
Seat 4: DerKingKalle folded before Flop (didn't bet)
Seat 5: KECAKUATL folded before Flop (didn't bet)
Seat 6: Kevin12345Mc (button) folded before Flop (didn't bet)
Seat 7: Tess_4444 (small blind) folded before Flop
Seat 8: igor okumura (big blind) folded on the Flop



PokerStars Hand #254864503310: Tournament #3856223586, $2.45+$2.45+$0.60 USD Hold'em No Limit - Level XI (500/1000) - 2025/02/14 19:05:00 WET [2025/02/14 14:05:00 ET]
Table '3856223586 32' 8-max Seat #7 is the button
Seat 1: posetuta (61221 in chips, $3.67 bounty) 
Seat 2: HaWooli (53429 in chips, $2.45 bounty) 
Seat 3: boidoidu (34962 in chips, $3.67 bounty) 
Seat 4: DerKingKalle (31300 in chips, $2.45 bounty) 
Seat 5: KECAKUATL (61894 in chips, $4.28 bounty) 
Seat 6: Kevin12345Mc (30320 in chips, $2.45 bounty) 
Seat 7: Tess_4444 (38165 in chips, $2.45 bounty) 
Seat 8: igor okumura (29725 in chips, $2.45 bounty) 
posetuta: posts the ante 150
HaWooli: posts the ante 150
boidoidu: posts the ante 150
DerKingKalle: posts the ante 150
KECAKUATL: posts the ante 150
Kevin12345Mc: posts the ante 150
Tess_4444: posts the ante 150
igor okumura: posts the ante 150
igor okumura: posts small blind 500
posetuta: posts big blind 1000
*** HOLE CARDS ***
Dealt to Kevin12345Mc [Qc Tc]
HaWooli: raises 1120 to 2120
boidoidu: folds 
DerKingKalle: folds 
KECAKUATL: folds 
Kevin12345Mc: calls 2120
Tess_4444: folds 
igor okumura: folds 
posetuta: folds 
*** FLOP *** [3c 6c 5d]
HaWooli: checks 
Kevin12345Mc: bets 2290
HaWooli: folds 
Uncalled bet (2290) returned to Kevin12345Mc
Kevin12345Mc collected 6940 from pot
Kevin12345Mc: doesn't show hand 
*** SUMMARY ***
Total pot 6940 | Rake 0 
Board [3c 6c 5d]
Seat 1: posetuta (big blind) folded before Flop
Seat 2: HaWooli folded on the Flop
Seat 3: boidoidu folded before Flop (didn't bet)
Seat 4: DerKingKalle folded before Flop (didn't bet)
Seat 5: KECAKUATL folded before Flop (didn't bet)
Seat 6: Kevin12345Mc collected (6940)
Seat 7: Tess_4444 (button) folded before Flop (didn't bet)
Seat 8: igor okumura (small blind) folded before Flop



PokerStars Hand #254864513890: Tournament #3856223586, $2.45+$2.45+$0.60 USD Hold'em No Limit - Level XI (500/1000) - 2025/02/14 19:05:41 WET [2025/02/14 14:05:41 ET]
Table '3856223586 32' 8-max Seat #8 is the button
Seat 1: posetuta (60071 in chips, $3.67 bounty) 
Seat 2: HaWooli (51159 in chips, $2.45 bounty) 
Seat 3: boidoidu (34812 in chips, $3.67 bounty) 
Seat 4: DerKingKalle (31150 in chips, $2.45 bounty) 
Seat 5: KECAKUATL (61744 in chips, $4.28 bounty) 
Seat 6: Kevin12345Mc (34990 in chips, $2.45 bounty) 
Seat 7: Tess_4444 (38015 in chips, $2.45 bounty) 
Seat 8: igor okumura (29075 in chips, $2.45 bounty) 
posetuta: posts the ante 150
HaWooli: posts the ante 150
boidoidu: posts the ante 150
DerKingKalle: posts the ante 150
KECAKUATL: posts the ante 150
Kevin12345Mc: posts the ante 150
Tess_4444: posts the ante 150
igor okumura: posts the ante 150
posetuta: posts small blind 500
HaWooli: posts big blind 1000
*** HOLE CARDS ***
Dealt to Kevin12345Mc [8d Ad]
boidoidu: folds 
DerKingKalle: folds 
KECAKUATL: raises 1000 to 2000
Kevin12345Mc: calls 2000
Tess_4444: folds 
igor okumura: folds 
posetuta: folds 
HaWooli: folds 
*** FLOP *** [5h 6s 2h]
KECAKUATL: checks 
Kevin12345Mc: checks 
*** TURN *** [5h 6s 2h] [5d]
KECAKUATL: checks 
Kevin12345Mc: checks 
*** RIVER *** [5h 6s 2h 5d] [Qs]
KECAKUATL: bets 3350
Kevin12345Mc: folds 
Uncalled bet (3350) returned to KECAKUATL
KECAKUATL collected 6700 from pot
KECAKUATL: doesn't show hand 
*** SUMMARY ***
Total pot 6700 | Rake 0 
Board [5h 6s 2h 5d Qs]
Seat 1: posetuta (small blind) folded before Flop
Seat 2: HaWooli (big blind) folded before Flop
Seat 3: boidoidu folded before Flop (didn't bet)
Seat 4: DerKingKalle folded before Flop (didn't bet)
Seat 5: KECAKUATL collected (6700)
Seat 6: Kevin12345Mc folded on the River
Seat 7: Tess_4444 folded before Flop (didn't bet)
Seat 8: igor okumura (button) folded before Flop (didn't bet)



PokerStars Hand #254864524349: Tournament #3856223586, $2.45+$2.45+$0.60 USD Hold'em No Limit - Level XI (500/1000) - 2025/02/14 19:06:22 WET [2025/02/14 14:06:22 ET]
Table '3856223586 32' 8-max Seat #1 is the button
Seat 1: posetuta (59421 in chips, $3.67 bounty) 
Seat 2: HaWooli (50009 in chips, $2.45 bounty) 
Seat 3: boidoidu (34662 in chips, $3.67 bounty) 
Seat 4: DerKingKalle (31000 in chips, $2.45 bounty) 
Seat 5: KECAKUATL (66294 in chips, $4.28 bounty) 
Seat 6: Kevin12345Mc (32840 in chips, $2.45 bounty) 
Seat 7: Tess_4444 (37865 in chips, $2.45 bounty) 
Seat 8: igor okumura (28925 in chips, $2.45 bounty) 
posetuta: posts the ante 150
HaWooli: posts the ante 150
boidoidu: posts the ante 150
DerKingKalle: posts the ante 150
KECAKUATL: posts the ante 150
Kevin12345Mc: posts the ante 150
Tess_4444: posts the ante 150
igor okumura: posts the ante 150
HaWooli: posts small blind 500
boidoidu: posts big blind 1000
*** HOLE CARDS ***
Dealt to Kevin12345Mc [Td 9h]
DerKingKalle: folds 
KECAKUATL: folds 
Kevin12345Mc: folds 
Tess_4444: folds 
igor okumura: folds 
posetuta: raises 1500 to 2500
HaWooli: folds 
boidoidu: folds 
Uncalled bet (1500) returned to posetuta
posetuta collected 3700 from pot
posetuta: doesn't show hand 
*** SUMMARY ***
Total pot 3700 | Rake 0 
Seat 1: posetuta (button) collected (3700)
Seat 2: HaWooli (small blind) folded before Flop
Seat 3: boidoidu (big blind) folded before Flop
Seat 4: DerKingKalle folded before Flop (didn't bet)
Seat 5: KECAKUATL folded before Flop (didn't bet)
Seat 6: Kevin12345Mc folded before Flop (didn't bet)
Seat 7: Tess_4444 folded before Flop (didn't bet)
Seat 8: igor okumura folded before Flop (didn't bet)



PokerStars Hand #254864534097: Tournament #3856223586, $2.45+$2.45+$0.60 USD Hold'em No Limit - Level XI (500/1000) - 2025/02/14 19:06:59 WET [2025/02/14 14:06:59 ET]
Table '3856223586 32' 8-max Seat #2 is the button
Seat 1: posetuta (61971 in chips, $3.67 bounty) 
Seat 2: HaWooli (49359 in chips, $2.45 bounty) 
Seat 3: boidoidu (33512 in chips, $3.67 bounty) 
Seat 4: DerKingKalle (30850 in chips, $2.45 bounty) 
Seat 5: KECAKUATL (66144 in chips, $4.28 bounty) 
Seat 6: Kevin12345Mc (32690 in chips, $2.45 bounty) 
Seat 7: Tess_4444 (37715 in chips, $2.45 bounty) 
Seat 8: igor okumura (28775 in chips, $2.45 bounty) 
posetuta: posts the ante 150
HaWooli: posts the ante 150
boidoidu: posts the ante 150
DerKingKalle: posts the ante 150
KECAKUATL: posts the ante 150
Kevin12345Mc: posts the ante 150
Tess_4444: posts the ante 150
igor okumura: posts the ante 150
boidoidu: posts small blind 500
DerKingKalle: posts big blind 1000
*** HOLE CARDS ***
Dealt to Kevin12345Mc [5h Ks]
KECAKUATL: folds 
Kevin12345Mc: folds 
Tess_4444: raises 1000 to 2000
igor okumura: folds 
posetuta: folds 
HaWooli: folds 
boidoidu: folds 
DerKingKalle: calls 1000
*** FLOP *** [As 6h 3h]
DerKingKalle: checks 
Tess_4444: bets 2850
DerKingKalle: calls 2850
*** TURN *** [As 6h 3h] [6c]
DerKingKalle: checks 
Tess_4444: checks 
*** RIVER *** [As 6h 3h 6c] [Qd]
DerKingKalle: bets 12000
Tess_4444: folds 
Uncalled bet (12000) returned to DerKingKalle
DerKingKalle collected 11400 from pot
DerKingKalle: doesn't show hand 
*** SUMMARY ***
Total pot 11400 | Rake 0 
Board [As 6h 3h 6c Qd]
Seat 1: posetuta folded before Flop (didn't bet)
Seat 2: HaWooli (button) folded before Flop (didn't bet)
Seat 3: boidoidu (small blind) folded before Flop
Seat 4: DerKingKalle (big blind) collected (11400)
Seat 5: KECAKUATL folded before Flop (didn't bet)
Seat 6: Kevin12345Mc folded before Flop (didn't bet)
Seat 7: Tess_4444 folded on the River
Seat 8: igor okumura folded before Flop (didn't bet)



PokerStars Hand #254864557279: Tournament #3856223586, $2.45+$2.45+$0.60 USD Hold'em No Limit - Level XI (500/1000) - 2025/02/14 19:08:30 WET [2025/02/14 14:08:30 ET]
Table '3856223586 32' 8-max Seat #3 is the button
Seat 1: posetuta (61821 in chips, $3.67 bounty) 
Seat 2: HaWooli (49209 in chips, $2.45 bounty) 
Seat 3: boidoidu (32862 in chips, $3.67 bounty) 
Seat 4: DerKingKalle (37250 in chips, $2.45 bounty) 
Seat 5: KECAKUATL (65994 in chips, $4.28 bounty) 
Seat 6: Kevin12345Mc (32540 in chips, $2.45 bounty) 
Seat 7: Tess_4444 (32715 in chips, $2.45 bounty) 
Seat 8: igor okumura (28625 in chips, $2.45 bounty) 
posetuta: posts the ante 150
HaWooli: posts the ante 150
boidoidu: posts the ante 150
DerKingKalle: posts the ante 150
KECAKUATL: posts the ante 150
Kevin12345Mc: posts the ante 150
Tess_4444: posts the ante 150
igor okumura: posts the ante 150
DerKingKalle: posts small blind 500
KECAKUATL: posts big blind 1000
*** HOLE CARDS ***
Dealt to Kevin12345Mc [4h Ts]
Kevin12345Mc: folds 
Tess_4444: folds 
igor okumura: folds 
posetuta: folds 
HaWooli: folds 
boidoidu: raises 1000 to 2000
DerKingKalle: folds 
KECAKUATL: folds 
Uncalled bet (1000) returned to boidoidu
boidoidu collected 3700 from pot
boidoidu: doesn't show hand 
*** SUMMARY ***
Total pot 3700 | Rake 0 
Seat 1: posetuta folded before Flop (didn't bet)
Seat 2: HaWooli folded before Flop (didn't bet)
Seat 3: boidoidu (button) collected (3700)
Seat 4: DerKingKalle (small blind) folded before Flop
Seat 5: KECAKUATL (big blind) folded before Flop
Seat 6: Kevin12345Mc folded before Flop (didn't bet)
Seat 7: Tess_4444 folded before Flop (didn't bet)
Seat 8: igor okumura folded before Flop (didn't bet)



PokerStars Hand #254864567122: Tournament #3856223586, $2.45+$2.45+$0.60 USD Hold'em No Limit - Level XI (500/1000) - 2025/02/14 19:09:08 WET [2025/02/14 14:09:08 ET]
Table '3856223586 32' 8-max Seat #4 is the button
Seat 1: posetuta (61671 in chips, $3.67 bounty) 
Seat 2: HaWooli (49059 in chips, $2.45 bounty) 
Seat 3: boidoidu (35412 in chips, $3.67 bounty) 
Seat 4: DerKingKalle (36600 in chips, $2.45 bounty) 
Seat 5: KECAKUATL (64844 in chips, $4.28 bounty) 
Seat 6: Kevin12345Mc (32390 in chips, $2.45 bounty) 
Seat 7: Tess_4444 (32565 in chips, $2.45 bounty) 
Seat 8: igor okumura (28475 in chips, $2.45 bounty) 
posetuta: posts the ante 150
HaWooli: posts the ante 150
boidoidu: posts the ante 150
DerKingKalle: posts the ante 150
KECAKUATL: posts the ante 150
Kevin12345Mc: posts the ante 150
Tess_4444: posts the ante 150
igor okumura: posts the ante 150
KECAKUATL: posts small blind 500
Kevin12345Mc: posts big blind 1000
*** HOLE CARDS ***
Dealt to Kevin12345Mc [Jd Td]
Tess_4444: raises 2000 to 3000
igor okumura: folds 
posetuta: folds 
HaWooli: folds 
boidoidu: folds 
DerKingKalle: folds 
KECAKUATL: folds 
Kevin12345Mc: calls 2000
*** FLOP *** [Ac Ks Qh]
Kevin12345Mc: checks 
Tess_4444: bets 3850
Kevin12345Mc: calls 3850
*** TURN *** [Ac Ks Qh] [5d]
Kevin12345Mc: checks 
Tess_4444: bets 7700
Kevin12345Mc: raises 17690 to 25390 and is all-in
Tess_4444: calls 17690
*** RIVER *** [Ac Ks Qh 5d] [4c]
*** SHOW DOWN ***
Kevin12345Mc: shows [Jd Td] (a straight, Ten to Ace)
Tess_4444: shows [As Tc] (a pair of Aces)
Kevin12345Mc collected 66180 from pot
*** SUMMARY ***
Total pot 66180 | Rake 0 
Board [Ac Ks Qh 5d 4c]
Seat 1: posetuta folded before Flop (didn't bet)
Seat 2: HaWooli folded before Flop (didn't bet)
Seat 3: boidoidu folded before Flop (didn't bet)
Seat 4: DerKingKalle (button) folded before Flop (didn't bet)
Seat 5: KECAKUATL (small blind) folded before Flop
Seat 6: Kevin12345Mc (big blind) showed [Jd Td] and won (66180) with a straight, Ten to Ace
Seat 7: Tess_4444 showed [As Tc] and lost with a pair of Aces
Seat 8: igor okumura folded before Flop (didn't bet)



PokerStars Hand #254864578052: Tournament #3856223586, $2.45+$2.45+$0.60 USD Hold'em No Limit - Level XI (500/1000) - 2025/02/14 19:09:51 WET [2025/02/14 14:09:51 ET]
Table '3856223586 32' 8-max Seat #5 is the button
Seat 1: posetuta (61521 in chips, $3.67 bounty) 
Seat 2: HaWooli (48909 in chips, $2.45 bounty) 
Seat 3: boidoidu (35262 in chips, $3.67 bounty) 
Seat 4: DerKingKalle (36450 in chips, $2.45 bounty) 
Seat 5: KECAKUATL (64194 in chips, $4.28 bounty) 
Seat 6: Kevin12345Mc (66180 in chips, $2.45 bounty) 
Seat 7: Tess_4444 (175 in chips, $2.45 bounty) 
Seat 8: igor okumura (28325 in chips, $2.45 bounty) 
posetuta: posts the ante 150
HaWooli: posts the ante 150
boidoidu: posts the ante 150
DerKingKalle: posts the ante 150
KECAKUATL: posts the ante 150
Kevin12345Mc: posts the ante 150
Tess_4444: posts the ante 150
igor okumura: posts the ante 150
Kevin12345Mc: posts small blind 500
Tess_4444: posts big blind 25 and is all-in
*** HOLE CARDS ***
Dealt to Kevin12345Mc [Kh 7s]
igor okumura: folds 
posetuta: folds 
HaWooli: folds 
boidoidu: folds 
DerKingKalle: folds 
KECAKUATL: folds 
Uncalled bet (475) returned to Kevin12345Mc
*** FLOP *** [7c Ts 4h]
*** TURN *** [7c Ts 4h] [Ac]
*** RIVER *** [7c Ts 4h Ac] [Qd]
*** SHOW DOWN ***
Kevin12345Mc: shows [Kh 7s] (a pair of Sevens)
Tess_4444: shows [3d Qc] (a pair of Queens)
Tess_4444 collected 1250 from pot
*** SUMMARY ***
Total pot 1250 | Rake 0 
Board [7c Ts 4h Ac Qd]
Seat 1: posetuta folded before Flop (didn't bet)
Seat 2: HaWooli folded before Flop (didn't bet)
Seat 3: boidoidu folded before Flop (didn't bet)
Seat 4: DerKingKalle folded before Flop (didn't bet)
Seat 5: KECAKUATL (button) folded before Flop (didn't bet)
Seat 6: Kevin12345Mc (small blind) showed [Kh 7s] and lost with a pair of Sevens
Seat 7: Tess_4444 (big blind) showed [3d Qc] and won (1250) with a pair of Queens
Seat 8: igor okumura folded before Flop (didn't bet)



PokerStars Hand #254864584298: Tournament #3856223586, $2.45+$2.45+$0.60 USD Hold'em No Limit - Level XI (500/1000) - 2025/02/14 19:10:14 WET [2025/02/14 14:10:14 ET]
Table '3856223586 32' 8-max Seat #6 is the button
Seat 1: posetuta (61371 in chips, $3.67 bounty) 
Seat 2: HaWooli (48759 in chips, $2.45 bounty) 
Seat 3: boidoidu (35112 in chips, $3.67 bounty) 
Seat 4: DerKingKalle (36300 in chips, $2.45 bounty) 
Seat 5: KECAKUATL (64044 in chips, $4.28 bounty) 
Seat 6: Kevin12345Mc (66005 in chips, $2.45 bounty) 
Seat 7: Tess_4444 (1250 in chips, $2.45 bounty) 
Seat 8: igor okumura (28175 in chips, $2.45 bounty) 
posetuta: posts the ante 150
HaWooli: posts the ante 150
boidoidu: posts the ante 150
DerKingKalle: posts the ante 150
KECAKUATL: posts the ante 150
Kevin12345Mc: posts the ante 150
Tess_4444: posts the ante 150
igor okumura: posts the ante 150
Tess_4444: posts small blind 500
igor okumura: posts big blind 1000
*** HOLE CARDS ***
Dealt to Kevin12345Mc [Ts Jc]
posetuta: folds 
HaWooli: raises 1120 to 2120
boidoidu: folds 
DerKingKalle: folds 
KECAKUATL: folds 
Kevin12345Mc: calls 2120
Tess_4444: calls 600 and is all-in
igor okumura has timed out
igor okumura: folds 
igor okumura is sitting out
*** FLOP *** [Qd 4c 5s]
igor okumura has returned
HaWooli: bets 2790
Kevin12345Mc: folds 
Uncalled bet (2790) returned to HaWooli
*** TURN *** [Qd 4c 5s] [3d]
*** RIVER *** [Qd 4c 5s 3d] [Qs]
*** SHOW DOWN ***
HaWooli: shows [Kd Tc] (a pair of Queens)
HaWooli collected 2040 from side pot
Tess_4444: shows [Js Ac] (a pair of Queens - Ace kicker)
Tess_4444 collected 5500 from main pot
*** SUMMARY ***
Total pot 7540 Main pot 5500. Side pot 2040. | Rake 0 
Board [Qd 4c 5s 3d Qs]
Seat 1: posetuta folded before Flop (didn't bet)
Seat 2: HaWooli showed [Kd Tc] and won (2040) with a pair of Queens
Seat 3: boidoidu folded before Flop (didn't bet)
Seat 4: DerKingKalle folded before Flop (didn't bet)
Seat 5: KECAKUATL folded before Flop (didn't bet)
Seat 6: Kevin12345Mc (button) folded on the Flop
Seat 7: Tess_4444 (small blind) showed [Js Ac] and won (5500) with a pair of Queens
Seat 8: igor okumura (big blind) folded before Flop



PokerStars Hand #254864604092: Tournament #3856223586, $2.45+$2.45+$0.60 USD Hold'em No Limit - Level XI (500/1000) - 2025/02/14 19:11:30 WET [2025/02/14 14:11:30 ET]
Table '3856223586 32' 8-max Seat #7 is the button
Seat 1: posetuta (61221 in chips, $3.67 bounty) 
Seat 2: HaWooli (48529 in chips, $2.45 bounty) 
Seat 3: boidoidu (34962 in chips, $3.67 bounty) 
Seat 4: DerKingKalle (36150 in chips, $2.45 bounty) 
Seat 5: KECAKUATL (63894 in chips, $4.28 bounty) 
Seat 6: Kevin12345Mc (63735 in chips, $2.45 bounty) 
Seat 7: Tess_4444 (5500 in chips, $2.45 bounty) 
Seat 8: igor okumura (27025 in chips, $2.45 bounty) 
posetuta: posts the ante 150
HaWooli: posts the ante 150
boidoidu: posts the ante 150
DerKingKalle: posts the ante 150
KECAKUATL: posts the ante 150
Kevin12345Mc: posts the ante 150
Tess_4444: posts the ante 150
igor okumura: posts the ante 150
igor okumura: posts small blind 500
posetuta: posts big blind 1000
*** HOLE CARDS ***
Dealt to Kevin12345Mc [4d Th]
HaWooli: folds 
boidoidu: folds 
DerKingKalle: raises 1200 to 2200
KECAKUATL: folds 
Kevin12345Mc: folds 
Tess_4444: raises 3150 to 5350 and is all-in
igor okumura has timed out
igor okumura: folds 
igor okumura is sitting out
igor okumura has returned
posetuta: calls 4350
DerKingKalle: raises 30650 to 36000 and is all-in
posetuta: folds 
Uncalled bet (30650) returned to DerKingKalle
*** FLOP *** [9c Td 6c]
*** TURN *** [9c Td 6c] [As]
*** RIVER *** [9c Td 6c As] [7s]
*** SHOW DOWN ***
DerKingKalle: shows [3c 3s] (a pair of Threes)
Tess_4444: shows [Jd 8d] (a straight, Seven to Jack)
Tess_4444 collected 17750 from pot
*** SUMMARY ***
Total pot 17750 | Rake 0 
Board [9c Td 6c As 7s]
Seat 1: posetuta (big blind) folded before Flop
Seat 2: HaWooli folded before Flop (didn't bet)
Seat 3: boidoidu folded before Flop (didn't bet)
Seat 4: DerKingKalle showed [3c 3s] and lost with a pair of Threes
Seat 5: KECAKUATL folded before Flop (didn't bet)
Seat 6: Kevin12345Mc folded before Flop (didn't bet)
Seat 7: Tess_4444 (button) showed [Jd 8d] and won (17750) with a straight, Seven to Jack
Seat 8: igor okumura (small blind) folded before Flop



PokerStars Hand #254864623693: Tournament #3856223586, $2.45+$2.45+$0.60 USD Hold'em No Limit - Level XII (600/1200) - 2025/02/14 19:12:44 WET [2025/02/14 14:12:44 ET]
Table '3856223586 32' 8-max Seat #8 is the button
Seat 1: posetuta (55721 in chips, $3.67 bounty) 
Seat 2: HaWooli (48379 in chips, $2.45 bounty) 
Seat 3: boidoidu (34812 in chips, $3.67 bounty) 
Seat 4: DerKingKalle (30650 in chips, $2.45 bounty) 
Seat 5: KECAKUATL (63744 in chips, $4.28 bounty) 
Seat 6: Kevin12345Mc (63585 in chips, $2.45 bounty) 
Seat 7: Tess_4444 (17750 in chips, $2.45 bounty) 
Seat 8: igor okumura (26375 in chips, $2.45 bounty) 
posetuta: posts the ante 175
HaWooli: posts the ante 175
boidoidu: posts the ante 175
DerKingKalle: posts the ante 175
KECAKUATL: posts the ante 175
Kevin12345Mc: posts the ante 175
Tess_4444: posts the ante 175
igor okumura: posts the ante 175
posetuta: posts small blind 600
HaWooli: posts big blind 1200
*** HOLE CARDS ***
Dealt to Kevin12345Mc [9s Jc]
boidoidu: folds 
DerKingKalle: folds 
KECAKUATL: folds 
Kevin12345Mc: folds 
Tess_4444: folds 
igor okumura: raises 1200 to 2400
posetuta: folds 
HaWooli: folds 
Uncalled bet (1200) returned to igor okumura
igor okumura collected 4400 from pot
igor okumura: doesn't show hand 
*** SUMMARY ***
Total pot 4400 | Rake 0 
Seat 1: posetuta (small blind) folded before Flop
Seat 2: HaWooli (big blind) folded before Flop
Seat 3: boidoidu folded before Flop (didn't bet)
Seat 4: DerKingKalle folded before Flop (didn't bet)
Seat 5: KECAKUATL folded before Flop (didn't bet)
Seat 6: Kevin12345Mc folded before Flop (didn't bet)
Seat 7: Tess_4444 folded before Flop (didn't bet)
Seat 8: igor okumura (button) collected (4400)



PokerStars Hand #254864628974: Tournament #3856223586, $2.45+$2.45+$0.60 USD Hold'em No Limit - Level XII (600/1200) - 2025/02/14 19:13:04 WET [2025/02/14 14:13:04 ET]
Table '3856223586 32' 8-max Seat #1 is the button
Seat 1: posetuta (54946 in chips, $3.67 bounty) 
Seat 2: HaWooli (47004 in chips, $2.45 bounty) 
Seat 3: boidoidu (34637 in chips, $3.67 bounty) 
Seat 4: DerKingKalle (30475 in chips, $2.45 bounty) 
Seat 5: KECAKUATL (63569 in chips, $4.28 bounty) 
Seat 6: Kevin12345Mc (63410 in chips, $2.45 bounty) 
Seat 7: Tess_4444 (17575 in chips, $2.45 bounty) 
Seat 8: igor okumura (29400 in chips, $2.45 bounty) 
posetuta: posts the ante 175
HaWooli: posts the ante 175
boidoidu: posts the ante 175
DerKingKalle: posts the ante 175
KECAKUATL: posts the ante 175
Kevin12345Mc: posts the ante 175
Tess_4444: posts the ante 175
igor okumura: posts the ante 175
HaWooli: posts small blind 600
boidoidu: posts big blind 1200
*** HOLE CARDS ***
Dealt to Kevin12345Mc [Qd 9c]
DerKingKalle: folds 
KECAKUATL: folds 
Kevin12345Mc: folds 
Tess_4444: folds 
igor okumura: folds 
posetuta: raises 1800 to 3000
HaWooli: raises 8600 to 11600
boidoidu: folds 
posetuta: folds 
Uncalled bet (8600) returned to HaWooli
HaWooli collected 8600 from pot
HaWooli: doesn't show hand 
*** SUMMARY ***
Total pot 8600 | Rake 0 
Seat 1: posetuta (button) folded before Flop
Seat 2: HaWooli (small blind) collected (8600)
Seat 3: boidoidu (big blind) folded before Flop
Seat 4: DerKingKalle folded before Flop (didn't bet)
Seat 5: KECAKUATL folded before Flop (didn't bet)
Seat 6: Kevin12345Mc folded before Flop (didn't bet)
Seat 7: Tess_4444 folded before Flop (didn't bet)
Seat 8: igor okumura folded before Flop (didn't bet)



PokerStars Hand #254864641417: Tournament #3856223586, $2.45+$2.45+$0.60 USD Hold'em No Limit - Level XII (600/1200) - 2025/02/14 19:13:51 WET [2025/02/14 14:13:51 ET]
Table '3856223586 32' 8-max Seat #2 is the button
Seat 1: posetuta (51771 in chips, $3.67 bounty) 
Seat 2: HaWooli (52429 in chips, $2.45 bounty) 
Seat 3: boidoidu (33262 in chips, $3.67 bounty) 
Seat 4: DerKingKalle (30300 in chips, $2.45 bounty) 
Seat 5: KECAKUATL (63394 in chips, $4.28 bounty) 
Seat 6: Kevin12345Mc (63235 in chips, $2.45 bounty) 
Seat 7: Tess_4444 (17400 in chips, $2.45 bounty) 
Seat 8: igor okumura (29225 in chips, $2.45 bounty) 
posetuta: posts the ante 175
HaWooli: posts the ante 175
boidoidu: posts the ante 175
DerKingKalle: posts the ante 175
KECAKUATL: posts the ante 175
Kevin12345Mc: posts the ante 175
Tess_4444: posts the ante 175
igor okumura: posts the ante 175
boidoidu: posts small blind 600
DerKingKalle: posts big blind 1200
*** HOLE CARDS ***
Dealt to Kevin12345Mc [9c Kh]
KECAKUATL: folds 
Kevin12345Mc: folds 
Tess_4444: folds 
igor okumura: raises 1200 to 2400
posetuta: folds 
HaWooli: calls 2400
boidoidu: folds 
DerKingKalle: folds 
*** FLOP *** [Ks 3h Kd]
igor okumura: checks 
HaWooli: checks 
*** TURN *** [Ks 3h Kd] [Kc]
igor okumura: checks 
HaWooli: checks 
*** RIVER *** [Ks 3h Kd Kc] [3s]
igor okumura: checks 
HaWooli: checks 
*** SHOW DOWN ***
igor okumura: shows [Ts Ad] (a full house, Kings full of Threes)
HaWooli: shows [9s Tc] (a full house, Kings full of Threes)
igor okumura collected 4000 from pot
HaWooli collected 4000 from pot
*** SUMMARY ***
Total pot 8000 | Rake 0 
Board [Ks 3h Kd Kc 3s]
Seat 1: posetuta folded before Flop (didn't bet)
Seat 2: HaWooli (button) showed [9s Tc] and won (4000) with a full house, Kings full of Threes
Seat 3: boidoidu (small blind) folded before Flop
Seat 4: DerKingKalle (big blind) folded before Flop
Seat 5: KECAKUATL folded before Flop (didn't bet)
Seat 6: Kevin12345Mc folded before Flop (didn't bet)
Seat 7: Tess_4444 folded before Flop (didn't bet)
Seat 8: igor okumura showed [Ts Ad] and won (4000) with a full house, Kings full of Threes



PokerStars Hand #254864653502: Tournament #3856223586, $2.45+$2.45+$0.60 USD Hold'em No Limit - Level XII (600/1200) - 2025/02/14 19:14:36 WET [2025/02/14 14:14:36 ET]
Table '3856223586 32' 8-max Seat #3 is the button
Seat 1: posetuta (51596 in chips, $3.67 bounty) 
Seat 2: HaWooli (53854 in chips, $2.45 bounty) 
Seat 3: boidoidu (32487 in chips, $3.67 bounty) 
Seat 4: DerKingKalle (28925 in chips, $2.45 bounty) 
Seat 5: KECAKUATL (63219 in chips, $4.28 bounty) 
Seat 6: Kevin12345Mc (63060 in chips, $2.45 bounty) 
Seat 7: Tess_4444 (17225 in chips, $2.45 bounty) 
Seat 8: igor okumura (30650 in chips, $2.45 bounty) 
posetuta: posts the ante 175
HaWooli: posts the ante 175
boidoidu: posts the ante 175
DerKingKalle: posts the ante 175
KECAKUATL: posts the ante 175
Kevin12345Mc: posts the ante 175
Tess_4444: posts the ante 175
igor okumura: posts the ante 175
DerKingKalle: posts small blind 600
KECAKUATL: posts big blind 1200
*** HOLE CARDS ***
Dealt to Kevin12345Mc [8c Tc]
Kevin12345Mc: folds 
Tess_4444: folds 
igor okumura: raises 1200 to 2400
posetuta: folds 
HaWooli: folds 
boidoidu: folds 
DerKingKalle: folds 
KECAKUATL: folds 
Uncalled bet (1200) returned to igor okumura
igor okumura collected 4400 from pot
igor okumura: doesn't show hand 
*** SUMMARY ***
Total pot 4400 | Rake 0 
Seat 1: posetuta folded before Flop (didn't bet)
Seat 2: HaWooli folded before Flop (didn't bet)
Seat 3: boidoidu (button) folded before Flop (didn't bet)
Seat 4: DerKingKalle (small blind) folded before Flop
Seat 5: KECAKUATL (big blind) folded before Flop
Seat 6: Kevin12345Mc folded before Flop (didn't bet)
Seat 7: Tess_4444 folded before Flop (didn't bet)
Seat 8: igor okumura collected (4400)



PokerStars Hand #254864662422: Tournament #3856223586, $2.45+$2.45+$0.60 USD Hold'em No Limit - Level XII (600/1200) - 2025/02/14 19:15:10 WET [2025/02/14 14:15:10 ET]
Table '3856223586 32' 8-max Seat #4 is the button
Seat 1: posetuta (51421 in chips, $3.67 bounty) 
Seat 2: HaWooli (53679 in chips, $2.45 bounty) 
Seat 3: boidoidu (32312 in chips, $3.67 bounty) 
Seat 4: DerKingKalle (28150 in chips, $2.45 bounty) 
Seat 5: KECAKUATL (61844 in chips, $4.28 bounty) 
Seat 6: Kevin12345Mc (62885 in chips, $2.45 bounty) 
Seat 7: Tess_4444 (17050 in chips, $2.45 bounty) 
Seat 8: igor okumura (33675 in chips, $2.45 bounty) 
posetuta: posts the ante 175
HaWooli: posts the ante 175
boidoidu: posts the ante 175
DerKingKalle: posts the ante 175
KECAKUATL: posts the ante 175
Kevin12345Mc: posts the ante 175
Tess_4444: posts the ante 175
igor okumura: posts the ante 175
KECAKUATL: posts small blind 600
Kevin12345Mc: posts big blind 1200
*** HOLE CARDS ***
Dealt to Kevin12345Mc [Qc 9c]
Tess_4444: folds 
igor okumura: folds 
posetuta: raises 1800 to 3000
HaWooli: raises 9200 to 12200
boidoidu: folds 
DerKingKalle: folds 
KECAKUATL: folds 
Kevin12345Mc: folds 
posetuta: raises 39046 to 51246 and is all-in
HaWooli: calls 39046
*** FLOP *** [7d 8c 2h]
*** TURN *** [7d 8c 2h] [8s]
*** RIVER *** [7d 8c 2h 8s] [Tc]
*** SHOW DOWN ***
posetuta: shows [Ah Ks] (a pair of Eights)
HaWooli: shows [As Kh] (a pair of Eights)
posetuta collected 52846 from pot
HaWooli collected 52846 from pot
*** SUMMARY ***
Total pot 105692 | Rake 0 
Board [7d 8c 2h 8s Tc]
Seat 1: posetuta showed [Ah Ks] and won (52846) with a pair of Eights
Seat 2: HaWooli showed [As Kh] and won (52846) with a pair of Eights
Seat 3: boidoidu folded before Flop (didn't bet)
Seat 4: DerKingKalle (button) folded before Flop (didn't bet)
Seat 5: KECAKUATL (small blind) folded before Flop
Seat 6: Kevin12345Mc (big blind) folded before Flop
Seat 7: Tess_4444 folded before Flop (didn't bet)
Seat 8: igor okumura folded before Flop (didn't bet)



PokerStars Hand #254864678801: Tournament #3856223586, $2.45+$2.45+$0.60 USD Hold'em No Limit - Level XII (600/1200) - 2025/02/14 19:16:12 WET [2025/02/14 14:16:12 ET]
Table '3856223586 32' 8-max Seat #5 is the button
Seat 1: posetuta (52846 in chips, $3.67 bounty) 
Seat 2: HaWooli (55104 in chips, $2.45 bounty) 
Seat 3: boidoidu (32137 in chips, $3.67 bounty) 
Seat 4: DerKingKalle (27975 in chips, $2.45 bounty) 
Seat 5: KECAKUATL (61069 in chips, $4.28 bounty) 
Seat 6: Kevin12345Mc (61510 in chips, $2.45 bounty) 
Seat 7: Tess_4444 (16875 in chips, $2.45 bounty) 
Seat 8: igor okumura (33500 in chips, $2.45 bounty) 
posetuta: posts the ante 175
HaWooli: posts the ante 175
boidoidu: posts the ante 175
DerKingKalle: posts the ante 175
KECAKUATL: posts the ante 175
Kevin12345Mc: posts the ante 175
Tess_4444: posts the ante 175
igor okumura: posts the ante 175
Kevin12345Mc: posts small blind 600
Tess_4444: posts big blind 1200
*** HOLE CARDS ***
Dealt to Kevin12345Mc [Ks 7s]
igor okumura: folds 
posetuta: folds 
HaWooli: raises 1344 to 2544
boidoidu: folds 
DerKingKalle: calls 2544
KECAKUATL: folds 
Kevin12345Mc: calls 1944
Tess_4444: folds 
*** FLOP *** [Tc As Jh]
Kevin12345Mc: checks 
HaWooli: bets 3786
DerKingKalle: calls 3786
Kevin12345Mc: folds 
*** TURN *** [Tc As Jh] [3s]
HaWooli: bets 12107
DerKingKalle: folds 
Uncalled bet (12107) returned to HaWooli
HaWooli collected 17804 from pot
HaWooli: doesn't show hand 
*** SUMMARY ***
Total pot 17804 | Rake 0 
Board [Tc As Jh 3s]
Seat 1: posetuta folded before Flop (didn't bet)
Seat 2: HaWooli collected (17804)
Seat 3: boidoidu folded before Flop (didn't bet)
Seat 4: DerKingKalle folded on the Turn
Seat 5: KECAKUATL (button) folded before Flop (didn't bet)
Seat 6: Kevin12345Mc (small blind) folded on the Flop
Seat 7: Tess_4444 (big blind) folded before Flop
Seat 8: igor okumura folded before Flop (didn't bet)



PokerStars Hand #254864697190: Tournament #3856223586, $2.45+$2.45+$0.60 USD Hold'em No Limit - Level XII (600/1200) - 2025/02/14 19:17:20 WET [2025/02/14 14:17:20 ET]
Table '3856223586 32' 8-max Seat #6 is the button
Seat 1: posetuta (52671 in chips, $3.67 bounty) 
Seat 2: HaWooli (66403 in chips, $2.45 bounty) 
Seat 3: boidoidu (31962 in chips, $3.67 bounty) 
Seat 4: DerKingKalle (21470 in chips, $2.45 bounty) 
Seat 5: KECAKUATL (60894 in chips, $4.28 bounty) 
Seat 6: Kevin12345Mc (58791 in chips, $2.45 bounty) 
Seat 7: Tess_4444 (15500 in chips, $2.45 bounty) 
Seat 8: igor okumura (33325 in chips, $2.45 bounty) 
posetuta: posts the ante 175
HaWooli: posts the ante 175
boidoidu: posts the ante 175
DerKingKalle: posts the ante 175
KECAKUATL: posts the ante 175
Kevin12345Mc: posts the ante 175
Tess_4444: posts the ante 175
igor okumura: posts the ante 175
Tess_4444: posts small blind 600
igor okumura: posts big blind 1200
*** HOLE CARDS ***
Dealt to Kevin12345Mc [6h 2d]
posetuta: raises 1320 to 2520
HaWooli: folds 
boidoidu: folds 
DerKingKalle: folds 
KECAKUATL: folds 
Kevin12345Mc: folds 
Tess_4444: folds 
igor okumura: calls 1320
*** FLOP *** [9c Js 4s]
igor okumura: checks 
posetuta: bets 2323
igor okumura: folds 
Uncalled bet (2323) returned to posetuta
posetuta collected 7040 from pot
posetuta: doesn't show hand 
*** SUMMARY ***
Total pot 7040 | Rake 0 
Board [9c Js 4s]
Seat 1: posetuta collected (7040)
Seat 2: HaWooli folded before Flop (didn't bet)
Seat 3: boidoidu folded before Flop (didn't bet)
Seat 4: DerKingKalle folded before Flop (didn't bet)
Seat 5: KECAKUATL folded before Flop (didn't bet)
Seat 6: Kevin12345Mc (button) folded before Flop (didn't bet)
Seat 7: Tess_4444 (small blind) folded before Flop
Seat 8: igor okumura (big blind) folded on the Flop



PokerStars Hand #254864712015: Tournament #3856223586, $2.45+$2.45+$0.60 USD Hold'em No Limit - Level XII (600/1200) - 2025/02/14 19:18:15 WET [2025/02/14 14:18:15 ET]
Table '3856223586 32' 8-max Seat #7 is the button
Seat 1: posetuta (57016 in chips, $3.67 bounty) 
Seat 2: HaWooli (66228 in chips, $2.45 bounty) 
Seat 3: boidoidu (31787 in chips, $3.67 bounty) 
Seat 4: DerKingKalle (21295 in chips, $2.45 bounty) 
Seat 5: KECAKUATL (60719 in chips, $4.28 bounty) 
Seat 6: Kevin12345Mc (58616 in chips, $2.45 bounty) 
Seat 7: Tess_4444 (14725 in chips, $2.45 bounty) 
Seat 8: igor okumura (30630 in chips, $2.45 bounty) 
posetuta: posts the ante 175
HaWooli: posts the ante 175
boidoidu: posts the ante 175
DerKingKalle: posts the ante 175
KECAKUATL: posts the ante 175
Kevin12345Mc: posts the ante 175
Tess_4444: posts the ante 175
igor okumura: posts the ante 175
igor okumura: posts small blind 600
posetuta: posts big blind 1200
*** HOLE CARDS ***
Dealt to Kevin12345Mc [Th Kd]
HaWooli: folds 
boidoidu: folds 
DerKingKalle: raises 1440 to 2640
KECAKUATL: calls 2640
Kevin12345Mc: folds 
Tess_4444: folds 
igor okumura: folds 
posetuta: calls 1440
*** FLOP *** [Jc 5s Ad]
posetuta: checks 
DerKingKalle: bets 3274
KECAKUATL: calls 3274
posetuta: folds 
*** TURN *** [Jc 5s Ad] [4d]
DerKingKalle: bets 15206 and is all-in
KECAKUATL: calls 15206
*** RIVER *** [Jc 5s Ad 4d] [4s]
*** SHOW DOWN ***
DerKingKalle: shows [Kc Tc] (a pair of Fours)
KECAKUATL: shows [Ac As] (a full house, Aces full of Fours)
KECAKUATL collected 46880 from pot
KECAKUATL wins $1.23 for eliminating DerKingKalle and their own bounty increases by $1.22 to $5.50
DerKingKalle finished the tournament
*** SUMMARY ***
Total pot 46880 | Rake 0 
Board [Jc 5s Ad 4d 4s]
Seat 1: posetuta (big blind) folded on the Flop
Seat 2: HaWooli folded before Flop (didn't bet)
Seat 3: boidoidu folded before Flop (didn't bet)
Seat 4: DerKingKalle showed [Kc Tc] and lost with a pair of Fours
Seat 5: KECAKUATL showed [Ac As] and won (46880) with a full house, Aces full of Fours
Seat 6: Kevin12345Mc folded before Flop (didn't bet)
Seat 7: Tess_4444 (button) folded before Flop (didn't bet)
Seat 8: igor okumura (small blind) folded before Flop



PokerStars Hand #254864730278: Tournament #3856223586, $2.45+$2.45+$0.60 USD Hold'em No Limit - Level XII (600/1200) - 2025/02/14 19:19:23 WET [2025/02/14 14:19:23 ET]
Table '3856223586 32' 8-max Seat #8 is the button
Seat 1: posetuta (54201 in chips, $3.67 bounty) 
Seat 2: HaWooli (66053 in chips, $2.45 bounty) 
Seat 3: boidoidu (31612 in chips, $3.67 bounty) 
Seat 5: KECAKUATL (86304 in chips, $5.50 bounty) 
Seat 6: Kevin12345Mc (58441 in chips, $2.45 bounty) 
Seat 7: Tess_4444 (14550 in chips, $2.45 bounty) 
Seat 8: igor okumura (29855 in chips, $2.45 bounty) 
posetuta: posts the ante 175
HaWooli: posts the ante 175
boidoidu: posts the ante 175
KECAKUATL: posts the ante 175
Kevin12345Mc: posts the ante 175
Tess_4444: posts the ante 175
igor okumura: posts the ante 175
posetuta: posts small blind 600
HaWooli: posts big blind 1200
*** HOLE CARDS ***
Dealt to Kevin12345Mc [3d Kd]
DerKingKalle is disconnected 
boidoidu: raises 30237 to 31437 and is all-in
KECAKUATL: folds 
Kevin12345Mc: folds 
Tess_4444: folds 
igor okumura: folds 
posetuta: folds 
HaWooli: folds 
Uncalled bet (30237) returned to boidoidu
boidoidu collected 4225 from pot
boidoidu: doesn't show hand 
*** SUMMARY ***
Total pot 4225 | Rake 0 
Seat 1: posetuta (small blind) folded before Flop
Seat 2: HaWooli (big blind) folded before Flop
Seat 3: boidoidu collected (4225)
Seat 5: KECAKUATL folded before Flop (didn't bet)
Seat 6: Kevin12345Mc folded before Flop (didn't bet)
Seat 7: Tess_4444 folded before Flop (didn't bet)
Seat 8: igor okumura (button) folded before Flop (didn't bet)



PokerStars Hand #254864739961: Tournament #3856223586, $2.45+$2.45+$0.60 USD Hold'em No Limit - Level XII (600/1200) - 2025/02/14 19:19:59 WET [2025/02/14 14:19:59 ET]
Table '3856223586 32' 8-max Seat #1 is the button
Seat 1: posetuta (53426 in chips, $3.67 bounty) 
Seat 2: HaWooli (64678 in chips, $2.45 bounty) 
Seat 3: boidoidu (34462 in chips, $3.67 bounty) 
Seat 4: DerKingKalle (25000 in chips, $2.45 bounty) 
Seat 5: KECAKUATL (86129 in chips, $5.50 bounty) 
Seat 6: Kevin12345Mc (58266 in chips, $2.45 bounty) 
Seat 7: Tess_4444 (14375 in chips, $2.45 bounty) 
Seat 8: igor okumura (29680 in chips, $2.45 bounty) 
posetuta: posts the ante 175
HaWooli: posts the ante 175
boidoidu: posts the ante 175
DerKingKalle: posts the ante 175
KECAKUATL: posts the ante 175
Kevin12345Mc: posts the ante 175
Tess_4444: posts the ante 175
igor okumura: posts the ante 175
HaWooli: posts small blind 600
boidoidu: posts big blind 1200
*** HOLE CARDS ***
Dealt to Kevin12345Mc [Qd 5h]
DerKingKalle: folds 
KECAKUATL: folds 
Kevin12345Mc: folds 
Tess_4444: folds 
igor okumura: folds 
posetuta: raises 1800 to 3000
HaWooli: folds 
boidoidu: folds 
Uncalled bet (1800) returned to posetuta
posetuta collected 4400 from pot
posetuta: doesn't show hand 
*** SUMMARY ***
Total pot 4400 | Rake 0 
Seat 1: posetuta (button) collected (4400)
Seat 2: HaWooli (small blind) folded before Flop
Seat 3: boidoidu (big blind) folded before Flop
Seat 4: DerKingKalle folded before Flop (didn't bet)
Seat 5: KECAKUATL folded before Flop (didn't bet)
Seat 6: Kevin12345Mc folded before Flop (didn't bet)
Seat 7: Tess_4444 folded before Flop (didn't bet)
Seat 8: igor okumura folded before Flop (didn't bet)



PokerStars Hand #254864745910: Tournament #3856223586, $2.45+$2.45+$0.60 USD Hold'em No Limit - Level XII (600/1200) - 2025/02/14 19:20:22 WET [2025/02/14 14:20:22 ET]
Table '3856223586 32' 8-max Seat #2 is the button
Seat 1: posetuta (56451 in chips, $3.67 bounty) 
Seat 2: HaWooli (63903 in chips, $2.45 bounty) 
Seat 3: boidoidu (33087 in chips, $3.67 bounty) 
Seat 4: DerKingKalle (24825 in chips, $2.45 bounty) 
Seat 5: KECAKUATL (85954 in chips, $5.50 bounty) 
Seat 6: Kevin12345Mc (58091 in chips, $2.45 bounty) 
Seat 7: Tess_4444 (14200 in chips, $2.45 bounty) 
Seat 8: igor okumura (29505 in chips, $2.45 bounty) 
posetuta: posts the ante 175
HaWooli: posts the ante 175
boidoidu: posts the ante 175
DerKingKalle: posts the ante 175
KECAKUATL: posts the ante 175
Kevin12345Mc: posts the ante 175
Tess_4444: posts the ante 175
igor okumura: posts the ante 175
boidoidu: posts small blind 600
DerKingKalle: posts big blind 1200
*** HOLE CARDS ***
Dealt to Kevin12345Mc [2s 2c]
KECAKUATL: folds 
Kevin12345Mc: folds 
Tess_4444: raises 12825 to 14025 and is all-in
igor okumura: folds 
posetuta: folds 
HaWooli: folds 
boidoidu: folds 
DerKingKalle: calls 12825
*** FLOP *** [8s Qh Jd]
*** TURN *** [8s Qh Jd] [9s]
*** RIVER *** [8s Qh Jd 9s] [5c]
*** SHOW DOWN ***
DerKingKalle: shows [7c Ac] (high card Ace)
Tess_4444: shows [3s 3c] (a pair of Threes)
Tess_4444 collected 30050 from pot
*** SUMMARY ***
Total pot 30050 | Rake 0 
Board [8s Qh Jd 9s 5c]
Seat 1: posetuta folded before Flop (didn't bet)
Seat 2: HaWooli (button) folded before Flop (didn't bet)
Seat 3: boidoidu (small blind) folded before Flop
Seat 4: DerKingKalle (big blind) showed [7c Ac] and lost with high card Ace
Seat 5: KECAKUATL folded before Flop (didn't bet)
Seat 6: Kevin12345Mc folded before Flop (didn't bet)
Seat 7: Tess_4444 showed [3s 3c] and won (30050) with a pair of Threes
Seat 8: igor okumura folded before Flop (didn't bet)



PokerStars Hand #254864757775: Tournament #3856223586, $2.45+$2.45+$0.60 USD Hold'em No Limit - Level XIII (700/1400) - 2025/02/14 19:21:06 WET [2025/02/14 14:21:06 ET]
Table '3856223586 32' 8-max Seat #3 is the button
Seat 1: posetuta (56276 in chips, $3.67 bounty) 
Seat 2: HaWooli (63728 in chips, $2.45 bounty) 
Seat 3: boidoidu (32312 in chips, $3.67 bounty) 
Seat 4: DerKingKalle (10625 in chips, $2.45 bounty) 
Seat 5: KECAKUATL (85779 in chips, $5.50 bounty) 
Seat 6: Kevin12345Mc (57916 in chips, $2.45 bounty) 
Seat 7: Tess_4444 (30050 in chips, $2.45 bounty) 
Seat 8: igor okumura (29330 in chips, $2.45 bounty) 
posetuta: posts the ante 200
HaWooli: posts the ante 200
boidoidu: posts the ante 200
DerKingKalle: posts the ante 200
KECAKUATL: posts the ante 200
Kevin12345Mc: posts the ante 200
Tess_4444: posts the ante 200
igor okumura: posts the ante 200
DerKingKalle: posts small blind 700
KECAKUATL: posts big blind 1400
*** HOLE CARDS ***
Dealt to Kevin12345Mc [7c Td]
Kevin12345Mc: folds 
Tess_4444: folds 
igor okumura: folds 
posetuta: folds 
HaWooli: folds 
boidoidu: folds 
DerKingKalle: raises 9025 to 10425 and is all-in
KECAKUATL: calls 9025
*** FLOP *** [6s 9s 4h]
*** TURN *** [6s 9s 4h] [7d]
*** RIVER *** [6s 9s 4h 7d] [4d]
*** SHOW DOWN ***
DerKingKalle: shows [Kc 5d] (a pair of Fours)
KECAKUATL: shows [3h 5c] (a straight, Three to Seven)
KECAKUATL collected 22450 from pot
KECAKUATL wins $1.23 for eliminating DerKingKalle and their own bounty increases by $1.22 to $6.72
DerKingKalle finished the tournament
*** SUMMARY ***
Total pot 22450 | Rake 0 
Board [6s 9s 4h 7d 4d]
Seat 1: posetuta folded before Flop (didn't bet)
Seat 2: HaWooli folded before Flop (didn't bet)
Seat 3: boidoidu (button) folded before Flop (didn't bet)
Seat 4: DerKingKalle (small blind) showed [Kc 5d] and lost with a pair of Fours
Seat 5: KECAKUATL (big blind) showed [3h 5c] and won (22450) with a straight, Three to Seven
Seat 6: Kevin12345Mc folded before Flop (didn't bet)
Seat 7: Tess_4444 folded before Flop (didn't bet)
Seat 8: igor okumura folded before Flop (didn't bet)



PokerStars Hand #254864765735: Tournament #3856223586, $2.45+$2.45+$0.60 USD Hold'em No Limit - Level XIII (700/1400) - 2025/02/14 19:21:36 WET [2025/02/14 14:21:36 ET]
Table '3856223586 32' 8-max Seat #5 is the button
Seat 1: posetuta (56076 in chips, $3.67 bounty) 
Seat 2: HaWooli (63528 in chips, $2.45 bounty) 
Seat 3: boidoidu (32112 in chips, $3.67 bounty) 
Seat 5: KECAKUATL (97604 in chips, $6.72 bounty) 
Seat 6: Kevin12345Mc (57716 in chips, $2.45 bounty) 
Seat 7: Tess_4444 (29850 in chips, $2.45 bounty) 
Seat 8: igor okumura (29130 in chips, $2.45 bounty) 
posetuta: posts the ante 200
HaWooli: posts the ante 200
boidoidu: posts the ante 200
KECAKUATL: posts the ante 200
Kevin12345Mc: posts the ante 200
Tess_4444: posts the ante 200
igor okumura: posts the ante 200
Kevin12345Mc: posts small blind 700
Tess_4444: posts big blind 1400
*** HOLE CARDS ***
Dealt to Kevin12345Mc [7h Js]
igor okumura: folds 
posetuta: folds 
HaWooli: folds 
boidoidu: folds 
bullgo is disconnected 
KECAKUATL: folds 
Kevin12345Mc: calls 700
Tess_4444: raises 4200 to 5600
Kevin12345Mc: folds 
Uncalled bet (4200) returned to Tess_4444
Tess_4444 collected 4200 from pot
*** SUMMARY ***
Total pot 4200 | Rake 0 
Seat 1: posetuta folded before Flop (didn't bet)
Seat 2: HaWooli folded before Flop (didn't bet)
Seat 3: boidoidu folded before Flop (didn't bet)
Seat 5: KECAKUATL (button) folded before Flop (didn't bet)
Seat 6: Kevin12345Mc (small blind) folded before Flop
Seat 7: Tess_4444 (big blind) collected (4200)
Seat 8: igor okumura folded before Flop (didn't bet)



PokerStars Hand #254864775554: Tournament #3856223586, $2.45+$2.45+$0.60 USD Hold'em No Limit - Level XIII (700/1400) - 2025/02/14 19:22:13 WET [2025/02/14 14:22:13 ET]
Table '3856223586 32' 8-max Seat #6 is the button
Seat 1: posetuta (55876 in chips, $3.67 bounty) 
Seat 2: HaWooli (63328 in chips, $2.45 bounty) 
Seat 3: boidoidu (31912 in chips, $3.67 bounty) 
Seat 4: bullgo (33960 in chips, $2.45 bounty) 
Seat 5: KECAKUATL (97404 in chips, $6.72 bounty) 
Seat 6: Kevin12345Mc (56116 in chips, $2.45 bounty) 
Seat 7: Tess_4444 (32450 in chips, $2.45 bounty) 
Seat 8: igor okumura (28930 in chips, $2.45 bounty) 
posetuta: posts the ante 200
HaWooli: posts the ante 200
boidoidu: posts the ante 200
bullgo: posts the ante 200
KECAKUATL: posts the ante 200
Kevin12345Mc: posts the ante 200
Tess_4444: posts the ante 200
igor okumura: posts the ante 200
Tess_4444: posts small blind 700
igor okumura: posts big blind 1400
*** HOLE CARDS ***
Dealt to Kevin12345Mc [Jd 8d]
posetuta: raises 2100 to 3500
HaWooli: folds 
boidoidu: folds 
bullgo: folds 
KECAKUATL: folds 
Kevin12345Mc: folds 
Tess_4444: folds 
igor okumura: folds 
Uncalled bet (2100) returned to posetuta
posetuta collected 5100 from pot
posetuta: doesn't show hand 
*** SUMMARY ***
Total pot 5100 | Rake 0 
Seat 1: posetuta collected (5100)
Seat 2: HaWooli folded before Flop (didn't bet)
Seat 3: boidoidu folded before Flop (didn't bet)
Seat 4: bullgo folded before Flop (didn't bet)
Seat 5: KECAKUATL folded before Flop (didn't bet)
Seat 6: Kevin12345Mc (button) folded before Flop (didn't bet)
Seat 7: Tess_4444 (small blind) folded before Flop
Seat 8: igor okumura (big blind) folded before Flop



PokerStars Hand #254864779789: Tournament #3856223586, $2.45+$2.45+$0.60 USD Hold'em No Limit - Level XIII (700/1400) - 2025/02/14 19:22:29 WET [2025/02/14 14:22:29 ET]
Table '3856223586 32' 8-max Seat #7 is the button
Seat 1: posetuta (59376 in chips, $3.67 bounty) 
Seat 2: HaWooli (63128 in chips, $2.45 bounty) 
Seat 3: boidoidu (31712 in chips, $3.67 bounty) 
Seat 4: bullgo (33760 in chips, $2.45 bounty) 
Seat 5: KECAKUATL (97204 in chips, $6.72 bounty) 
Seat 6: Kevin12345Mc (55916 in chips, $2.45 bounty) 
Seat 7: Tess_4444 (31550 in chips, $2.45 bounty) 
Seat 8: igor okumura (27330 in chips, $2.45 bounty) 
posetuta: posts the ante 200
HaWooli: posts the ante 200
boidoidu: posts the ante 200
bullgo: posts the ante 200
KECAKUATL: posts the ante 200
Kevin12345Mc: posts the ante 200
Tess_4444: posts the ante 200
igor okumura: posts the ante 200
igor okumura: posts small blind 700
posetuta: posts big blind 1400
*** HOLE CARDS ***
Dealt to Kevin12345Mc [5c Qh]
HaWooli: raises 1568 to 2968
boidoidu: folds 
bullgo: folds 
KECAKUATL: folds 
Kevin12345Mc: folds 
Tess_4444: folds 
igor okumura: folds 
posetuta: calls 1568
*** FLOP *** [2c Js 9h]
posetuta: checks 
HaWooli: bets 3047
posetuta: calls 3047
*** TURN *** [2c Js 9h] [9d]
posetuta: checks 
HaWooli: bets 5302
posetuta: calls 5302
*** RIVER *** [2c Js 9h 9d] [8c]
posetuta: checks 
HaWooli: bets 16955
posetuta: folds 
Uncalled bet (16955) returned to HaWooli
HaWooli collected 24934 from pot
HaWooli: doesn't show hand 
*** SUMMARY ***
Total pot 24934 | Rake 0 
Board [2c Js 9h 9d 8c]
Seat 1: posetuta (big blind) folded on the River
Seat 2: HaWooli collected (24934)
Seat 3: boidoidu folded before Flop (didn't bet)
Seat 4: bullgo folded before Flop (didn't bet)
Seat 5: KECAKUATL folded before Flop (didn't bet)
Seat 6: Kevin12345Mc folded before Flop (didn't bet)
Seat 7: Tess_4444 (button) folded before Flop (didn't bet)
Seat 8: igor okumura (small blind) folded before Flop



PokerStars Hand #254864794825: Tournament #3856223586, $2.45+$2.45+$0.60 USD Hold'em No Limit - Level XIII (700/1400) - 2025/02/14 19:23:26 WET [2025/02/14 14:23:26 ET]
Table '3856223586 32' 8-max Seat #8 is the button
Seat 1: posetuta (47859 in chips, $3.67 bounty) 
Seat 2: HaWooli (76545 in chips, $2.45 bounty) 
Seat 3: boidoidu (31512 in chips, $3.67 bounty) 
Seat 4: bullgo (33560 in chips, $2.45 bounty) 
Seat 5: KECAKUATL (97004 in chips, $6.72 bounty) 
Seat 6: Kevin12345Mc (55716 in chips, $2.45 bounty) 
Seat 7: Tess_4444 (31350 in chips, $2.45 bounty) 
Seat 8: igor okumura (26430 in chips, $2.45 bounty) 
posetuta: posts the ante 200
HaWooli: posts the ante 200
boidoidu: posts the ante 200
bullgo: posts the ante 200
KECAKUATL: posts the ante 200
Kevin12345Mc: posts the ante 200
Tess_4444: posts the ante 200
igor okumura: posts the ante 200
posetuta: posts small blind 700
HaWooli: posts big blind 1400
*** HOLE CARDS ***
Dealt to Kevin12345Mc [8d Ad]
boidoidu: folds 
bullgo: folds 
KECAKUATL: folds 
Kevin12345Mc: raises 1680 to 3080
Tess_4444: folds 
igor okumura: folds 
posetuta: calls 2380
HaWooli: folds 
*** FLOP *** [4h Jc 3d]
posetuta: checks 
Kevin12345Mc: bets 3023
posetuta: calls 3023
*** TURN *** [4h Jc 3d] [2c]
posetuta: checks 
Kevin12345Mc: checks 
*** RIVER *** [4h Jc 3d 2c] [5h]
posetuta: checks 
Kevin12345Mc: bets 5018
posetuta: folds 
Uncalled bet (5018) returned to Kevin12345Mc
Kevin12345Mc collected 15206 from pot
Kevin12345Mc: doesn't show hand 
*** SUMMARY ***
Total pot 15206 | Rake 0 
Board [4h Jc 3d 2c 5h]
Seat 1: posetuta (small blind) folded on the River
Seat 2: HaWooli (big blind) folded before Flop
Seat 3: boidoidu folded before Flop (didn't bet)
Seat 4: bullgo folded before Flop (didn't bet)
Seat 5: KECAKUATL folded before Flop (didn't bet)
Seat 6: Kevin12345Mc collected (15206)
Seat 7: Tess_4444 folded before Flop (didn't bet)
Seat 8: igor okumura (button) folded before Flop (didn't bet)



PokerStars Hand #254864809791: Tournament #3856223586, $2.45+$2.45+$0.60 USD Hold'em No Limit - Level XIII (700/1400) - 2025/02/14 19:24:22 WET [2025/02/14 14:24:22 ET]
Table '3856223586 32' 8-max Seat #1 is the button
Seat 1: posetuta (41556 in chips, $3.67 bounty) 
Seat 2: HaWooli (74945 in chips, $2.45 bounty) 
Seat 3: boidoidu (31312 in chips, $3.67 bounty) 
Seat 4: bullgo (33360 in chips, $2.45 bounty) 
Seat 5: KECAKUATL (96804 in chips, $6.72 bounty) 
Seat 6: Kevin12345Mc (64619 in chips, $2.45 bounty) 
Seat 7: Tess_4444 (31150 in chips, $2.45 bounty) 
Seat 8: igor okumura (26230 in chips, $2.45 bounty) 
posetuta: posts the ante 200
HaWooli: posts the ante 200
boidoidu: posts the ante 200
bullgo: posts the ante 200
KECAKUATL: posts the ante 200
Kevin12345Mc: posts the ante 200
Tess_4444: posts the ante 200
igor okumura: posts the ante 200
HaWooli: posts small blind 700
boidoidu: posts big blind 1400
*** HOLE CARDS ***
Dealt to Kevin12345Mc [Kd Kh]
bullgo: folds 
KECAKUATL: raises 1400 to 2800
Kevin12345Mc: raises 5600 to 8400
Tess_4444: folds 
igor okumura: folds 
posetuta: folds 
HaWooli: folds 
boidoidu: folds 
KECAKUATL: calls 5600
*** FLOP *** [Qs 4s 8d]
KECAKUATL: checks 
Kevin12345Mc: bets 6765
KECAKUATL: calls 6765
*** TURN *** [Qs 4s 8d] [Qc]
KECAKUATL: checks 
Kevin12345Mc: bets 11230
KECAKUATL: folds 
Uncalled bet (11230) returned to Kevin12345Mc
Kevin12345Mc collected 34030 from pot
Kevin12345Mc: doesn't show hand 
*** SUMMARY ***
Total pot 34030 | Rake 0 
Board [Qs 4s 8d Qc]
Seat 1: posetuta (button) folded before Flop (didn't bet)
Seat 2: HaWooli (small blind) folded before Flop
Seat 3: boidoidu (big blind) folded before Flop
Seat 4: bullgo folded before Flop (didn't bet)
Seat 5: KECAKUATL folded on the Turn
Seat 6: Kevin12345Mc collected (34030)
Seat 7: Tess_4444 folded before Flop (didn't bet)
Seat 8: igor okumura folded before Flop (didn't bet)



PokerStars Hand #254864826795: Tournament #3856223586, $2.45+$2.45+$0.60 USD Hold'em No Limit - Level XIII (700/1400) - 2025/02/14 19:25:27 WET [2025/02/14 14:25:27 ET]
Table '3856223586 32' 8-max Seat #2 is the button
Seat 1: posetuta (41356 in chips, $3.67 bounty) 
Seat 2: HaWooli (74045 in chips, $2.45 bounty) 
Seat 3: boidoidu (29712 in chips, $3.67 bounty) 
Seat 4: bullgo (33160 in chips, $2.45 bounty) 
Seat 5: KECAKUATL (81439 in chips, $6.72 bounty) 
Seat 6: Kevin12345Mc (83284 in chips, $2.45 bounty) 
Seat 7: Tess_4444 (30950 in chips, $2.45 bounty) 
Seat 8: igor okumura (26030 in chips, $2.45 bounty) 
posetuta: posts the ante 200
HaWooli: posts the ante 200
boidoidu: posts the ante 200
bullgo: posts the ante 200
KECAKUATL: posts the ante 200
Kevin12345Mc: posts the ante 200
Tess_4444: posts the ante 200
igor okumura: posts the ante 200
boidoidu: posts small blind 700
bullgo: posts big blind 1400
*** HOLE CARDS ***
Dealt to Kevin12345Mc [Tc 9h]
KECAKUATL: folds 
Kevin12345Mc: folds 
Tess_4444: folds 
igor okumura: folds 
posetuta: folds 
HaWooli: raises 1568 to 2968
boidoidu: folds 
bullgo: folds 
Uncalled bet (1568) returned to HaWooli
HaWooli collected 5100 from pot
HaWooli: doesn't show hand 
*** SUMMARY ***
Total pot 5100 | Rake 0 
Seat 1: posetuta folded before Flop (didn't bet)
Seat 2: HaWooli (button) collected (5100)
Seat 3: boidoidu (small blind) folded before Flop
Seat 4: bullgo (big blind) folded before Flop
Seat 5: KECAKUATL folded before Flop (didn't bet)
Seat 6: Kevin12345Mc folded before Flop (didn't bet)
Seat 7: Tess_4444 folded before Flop (didn't bet)
Seat 8: igor okumura folded before Flop (didn't bet)



PokerStars Hand #254864836839: Tournament #3856223586, $2.45+$2.45+$0.60 USD Hold'em No Limit - Level XIII (700/1400) - 2025/02/14 19:26:05 WET [2025/02/14 14:26:05 ET]
Table '3856223586 32' 8-max Seat #3 is the button
Seat 1: posetuta (41156 in chips, $3.67 bounty) 
Seat 2: HaWooli (77545 in chips, $2.45 bounty) 
Seat 3: boidoidu (28812 in chips, $3.67 bounty) 
Seat 4: bullgo (31560 in chips, $2.45 bounty) 
Seat 5: KECAKUATL (81239 in chips, $6.72 bounty) 
Seat 6: Kevin12345Mc (83084 in chips, $2.45 bounty) 
Seat 7: Tess_4444 (30750 in chips, $2.45 bounty) 
Seat 8: igor okumura (25830 in chips, $2.45 bounty) 
posetuta: posts the ante 200
HaWooli: posts the ante 200
boidoidu: posts the ante 200
bullgo: posts the ante 200
KECAKUATL: posts the ante 200
Kevin12345Mc: posts the ante 200
Tess_4444: posts the ante 200
igor okumura: posts the ante 200
bullgo: posts small blind 700
KECAKUATL: posts big blind 1400
*** HOLE CARDS ***
Dealt to Kevin12345Mc [9d Ts]
Kevin12345Mc: folds 
Tess_4444: folds 
igor okumura: folds 
posetuta: folds 
HaWooli: raises 1568 to 2968
boidoidu: raises 25644 to 28612 and is all-in
bullgo: folds 
KECAKUATL: raises 52427 to 81039 and is all-in
HaWooli: folds 
Uncalled bet (52427) returned to KECAKUATL
*** FLOP *** [5d 7d 6c]
*** TURN *** [5d 7d 6c] [9c]
*** RIVER *** [5d 7d 6c 9c] [Td]
*** SHOW DOWN ***
KECAKUATL: shows [Js Jc] (a pair of Jacks)
boidoidu: shows [Ad Kh] (high card Ace)
KECAKUATL collected 62492 from pot
KECAKUATL wins $1.84 for eliminating boidoidu and their own bounty increases by $1.83 to $8.55
boidoidu finished the tournament
*** SUMMARY ***
Total pot 62492 | Rake 0 
Board [5d 7d 6c 9c Td]
Seat 1: posetuta folded before Flop (didn't bet)
Seat 2: HaWooli folded before Flop
Seat 3: boidoidu (button) showed [Ad Kh] and lost with high card Ace
Seat 4: bullgo (small blind) folded before Flop
Seat 5: KECAKUATL (big blind) showed [Js Jc] and won (62492) with a pair of Jacks
Seat 6: Kevin12345Mc folded before Flop (didn't bet)
Seat 7: Tess_4444 folded before Flop (didn't bet)
Seat 8: igor okumura folded before Flop (didn't bet)



PokerStars Hand #254864851135: Tournament #3856223586, $2.45+$2.45+$0.60 USD Hold'em No Limit - Level XIII (700/1400) - 2025/02/14 19:26:59 WET [2025/02/14 14:26:59 ET]
Table '3856223586 32' 8-max Seat #4 is the button
Seat 1: posetuta (40956 in chips, $3.67 bounty) 
Seat 2: HaWooli (74377 in chips, $2.45 bounty) 
Seat 4: bullgo (30660 in chips, $2.45 bounty) 
Seat 5: KECAKUATL (114919 in chips, $8.55 bounty) 
Seat 6: Kevin12345Mc (82884 in chips, $2.45 bounty) 
Seat 7: Tess_4444 (30550 in chips, $2.45 bounty) 
Seat 8: igor okumura (25630 in chips, $2.45 bounty) 
posetuta: posts the ante 200
HaWooli: posts the ante 200
bullgo: posts the ante 200
KECAKUATL: posts the ante 200
Kevin12345Mc: posts the ante 200
Tess_4444: posts the ante 200
igor okumura: posts the ante 200
KECAKUATL: posts small blind 700
Kevin12345Mc: posts big blind 1400
*** HOLE CARDS ***
Dealt to Kevin12345Mc [Ac 7s]
Tess_4444: folds 
igor okumura: folds 
posetuta: raises 1680 to 3080
HaWooli: folds 
bullgo: folds 
KECAKUATL: calls 2380
Kevin12345Mc: calls 1680
*** FLOP *** [3d 5h 9h]
KECAKUATL: checks 
Kevin12345Mc: checks 
posetuta: checks 
*** TURN *** [3d 5h 9h] [Qc]
KECAKUATL: checks 
Kevin12345Mc: checks 
posetuta: checks 
*** RIVER *** [3d 5h 9h Qc] [8s]
KECAKUATL: checks 
Kevin12345Mc: checks 
posetuta: checks 
*** SHOW DOWN ***
KECAKUATL: shows [Jd Kc] (high card King)
Kevin12345Mc: shows [Ac 7s] (high card Ace)
posetuta: shows [4d 4c] (a pair of Fours)
posetuta collected 10640 from pot
*** SUMMARY ***
Total pot 10640 | Rake 0 
Board [3d 5h 9h Qc 8s]
Seat 1: posetuta showed [4d 4c] and won (10640) with a pair of Fours
Seat 2: HaWooli folded before Flop (didn't bet)
Seat 4: bullgo (button) folded before Flop (didn't bet)
Seat 5: KECAKUATL (small blind) showed [Jd Kc] and lost with high card King
Seat 6: Kevin12345Mc (big blind) showed [Ac 7s] and lost with high card Ace
Seat 7: Tess_4444 folded before Flop (didn't bet)
Seat 8: igor okumura folded before Flop (didn't bet)



PokerStars Hand #254864865978: Tournament #3856223586, $2.45+$2.45+$0.60 USD Hold'em No Limit - Level XIII (700/1400) - 2025/02/14 19:27:56 WET [2025/02/14 14:27:56 ET]
Table '3856223586 32' 8-max Seat #5 is the button
Seat 1: posetuta (48316 in chips, $3.67 bounty) 
Seat 2: HaWooli (74177 in chips, $2.45 bounty) 
Seat 3: MarcelNarita (25000 in chips, $2.45 bounty) 
Seat 4: bullgo (30460 in chips, $2.45 bounty) 
Seat 5: KECAKUATL (111639 in chips, $8.55 bounty) 
Seat 6: Kevin12345Mc (79604 in chips, $2.45 bounty) 
Seat 7: Tess_4444 (30350 in chips, $2.45 bounty) 
Seat 8: igor okumura (25430 in chips, $2.45 bounty) 
posetuta: posts the ante 200
HaWooli: posts the ante 200
MarcelNarita: posts the ante 200
bullgo: posts the ante 200
KECAKUATL: posts the ante 200
Kevin12345Mc: posts the ante 200
Tess_4444: posts the ante 200
igor okumura: posts the ante 200
Kevin12345Mc: posts small blind 700
Tess_4444: posts big blind 1400
*** HOLE CARDS ***
Dealt to Kevin12345Mc [6h Kc]
igor okumura: folds 
posetuta: folds 
HaWooli: raises 1568 to 2968
MarcelNarita: folds 
bullgo: calls 2968
KECAKUATL: folds 
Kevin12345Mc: folds 
Tess_4444: folds 
*** FLOP *** [5h 5c Jc]
HaWooli: bets 3565
bullgo: folds 
Uncalled bet (3565) returned to HaWooli
HaWooli collected 9636 from pot
HaWooli: doesn't show hand 
*** SUMMARY ***
Total pot 9636 | Rake 0 
Board [5h 5c Jc]
Seat 1: posetuta folded before Flop (didn't bet)
Seat 2: HaWooli collected (9636)
Seat 3: MarcelNarita folded before Flop (didn't bet)
Seat 4: bullgo folded on the Flop
Seat 5: KECAKUATL (button) folded before Flop (didn't bet)
Seat 6: Kevin12345Mc (small blind) folded before Flop
Seat 7: Tess_4444 (big blind) folded before Flop
Seat 8: igor okumura folded before Flop (didn't bet)



PokerStars Hand #254864879567: Tournament #3856223586, $2.45+$2.45+$0.60 USD Hold'em No Limit - Level XIV (800/1600) - 2025/02/14 19:28:47 WET [2025/02/14 14:28:47 ET]
Table '3856223586 32' 8-max Seat #6 is the button
Seat 1: posetuta (48116 in chips, $3.67 bounty) 
Seat 2: HaWooli (80645 in chips, $2.45 bounty) 
Seat 3: MarcelNarita (24800 in chips, $2.45 bounty) 
Seat 4: bullgo (27292 in chips, $2.45 bounty) 
Seat 5: KECAKUATL (111439 in chips, $8.55 bounty) 
Seat 6: Kevin12345Mc (78704 in chips, $2.45 bounty) 
Seat 7: Tess_4444 (28750 in chips, $2.45 bounty) 
Seat 8: igor okumura (25230 in chips, $2.45 bounty) 
posetuta: posts the ante 225
HaWooli: posts the ante 225
MarcelNarita: posts the ante 225
bullgo: posts the ante 225
KECAKUATL: posts the ante 225
Kevin12345Mc: posts the ante 225
Tess_4444: posts the ante 225
igor okumura: posts the ante 225
Tess_4444: posts small blind 800
igor okumura: posts big blind 1600
*** HOLE CARDS ***
Dealt to Kevin12345Mc [Kd 4s]
posetuta: raises 2400 to 4000
HaWooli: folds 
MarcelNarita: folds 
bullgo: folds 
KECAKUATL: folds 
Kevin12345Mc: folds 
Tess_4444: folds 
igor okumura: calls 2400
*** FLOP *** [6s 9d 9c]
igor okumura: checks 
posetuta: bets 3498
igor okumura: folds 
Uncalled bet (3498) returned to posetuta
posetuta collected 10600 from pot
posetuta: doesn't show hand 
*** SUMMARY ***
Total pot 10600 | Rake 0 
Board [6s 9d 9c]
Seat 1: posetuta collected (10600)
Seat 2: HaWooli folded before Flop (didn't bet)
Seat 3: MarcelNarita folded before Flop (didn't bet)
Seat 4: bullgo folded before Flop (didn't bet)
Seat 5: KECAKUATL folded before Flop (didn't bet)
Seat 6: Kevin12345Mc (button) folded before Flop (didn't bet)
Seat 7: Tess_4444 (small blind) folded before Flop
Seat 8: igor okumura (big blind) folded on the Flop



PokerStars Hand #254864888767: Tournament #3856223586, $2.45+$2.45+$0.60 USD Hold'em No Limit - Level XIV (800/1600) - 2025/02/14 19:29:22 WET [2025/02/14 14:29:22 ET]
Table '3856223586 32' 8-max Seat #7 is the button
Seat 1: posetuta (54491 in chips, $3.67 bounty) 
Seat 2: HaWooli (80420 in chips, $2.45 bounty) 
Seat 3: MarcelNarita (24575 in chips, $2.45 bounty) 
Seat 4: bullgo (27067 in chips, $2.45 bounty) 
Seat 5: KECAKUATL (111214 in chips, $8.55 bounty) 
Seat 6: Kevin12345Mc (78479 in chips, $2.45 bounty) 
Seat 7: Tess_4444 (27725 in chips, $2.45 bounty) 
Seat 8: igor okumura (21005 in chips, $2.45 bounty) 
posetuta: posts the ante 225
HaWooli: posts the ante 225
MarcelNarita: posts the ante 225
bullgo: posts the ante 225
KECAKUATL: posts the ante 225
Kevin12345Mc: posts the ante 225
Tess_4444: posts the ante 225
igor okumura: posts the ante 225
igor okumura: posts small blind 800
posetuta: posts big blind 1600
*** HOLE CARDS ***
Dealt to Kevin12345Mc [7c 5c]
HaWooli: folds 
MarcelNarita: folds 
bullgo: folds 
KECAKUATL: folds 
Kevin12345Mc: folds 
Tess_4444: folds 
igor okumura: raises 19180 to 20780 and is all-in
posetuta: calls 19180
*** FLOP *** [Kc 5h 8d]
*** TURN *** [Kc 5h 8d] [2c]
*** RIVER *** [Kc 5h 8d 2c] [8h]
*** SHOW DOWN ***
igor okumura: shows [As 9c] (a pair of Eights)
posetuta: shows [Ah 8c] (three of a kind, Eights)
posetuta collected 43360 from pot
posetuta wins $1.23 for eliminating igor okumura and their own bounty increases by $1.22 to $4.89
igor okumura finished the tournament
*** SUMMARY ***
Total pot 43360 | Rake 0 
Board [Kc 5h 8d 2c 8h]
Seat 1: posetuta (big blind) showed [Ah 8c] and won (43360) with three of a kind, Eights
Seat 2: HaWooli folded before Flop (didn't bet)
Seat 3: MarcelNarita folded before Flop (didn't bet)
Seat 4: bullgo folded before Flop (didn't bet)
Seat 5: KECAKUATL folded before Flop (didn't bet)
Seat 6: Kevin12345Mc folded before Flop (didn't bet)
Seat 7: Tess_4444 (button) folded before Flop (didn't bet)
Seat 8: igor okumura (small blind) showed [As 9c] and lost with a pair of Eights



PokerStars Hand #254864905006: Tournament #3856223586, $2.45+$2.45+$0.60 USD Hold'em No Limit - Level XIV (800/1600) - 2025/02/14 19:30:23 WET [2025/02/14 14:30:23 ET]
Table '3856223586 110' 8-max Seat #8 is the button
Seat 1: PinguaMito (49409 in chips, $2.45 bounty) 
Seat 2: jim5432 (162504 in chips, $9.77 bounty) 
Seat 3: HENREMAXFREITAS (56111 in chips, $6.11 bounty) 
Seat 4: Yura Est (106289 in chips, $4.28 bounty) 
Seat 5: curacfacu (31329 in chips, $2.45 bounty) 
Seat 6: Kevin12345Mc (78254 in chips, $2.45 bounty) 
Seat 7: mis Yuliya (92982 in chips, $3.67 bounty) 
Seat 8: neilsavage33 (39825 in chips, $2.45 bounty) 
PinguaMito: posts the ante 225
jim5432: posts the ante 225
HENREMAXFREITAS: posts the ante 225
Yura Est: posts the ante 225
curacfacu: posts the ante 225
Kevin12345Mc: posts the ante 225
mis Yuliya: posts the ante 225
neilsavage33: posts the ante 225
PinguaMito: posts small blind 800
jim5432: posts big blind 1600
*** HOLE CARDS ***
Dealt to Kevin12345Mc [Kc 2d]
HENREMAXFREITAS: calls 1600
Yura Est: folds 
curacfacu: folds 
Kevin12345Mc: folds 
mis Yuliya: calls 1600
neilsavage33: folds 
PinguaMito: folds 
jim5432: checks 
*** FLOP *** [4s Th 3h]
jim5432: checks 
HENREMAXFREITAS: checks 
mis Yuliya: bets 1600
jim5432: calls 1600
HENREMAXFREITAS: folds 
*** TURN *** [4s Th 3h] [Tc]
jim5432: bets 4800
mis Yuliya: calls 4800
*** RIVER *** [4s Th 3h Tc] [Ah]
jim5432: checks 
mis Yuliya: checks 
*** SHOW DOWN ***
jim5432: shows [3s 5d] (two pair, Tens and Threes)
mis Yuliya: shows [8c 8d] (two pair, Tens and Eights)
mis Yuliya collected 20200 from pot
*** SUMMARY ***
Total pot 20200 | Rake 0 
Board [4s Th 3h Tc Ah]
Seat 1: PinguaMito (small blind) folded before Flop
Seat 2: jim5432 (big blind) showed [3s 5d] and lost with two pair, Tens and Threes
Seat 3: HENREMAXFREITAS folded on the Flop
Seat 4: Yura Est folded before Flop (didn't bet)
Seat 5: curacfacu folded before Flop (didn't bet)
Seat 6: Kevin12345Mc folded before Flop (didn't bet)
Seat 7: mis Yuliya showed [8c 8d] and won (20200) with two pair, Tens and Eights
Seat 8: neilsavage33 (button) folded before Flop (didn't bet)



PokerStars Hand #254864922320: Tournament #3856223586, $2.45+$2.45+$0.60 USD Hold'em No Limit - Level XIV (800/1600) - 2025/02/14 19:31:29 WET [2025/02/14 14:31:29 ET]
Table '3856223586 110' 8-max Seat #1 is the button
Seat 1: PinguaMito (48384 in chips, $2.45 bounty) 
Seat 2: jim5432 (154279 in chips, $9.77 bounty) 
Seat 3: HENREMAXFREITAS (54286 in chips, $6.11 bounty) 
Seat 4: Yura Est (106064 in chips, $4.28 bounty) 
Seat 5: curacfacu (31104 in chips, $2.45 bounty) 
Seat 6: Kevin12345Mc (78029 in chips, $2.45 bounty) 
Seat 7: mis Yuliya (104957 in chips, $3.67 bounty) 
Seat 8: neilsavage33 (39600 in chips, $2.45 bounty) 
PinguaMito: posts the ante 225
jim5432: posts the ante 225
HENREMAXFREITAS: posts the ante 225
Yura Est: posts the ante 225
curacfacu: posts the ante 225
Kevin12345Mc: posts the ante 225
mis Yuliya: posts the ante 225
neilsavage33: posts the ante 225
jim5432: posts small blind 800
HENREMAXFREITAS: posts big blind 1600
*** HOLE CARDS ***
Dealt to Kevin12345Mc [Ah 9s]
Yura Est: folds 
curacfacu: folds 
Kevin12345Mc: folds 
mis Yuliya: folds 
neilsavage33: folds 
PinguaMito: raises 1600 to 3200
jim5432: folds 
HENREMAXFREITAS: folds 
Uncalled bet (1600) returned to PinguaMito
PinguaMito collected 5800 from pot
PinguaMito: doesn't show hand 
*** SUMMARY ***
Total pot 5800 | Rake 0 
Seat 1: PinguaMito (button) collected (5800)
Seat 2: jim5432 (small blind) folded before Flop
Seat 3: HENREMAXFREITAS (big blind) folded before Flop
Seat 4: Yura Est folded before Flop (didn't bet)
Seat 5: curacfacu folded before Flop (didn't bet)
Seat 6: Kevin12345Mc folded before Flop (didn't bet)
Seat 7: mis Yuliya folded before Flop (didn't bet)
Seat 8: neilsavage33 folded before Flop (didn't bet)



PokerStars Hand #254864929326: Tournament #3856223586, $2.45+$2.45+$0.60 USD Hold'em No Limit - Level XIV (800/1600) - 2025/02/14 19:31:55 WET [2025/02/14 14:31:55 ET]
Table '3856223586 110' 8-max Seat #2 is the button
Seat 1: PinguaMito (52359 in chips, $2.45 bounty) 
Seat 2: jim5432 (153254 in chips, $9.77 bounty) 
Seat 3: HENREMAXFREITAS (52461 in chips, $6.11 bounty) 
Seat 4: Yura Est (105839 in chips, $4.28 bounty) 
Seat 5: curacfacu (30879 in chips, $2.45 bounty) 
Seat 6: Kevin12345Mc (77804 in chips, $2.45 bounty) 
Seat 7: mis Yuliya (104732 in chips, $3.67 bounty) 
Seat 8: neilsavage33 (39375 in chips, $2.45 bounty) 
PinguaMito: posts the ante 225
jim5432: posts the ante 225
HENREMAXFREITAS: posts the ante 225
Yura Est: posts the ante 225
curacfacu: posts the ante 225
Kevin12345Mc: posts the ante 225
mis Yuliya: posts the ante 225
neilsavage33: posts the ante 225
HENREMAXFREITAS: posts small blind 800
Yura Est: posts big blind 1600
*** HOLE CARDS ***
Dealt to Kevin12345Mc [8s 3s]
curacfacu: folds 
Kevin12345Mc: folds 
mis Yuliya: folds 
neilsavage33: raises 1600 to 3200
PinguaMito: folds 
jim5432: calls 3200
HENREMAXFREITAS: folds 
Yura Est: folds 
*** FLOP *** [4h 2c Jd]
neilsavage33: bets 35950 and is all-in
jim5432: folds 
Uncalled bet (35950) returned to neilsavage33
neilsavage33 collected 10600 from pot
*** SUMMARY ***
Total pot 10600 | Rake 0 
Board [4h 2c Jd]
Seat 1: PinguaMito folded before Flop (didn't bet)
Seat 2: jim5432 (button) folded on the Flop
Seat 3: HENREMAXFREITAS (small blind) folded before Flop
Seat 4: Yura Est (big blind) folded before Flop
Seat 5: curacfacu folded before Flop (didn't bet)
Seat 6: Kevin12345Mc folded before Flop (didn't bet)
Seat 7: mis Yuliya folded before Flop (didn't bet)
Seat 8: neilsavage33 collected (10600)



PokerStars Hand #254864940539: Tournament #3856223586, $2.45+$2.45+$0.60 USD Hold'em No Limit - Level XIV (800/1600) - 2025/02/14 19:32:36 WET [2025/02/14 14:32:36 ET]
Table '3856223586 110' 8-max Seat #3 is the button
Seat 1: PinguaMito (52134 in chips, $2.45 bounty) 
Seat 2: jim5432 (149829 in chips, $9.77 bounty) 
Seat 3: HENREMAXFREITAS (51436 in chips, $6.11 bounty) 
Seat 4: Yura Est (104014 in chips, $4.28 bounty) 
Seat 5: curacfacu (30654 in chips, $2.45 bounty) 
Seat 6: Kevin12345Mc (77579 in chips, $2.45 bounty) 
Seat 7: mis Yuliya (104507 in chips, $3.67 bounty) 
Seat 8: neilsavage33 (46550 in chips, $2.45 bounty) 
PinguaMito: posts the ante 225
jim5432: posts the ante 225
HENREMAXFREITAS: posts the ante 225
Yura Est: posts the ante 225
curacfacu: posts the ante 225
Kevin12345Mc: posts the ante 225
mis Yuliya: posts the ante 225
neilsavage33: posts the ante 225
Yura Est: posts small blind 800
curacfacu: posts big blind 1600
*** HOLE CARDS ***
Dealt to Kevin12345Mc [9d Ks]
Kevin12345Mc: folds 
mis Yuliya: folds 
neilsavage33: folds 
PinguaMito: folds 
jim5432: raises 3200 to 4800
HENREMAXFREITAS: folds 
Yura Est: folds 
curacfacu: folds 
Uncalled bet (3200) returned to jim5432
jim5432 collected 5800 from pot
jim5432: doesn't show hand 
*** SUMMARY ***
Total pot 5800 | Rake 0 
Seat 1: PinguaMito folded before Flop (didn't bet)
Seat 2: jim5432 collected (5800)
Seat 3: HENREMAXFREITAS (button) folded before Flop (didn't bet)
Seat 4: Yura Est (small blind) folded before Flop
Seat 5: curacfacu (big blind) folded before Flop
Seat 6: Kevin12345Mc folded before Flop (didn't bet)
Seat 7: mis Yuliya folded before Flop (didn't bet)
Seat 8: neilsavage33 folded before Flop (didn't bet)



PokerStars Hand #254864948023: Tournament #3856223586, $2.45+$2.45+$0.60 USD Hold'em No Limit - Level XIV (800/1600) - 2025/02/14 19:33:05 WET [2025/02/14 14:33:05 ET]
Table '3856223586 110' 8-max Seat #4 is the button
Seat 1: PinguaMito (51909 in chips, $2.45 bounty) 
Seat 2: jim5432 (153804 in chips, $9.77 bounty) 
Seat 3: HENREMAXFREITAS (51211 in chips, $6.11 bounty) 
Seat 4: Yura Est (102989 in chips, $4.28 bounty) 
Seat 5: curacfacu (28829 in chips, $2.45 bounty) 
Seat 6: Kevin12345Mc (77354 in chips, $2.45 bounty) 
Seat 7: mis Yuliya (104282 in chips, $3.67 bounty) 
Seat 8: neilsavage33 (46325 in chips, $2.45 bounty) 
PinguaMito: posts the ante 225
jim5432: posts the ante 225
HENREMAXFREITAS: posts the ante 225
Yura Est: posts the ante 225
curacfacu: posts the ante 225
Kevin12345Mc: posts the ante 225
mis Yuliya: posts the ante 225
neilsavage33: posts the ante 225
curacfacu: posts small blind 800
Kevin12345Mc: posts big blind 1600
*** HOLE CARDS ***
Dealt to Kevin12345Mc [8d 9d]
mis Yuliya: folds 
neilsavage33: calls 1600
PinguaMito: folds 
jim5432: calls 1600
HENREMAXFREITAS: calls 1600
Yura Est: calls 1600
curacfacu: folds 
Kevin12345Mc: checks 
*** FLOP *** [2s Jc As]
Kevin12345Mc: checks 
neilsavage33: checks 
jim5432: checks 
HENREMAXFREITAS: checks 
Yura Est: checks 
*** TURN *** [2s Jc As] [Tc]
Kevin12345Mc: checks 
neilsavage33: bets 1600
jim5432: calls 1600
HENREMAXFREITAS: calls 1600
Yura Est: folds 
Kevin12345Mc: folds 
*** RIVER *** [2s Jc As Tc] [7h]
neilsavage33: checks 
jim5432: checks 
HENREMAXFREITAS: checks 
*** SHOW DOWN ***
neilsavage33: shows [Ts Qd] (a pair of Tens)
jim5432: shows [Jh Kc] (a pair of Jacks)
HENREMAXFREITAS: mucks hand 
jim5432 collected 15400 from pot
*** SUMMARY ***
Total pot 15400 | Rake 0 
Board [2s Jc As Tc 7h]
Seat 1: PinguaMito folded before Flop (didn't bet)
Seat 2: jim5432 showed [Jh Kc] and won (15400) with a pair of Jacks
Seat 3: HENREMAXFREITAS mucked [Jd Qh]
Seat 4: Yura Est (button) folded on the Turn
Seat 5: curacfacu (small blind) folded before Flop
Seat 6: Kevin12345Mc (big blind) folded on the Turn
Seat 7: mis Yuliya folded before Flop (didn't bet)
Seat 8: neilsavage33 showed [Ts Qd] and lost with a pair of Tens



PokerStars Hand #254864970126: Tournament #3856223586, $2.45+$2.45+$0.60 USD Hold'em No Limit - Level XIV (800/1600) - 2025/02/14 19:34:28 WET [2025/02/14 14:34:28 ET]
Table '3856223586 110' 8-max Seat #5 is the button
Seat 1: PinguaMito (51684 in chips, $2.45 bounty) 
Seat 2: jim5432 (165779 in chips, $9.77 bounty) 
Seat 3: HENREMAXFREITAS (47786 in chips, $6.11 bounty) 
Seat 4: Yura Est (101164 in chips, $4.28 bounty) 
Seat 5: curacfacu (27804 in chips, $2.45 bounty) 
Seat 6: Kevin12345Mc (75529 in chips, $2.45 bounty) 
Seat 7: mis Yuliya (104057 in chips, $3.67 bounty) 
Seat 8: neilsavage33 (42900 in chips, $2.45 bounty) 
PinguaMito: posts the ante 225
jim5432: posts the ante 225
HENREMAXFREITAS: posts the ante 225
Yura Est: posts the ante 225
curacfacu: posts the ante 225
Kevin12345Mc: posts the ante 225
mis Yuliya: posts the ante 225
neilsavage33: posts the ante 225
Kevin12345Mc: posts small blind 800
mis Yuliya: posts big blind 1600
*** HOLE CARDS ***
Dealt to Kevin12345Mc [As Jc]
neilsavage33: folds 
PinguaMito: folds 
jim5432: folds 
HENREMAXFREITAS: calls 1600
Yura Est: folds 
curacfacu: folds 
Kevin12345Mc: raises 4800 to 6400
mis Yuliya: folds 
HENREMAXFREITAS: folds 
Uncalled bet (4800) returned to Kevin12345Mc
Kevin12345Mc collected 6600 from pot
Kevin12345Mc: doesn't show hand 
*** SUMMARY ***
Total pot 6600 | Rake 0 
Seat 1: PinguaMito folded before Flop (didn't bet)
Seat 2: jim5432 folded before Flop (didn't bet)
Seat 3: HENREMAXFREITAS folded before Flop
Seat 4: Yura Est folded before Flop (didn't bet)
Seat 5: curacfacu (button) folded before Flop (didn't bet)
Seat 6: Kevin12345Mc (small blind) collected (6600)
Seat 7: mis Yuliya (big blind) folded before Flop
Seat 8: neilsavage33 folded before Flop (didn't bet)



PokerStars Hand #254864987646: Tournament #3856223586, $2.45+$2.45+$0.60 USD Hold'em No Limit - Level XIV (800/1600) - 2025/02/14 19:35:34 WET [2025/02/14 14:35:34 ET]
Table '3856223586 110' 8-max Seat #6 is the button
Seat 1: PinguaMito (51459 in chips, $2.45 bounty) 
Seat 2: jim5432 (165554 in chips, $9.77 bounty) 
Seat 3: HENREMAXFREITAS (45961 in chips, $6.11 bounty) 
Seat 4: Yura Est (100939 in chips, $4.28 bounty) 
Seat 5: curacfacu (27579 in chips, $2.45 bounty) 
Seat 6: Kevin12345Mc (80304 in chips, $2.45 bounty) 
Seat 7: mis Yuliya (102232 in chips, $3.67 bounty) 
Seat 8: neilsavage33 (42675 in chips, $2.45 bounty) 
PinguaMito: posts the ante 225
jim5432: posts the ante 225
HENREMAXFREITAS: posts the ante 225
Yura Est: posts the ante 225
curacfacu: posts the ante 225
Kevin12345Mc: posts the ante 225
mis Yuliya: posts the ante 225
neilsavage33: posts the ante 225
mis Yuliya: posts small blind 800
neilsavage33: posts big blind 1600
*** HOLE CARDS ***
Dealt to Kevin12345Mc [3s 4h]
PinguaMito: folds 
jim5432: folds 
HENREMAXFREITAS: folds 
Yura Est: folds 
curacfacu: raises 1600 to 3200
Kevin12345Mc: folds 
mis Yuliya: folds 
neilsavage33: folds 
Uncalled bet (1600) returned to curacfacu
curacfacu collected 5800 from pot
curacfacu: doesn't show hand 
*** SUMMARY ***
Total pot 5800 | Rake 0 
Seat 1: PinguaMito folded before Flop (didn't bet)
Seat 2: jim5432 folded before Flop (didn't bet)
Seat 3: HENREMAXFREITAS folded before Flop (didn't bet)
Seat 4: Yura Est folded before Flop (didn't bet)
Seat 5: curacfacu collected (5800)
Seat 6: Kevin12345Mc (button) folded before Flop (didn't bet)
Seat 7: mis Yuliya (small blind) folded before Flop
Seat 8: neilsavage33 (big blind) folded before Flop



PokerStars Hand #254864992252: Tournament #3856223586, $2.45+$2.45+$0.60 USD Hold'em No Limit - Level XIV (800/1600) - 2025/02/14 19:35:51 WET [2025/02/14 14:35:51 ET]
Table '3856223586 110' 8-max Seat #7 is the button
Seat 1: PinguaMito (51234 in chips, $2.45 bounty) 
Seat 2: jim5432 (165329 in chips, $9.77 bounty) 
Seat 3: HENREMAXFREITAS (45736 in chips, $6.11 bounty) 
Seat 4: Yura Est (100714 in chips, $4.28 bounty) 
Seat 5: curacfacu (31554 in chips, $2.45 bounty) 
Seat 6: Kevin12345Mc (80079 in chips, $2.45 bounty) 
Seat 7: mis Yuliya (101207 in chips, $3.67 bounty) 
Seat 8: neilsavage33 (40850 in chips, $2.45 bounty) 
PinguaMito: posts the ante 225
jim5432: posts the ante 225
HENREMAXFREITAS: posts the ante 225
Yura Est: posts the ante 225
curacfacu: posts the ante 225
Kevin12345Mc: posts the ante 225
mis Yuliya: posts the ante 225
neilsavage33: posts the ante 225
neilsavage33: posts small blind 800
PinguaMito: posts big blind 1600
*** HOLE CARDS ***
Dealt to Kevin12345Mc [3d Qh]
jim5432: folds 
HENREMAXFREITAS: calls 1600
Yura Est: folds 
curacfacu: folds 
Kevin12345Mc: folds 
mis Yuliya: folds 
neilsavage33: folds 
PinguaMito: checks 
*** FLOP *** [Ah Tc 3s]
PinguaMito: checks 
HENREMAXFREITAS: bets 1600
PinguaMito: folds 
Uncalled bet (1600) returned to HENREMAXFREITAS
HENREMAXFREITAS collected 5800 from pot
HENREMAXFREITAS: doesn't show hand 
*** SUMMARY ***
Total pot 5800 | Rake 0 
Board [Ah Tc 3s]
Seat 1: PinguaMito (big blind) folded on the Flop
Seat 2: jim5432 folded before Flop (didn't bet)
Seat 3: HENREMAXFREITAS collected (5800)
Seat 4: Yura Est folded before Flop (didn't bet)
Seat 5: curacfacu folded before Flop (didn't bet)
Seat 6: Kevin12345Mc folded before Flop (didn't bet)
Seat 7: mis Yuliya (button) folded before Flop (didn't bet)
Seat 8: neilsavage33 (small blind) folded before Flop



PokerStars Hand #254865000636: Tournament #3856223586, $2.45+$2.45+$0.60 USD Hold'em No Limit - Level XIV (800/1600) - 2025/02/14 19:36:23 WET [2025/02/14 14:36:23 ET]
Table '3856223586 110' 8-max Seat #8 is the button
Seat 1: PinguaMito (49409 in chips, $2.45 bounty) 
Seat 2: jim5432 (165104 in chips, $9.77 bounty) 
Seat 3: HENREMAXFREITAS (49711 in chips, $6.11 bounty) 
Seat 4: Yura Est (100489 in chips, $4.28 bounty) 
Seat 5: curacfacu (31329 in chips, $2.45 bounty) 
Seat 6: Kevin12345Mc (79854 in chips, $2.45 bounty) 
Seat 7: mis Yuliya (100982 in chips, $3.67 bounty) 
Seat 8: neilsavage33 (39825 in chips, $2.45 bounty) 
PinguaMito: posts the ante 225
jim5432: posts the ante 225
HENREMAXFREITAS: posts the ante 225
Yura Est: posts the ante 225
curacfacu: posts the ante 225
Kevin12345Mc: posts the ante 225
mis Yuliya: posts the ante 225
neilsavage33: posts the ante 225
PinguaMito: posts small blind 800
jim5432: posts big blind 1600
*** HOLE CARDS ***
Dealt to Kevin12345Mc [6c 2s]
HENREMAXFREITAS: folds 
Yura Est: folds 
curacfacu: raises 1600 to 3200
Kevin12345Mc: folds 
mis Yuliya: folds 
neilsavage33: calls 3200
PinguaMito: folds 
jim5432: calls 1600
*** FLOP *** [2c Qd 4h]
jim5432: checks 
curacfacu: checks 
neilsavage33: bets 36400 and is all-in
jim5432: folds 
curacfacu: calls 27904 and is all-in
Uncalled bet (8496) returned to neilsavage33
*** TURN *** [2c Qd 4h] [Ks]
*** RIVER *** [2c Qd 4h Ks] [Ah]
*** SHOW DOWN ***
curacfacu: shows [Ad Qs] (two pair, Aces and Queens)
neilsavage33: shows [Js Qh] (a pair of Queens)
curacfacu collected 68008 from pot
*** SUMMARY ***
Total pot 68008 | Rake 0 
Board [2c Qd 4h Ks Ah]
Seat 1: PinguaMito (small blind) folded before Flop
Seat 2: jim5432 (big blind) folded on the Flop
Seat 3: HENREMAXFREITAS folded before Flop (didn't bet)
Seat 4: Yura Est folded before Flop (didn't bet)
Seat 5: curacfacu showed [Ad Qs] and won (68008) with two pair, Aces and Queens
Seat 6: Kevin12345Mc folded before Flop (didn't bet)
Seat 7: mis Yuliya folded before Flop (didn't bet)
Seat 8: neilsavage33 (button) showed [Js Qh] and lost with a pair of Queens



PokerStars Hand #254865013412: Tournament #3856223586, $2.45+$2.45+$0.60 USD Hold'em No Limit - Level XV (900/1800) - 2025/02/14 19:37:11 WET [2025/02/14 14:37:11 ET]
Table '3856223586 110' 8-max Seat #1 is the button
Seat 1: PinguaMito (48384 in chips, $2.45 bounty) 
Seat 2: jim5432 (161679 in chips, $9.77 bounty) 
Seat 3: HENREMAXFREITAS (49486 in chips, $6.11 bounty) 
Seat 4: Yura Est (100264 in chips, $4.28 bounty) 
Seat 5: curacfacu (68008 in chips, $2.45 bounty) 
Seat 6: Kevin12345Mc (79629 in chips, $2.45 bounty) 
Seat 7: mis Yuliya (100757 in chips, $3.67 bounty) 
Seat 8: neilsavage33 (8496 in chips, $2.45 bounty) 
PinguaMito: posts the ante 250
jim5432: posts the ante 250
HENREMAXFREITAS: posts the ante 250
Yura Est: posts the ante 250
curacfacu: posts the ante 250
Kevin12345Mc: posts the ante 250
mis Yuliya: posts the ante 250
neilsavage33: posts the ante 250
jim5432: posts small blind 900
HENREMAXFREITAS: posts big blind 1800
*** HOLE CARDS ***
Dealt to Kevin12345Mc [Qh 2h]
Yura Est: folds 
curacfacu: folds 
Kevin12345Mc: folds 
mis Yuliya: folds 
neilsavage33: raises 6446 to 8246 and is all-in
PinguaMito: calls 8246
jim5432: folds 
HENREMAXFREITAS: folds 
*** FLOP *** [3c 3h Ad]
*** TURN *** [3c 3h Ad] [4h]
*** RIVER *** [3c 3h Ad 4h] [8h]
*** SHOW DOWN ***
neilsavage33: shows [8s Ks] (two pair, Eights and Threes)
PinguaMito: shows [5h Ah] (a flush, Ace high)
PinguaMito collected 21192 from pot
PinguaMito wins $1.23 for eliminating neilsavage33 and their own bounty increases by $1.22 to $3.67
neilsavage33 finished the tournament in 1246th place
*** SUMMARY ***
Total pot 21192 | Rake 0 
Board [3c 3h Ad 4h 8h]
Seat 1: PinguaMito (button) showed [5h Ah] and won (21192) with a flush, Ace high
Seat 2: jim5432 (small blind) folded before Flop
Seat 3: HENREMAXFREITAS (big blind) folded before Flop
Seat 4: Yura Est folded before Flop (didn't bet)
Seat 5: curacfacu folded before Flop (didn't bet)
Seat 6: Kevin12345Mc folded before Flop (didn't bet)
Seat 7: mis Yuliya folded before Flop (didn't bet)
Seat 8: neilsavage33 showed [8s Ks] and lost with two pair, Eights and Threes



PokerStars Hand #254865021134: Tournament #3856223586, $2.45+$2.45+$0.60 USD Hold'em No Limit - Level XV (900/1800) - 2025/02/14 19:37:41 WET [2025/02/14 14:37:41 ET]
Table '3856223586 110' 8-max Seat #2 is the button
Seat 1: PinguaMito (61080 in chips, $3.67 bounty) 
Seat 2: jim5432 (160529 in chips, $9.77 bounty) 
Seat 3: HENREMAXFREITAS (47436 in chips, $6.11 bounty) 
Seat 4: Yura Est (100014 in chips, $4.28 bounty) 
Seat 5: curacfacu (67758 in chips, $2.45 bounty) 
Seat 6: Kevin12345Mc (79379 in chips, $2.45 bounty) 
Seat 7: mis Yuliya (100507 in chips, $3.67 bounty) 
PinguaMito: posts the ante 250
jim5432: posts the ante 250
HENREMAXFREITAS: posts the ante 250
Yura Est: posts the ante 250
curacfacu: posts the ante 250
Kevin12345Mc: posts the ante 250
mis Yuliya: posts the ante 250
HENREMAXFREITAS: posts small blind 900
Yura Est: posts big blind 1800
*** HOLE CARDS ***
Dealt to Kevin12345Mc [Jd 5c]
curacfacu: folds 
u.andrei.md is disconnected 
Kevin12345Mc: folds 
mis Yuliya: folds 
PinguaMito: raises 1800 to 3600
jim5432: folds 
HENREMAXFREITAS: folds 
Yura Est: folds 
Uncalled bet (1800) returned to PinguaMito
PinguaMito collected 6250 from pot
PinguaMito: doesn't show hand 
*** SUMMARY ***
Total pot 6250 | Rake 0 
Seat 1: PinguaMito collected (6250)
Seat 2: jim5432 (button) folded before Flop (didn't bet)
Seat 3: HENREMAXFREITAS (small blind) folded before Flop
Seat 4: Yura Est (big blind) folded before Flop
Seat 5: curacfacu folded before Flop (didn't bet)
Seat 6: Kevin12345Mc folded before Flop (didn't bet)
Seat 7: mis Yuliya folded before Flop (didn't bet)



PokerStars Hand #254865031490: Tournament #3856223586, $2.45+$2.45+$0.60 USD Hold'em No Limit - Level XV (900/1800) - 2025/02/14 19:38:20 WET [2025/02/14 14:38:20 ET]
Table '3856223586 110' 8-max Seat #3 is the button
Seat 1: PinguaMito (65280 in chips, $3.67 bounty) 
Seat 2: jim5432 (160279 in chips, $9.77 bounty) 
Seat 3: HENREMAXFREITAS (46286 in chips, $6.11 bounty) 
Seat 4: Yura Est (97964 in chips, $4.28 bounty) 
Seat 5: curacfacu (67508 in chips, $2.45 bounty) 
Seat 6: Kevin12345Mc (79129 in chips, $2.45 bounty) 
Seat 7: mis Yuliya (100257 in chips, $3.67 bounty) 
Seat 8: u.andrei.md (26793 in chips, $4.89 bounty) 
PinguaMito: posts the ante 250
jim5432: posts the ante 250
HENREMAXFREITAS: posts the ante 250
Yura Est: posts the ante 250
curacfacu: posts the ante 250
Kevin12345Mc: posts the ante 250
mis Yuliya: posts the ante 250
u.andrei.md: posts the ante 250
Yura Est: posts small blind 900
curacfacu: posts big blind 1800
*** HOLE CARDS ***
Dealt to Kevin12345Mc [4h 7h]
Kevin12345Mc: folds 
mis Yuliya: folds 
u.andrei.md: folds 
PinguaMito: folds 
jim5432: raises 1800 to 3600
HENREMAXFREITAS: folds 
Yura Est: folds 
curacfacu: calls 1800
*** FLOP *** [6s 7d 8h]
curacfacu: bets 3600
jim5432: calls 3600
*** TURN *** [6s 7d 8h] [3c]
curacfacu: bets 8650
jim5432: calls 8650
*** RIVER *** [6s 7d 8h 3c] [As]
curacfacu: bets 3600
jim5432: calls 3600
*** SHOW DOWN ***
curacfacu: shows [7s Jd] (a pair of Sevens)
jim5432: shows [5h Ah] (a pair of Aces)
jim5432 collected 41800 from pot
*** SUMMARY ***
Total pot 41800 | Rake 0 
Board [6s 7d 8h 3c As]
Seat 1: PinguaMito folded before Flop (didn't bet)
Seat 2: jim5432 showed [5h Ah] and won (41800) with a pair of Aces
Seat 3: HENREMAXFREITAS (button) folded before Flop (didn't bet)
Seat 4: Yura Est (small blind) folded before Flop
Seat 5: curacfacu (big blind) showed [7s Jd] and lost with a pair of Sevens
Seat 6: Kevin12345Mc folded before Flop (didn't bet)
Seat 7: mis Yuliya folded before Flop (didn't bet)
Seat 8: u.andrei.md folded before Flop (didn't bet)



PokerStars Hand #254865046268: Tournament #3856223586, $2.45+$2.45+$0.60 USD Hold'em No Limit - Level XV (900/1800) - 2025/02/14 19:39:15 WET [2025/02/14 14:39:15 ET]
Table '3856223586 110' 8-max Seat #4 is the button
Seat 1: PinguaMito (65030 in chips, $3.67 bounty) 
Seat 2: jim5432 (182379 in chips, $9.77 bounty) 
Seat 3: HENREMAXFREITAS (46036 in chips, $6.11 bounty) 
Seat 4: Yura Est (96814 in chips, $4.28 bounty) 
Seat 5: curacfacu (47808 in chips, $2.45 bounty) 
Seat 6: Kevin12345Mc (78879 in chips, $2.45 bounty) 
Seat 7: mis Yuliya (100007 in chips, $3.67 bounty) 
Seat 8: u.andrei.md (26543 in chips, $4.89 bounty) 
PinguaMito: posts the ante 250
jim5432: posts the ante 250
HENREMAXFREITAS: posts the ante 250
Yura Est: posts the ante 250
curacfacu: posts the ante 250
Kevin12345Mc: posts the ante 250
mis Yuliya: posts the ante 250
u.andrei.md: posts the ante 250
curacfacu: posts small blind 900
Kevin12345Mc: posts big blind 1800
*** HOLE CARDS ***
Dealt to Kevin12345Mc [3d 5c]
mis Yuliya: folds 
u.andrei.md: folds 
PinguaMito: folds 
jim5432: folds 
HENREMAXFREITAS: folds 
Yura Est: raises 1800 to 3600
curacfacu: folds 
Kevin12345Mc: folds 
Uncalled bet (1800) returned to Yura Est
Yura Est collected 6500 from pot
Yura Est: doesn't show hand 
*** SUMMARY ***
Total pot 6500 | Rake 0 
Seat 1: PinguaMito folded before Flop (didn't bet)
Seat 2: jim5432 folded before Flop (didn't bet)
Seat 3: HENREMAXFREITAS folded before Flop (didn't bet)
Seat 4: Yura Est (button) collected (6500)
Seat 5: curacfacu (small blind) folded before Flop
Seat 6: Kevin12345Mc (big blind) folded before Flop
Seat 7: mis Yuliya folded before Flop (didn't bet)
Seat 8: u.andrei.md folded before Flop (didn't bet)



PokerStars Hand #254865051844: Tournament #3856223586, $2.45+$2.45+$0.60 USD Hold'em No Limit - Level XV (900/1800) - 2025/02/14 19:39:36 WET [2025/02/14 14:39:36 ET]
Table '3856223586 110' 8-max Seat #5 is the button
Seat 1: PinguaMito (64780 in chips, $3.67 bounty) 
Seat 2: jim5432 (182129 in chips, $9.77 bounty) 
Seat 3: HENREMAXFREITAS (45786 in chips, $6.11 bounty) 
Seat 4: Yura Est (101264 in chips, $4.28 bounty) 
Seat 5: curacfacu (46658 in chips, $2.45 bounty) 
Seat 6: Kevin12345Mc (76829 in chips, $2.45 bounty) 
Seat 7: mis Yuliya (99757 in chips, $3.67 bounty) 
Seat 8: u.andrei.md (26293 in chips, $4.89 bounty) 
PinguaMito: posts the ante 250
jim5432: posts the ante 250
HENREMAXFREITAS: posts the ante 250
Yura Est: posts the ante 250
curacfacu: posts the ante 250
Kevin12345Mc: posts the ante 250
mis Yuliya: posts the ante 250
u.andrei.md: posts the ante 250
Kevin12345Mc: posts small blind 900
mis Yuliya: posts big blind 1800
*** HOLE CARDS ***
Dealt to Kevin12345Mc [As 9s]
u.andrei.md: folds 
PinguaMito: folds 
jim5432: raises 1800 to 3600
HENREMAXFREITAS: folds 
Yura Est: folds 
curacfacu: folds 
Kevin12345Mc: calls 2700
mis Yuliya: folds 
*** FLOP *** [9h Jh 8d]
Kevin12345Mc: checks 
jim5432: bets 3600
Kevin12345Mc: calls 3600
*** TURN *** [9h Jh 8d] [Ac]
Kevin12345Mc: checks 
jim5432: bets 9000
Kevin12345Mc: calls 9000
*** RIVER *** [9h Jh 8d Ac] [5h]
Kevin12345Mc: checks 
jim5432: checks 
*** SHOW DOWN ***
Kevin12345Mc: shows [As 9s] (two pair, Aces and Nines)
jim5432: mucks hand 
Kevin12345Mc collected 36200 from pot
*** SUMMARY ***
Total pot 36200 | Rake 0 
Board [9h Jh 8d Ac 5h]
Seat 1: PinguaMito folded before Flop (didn't bet)
Seat 2: jim5432 mucked [8s Qd]
Seat 3: HENREMAXFREITAS folded before Flop (didn't bet)
Seat 4: Yura Est folded before Flop (didn't bet)
Seat 5: curacfacu (button) folded before Flop (didn't bet)
Seat 6: Kevin12345Mc (small blind) showed [As 9s] and won (36200) with two pair, Aces and Nines
Seat 7: mis Yuliya (big blind) folded before Flop
Seat 8: u.andrei.md folded before Flop (didn't bet)



PokerStars Hand #254865063872: Tournament #3856223586, $2.45+$2.45+$0.60 USD Hold'em No Limit - Level XV (900/1800) - 2025/02/14 19:40:21 WET [2025/02/14 14:40:21 ET]
Table '3856223586 110' 8-max Seat #6 is the button
Seat 1: PinguaMito (64530 in chips, $3.67 bounty) 
Seat 2: jim5432 (165679 in chips, $9.77 bounty) 
Seat 3: HENREMAXFREITAS (45536 in chips, $6.11 bounty) 
Seat 4: Yura Est (101014 in chips, $4.28 bounty) 
Seat 5: curacfacu (46408 in chips, $2.45 bounty) 
Seat 6: Kevin12345Mc (96579 in chips, $2.45 bounty) 
Seat 7: mis Yuliya (97707 in chips, $3.67 bounty) 
Seat 8: u.andrei.md (26043 in chips, $4.89 bounty) 
PinguaMito: posts the ante 250
jim5432: posts the ante 250
HENREMAXFREITAS: posts the ante 250
Yura Est: posts the ante 250
curacfacu: posts the ante 250
Kevin12345Mc: posts the ante 250
mis Yuliya: posts the ante 250
u.andrei.md: posts the ante 250
mis Yuliya: posts small blind 900
u.andrei.md: posts big blind 1800
*** HOLE CARDS ***
Dealt to Kevin12345Mc [Tc 8d]
PinguaMito: folds 
jim5432: folds 
HENREMAXFREITAS: folds 
Yura Est: raises 1800 to 3600
curacfacu: calls 3600
Kevin12345Mc: folds 
mis Yuliya: folds 
u.andrei.md: folds 
*** FLOP *** [2c 9d Jh]
Yura Est: bets 5950
curacfacu: raises 8450 to 14400
Yura Est: raises 32153 to 46553
curacfacu: calls 28158 and is all-in
Uncalled bet (3995) returned to Yura Est
*** TURN *** [2c 9d Jh] [2d]
*** RIVER *** [2c 9d Jh 2d] [Qh]
*** SHOW DOWN ***
Yura Est: shows [Kh Kc] (two pair, Kings and Deuces)
curacfacu: shows [Kd Jd] (two pair, Jacks and Deuces)
Yura Est collected 97016 from pot
Yura Est wins $1.23 for eliminating curacfacu and their own bounty increases by $1.22 to $5.50
curacfacu finished the tournament in 1160th place
*** SUMMARY ***
Total pot 97016 | Rake 0 
Board [2c 9d Jh 2d Qh]
Seat 1: PinguaMito folded before Flop (didn't bet)
Seat 2: jim5432 folded before Flop (didn't bet)
Seat 3: HENREMAXFREITAS folded before Flop (didn't bet)
Seat 4: Yura Est showed [Kh Kc] and won (97016) with two pair, Kings and Deuces
Seat 5: curacfacu showed [Kd Jd] and lost with two pair, Jacks and Deuces
Seat 6: Kevin12345Mc (button) folded before Flop (didn't bet)
Seat 7: mis Yuliya (small blind) folded before Flop
Seat 8: u.andrei.md (big blind) folded before Flop



PokerStars Hand #254865078713: Tournament #3856223586, $2.45+$2.45+$0.60 USD Hold'em No Limit - Level XV (900/1800) - 2025/02/14 19:41:17 WET [2025/02/14 14:41:17 ET]
Table '3856223586 110' 8-max Seat #7 is the button
Seat 1: PinguaMito (64280 in chips, $3.67 bounty) 
Seat 2: jim5432 (165429 in chips, $9.77 bounty) 
Seat 3: HENREMAXFREITAS (45286 in chips, $6.11 bounty) 
Seat 4: Yura Est (151622 in chips, $5.50 bounty) 
Seat 6: Kevin12345Mc (96329 in chips, $2.45 bounty) 
Seat 7: mis Yuliya (96557 in chips, $3.67 bounty) 
Seat 8: u.andrei.md (23993 in chips, $4.89 bounty) 
PinguaMito: posts the ante 250
jim5432: posts the ante 250
HENREMAXFREITAS: posts the ante 250
Yura Est: posts the ante 250
Kevin12345Mc: posts the ante 250
mis Yuliya: posts the ante 250
u.andrei.md: posts the ante 250
u.andrei.md: posts small blind 900
PinguaMito: posts big blind 1800
*** HOLE CARDS ***
Dealt to Kevin12345Mc [9d 7h]
jim5432: raises 1800 to 3600
HENREMAXFREITAS: folds 
Yura Est: folds 
Kevin12345Mc: folds 
mis Yuliya: folds 
u.andrei.md: folds 
PinguaMito: folds 
Uncalled bet (1800) returned to jim5432
jim5432 collected 6250 from pot
jim5432: doesn't show hand 
*** SUMMARY ***
Total pot 6250 | Rake 0 
Seat 1: PinguaMito (big blind) folded before Flop
Seat 2: jim5432 collected (6250)
Seat 3: HENREMAXFREITAS folded before Flop (didn't bet)
Seat 4: Yura Est folded before Flop (didn't bet)
Seat 6: Kevin12345Mc folded before Flop (didn't bet)
Seat 7: mis Yuliya (button) folded before Flop (didn't bet)
Seat 8: u.andrei.md (small blind) folded before Flop



PokerStars Hand #254865084978: Tournament #3856223586, $2.45+$2.45+$0.60 USD Hold'em No Limit - Level XV (900/1800) - 2025/02/14 19:41:40 WET [2025/02/14 14:41:40 ET]
Table '3856223586 110' 8-max Seat #8 is the button
Seat 1: PinguaMito (62230 in chips, $3.67 bounty) 
Seat 2: jim5432 (169629 in chips, $9.77 bounty) 
Seat 3: HENREMAXFREITAS (45036 in chips, $6.11 bounty) 
Seat 4: Yura Est (151372 in chips, $5.50 bounty) 
Seat 6: Kevin12345Mc (96079 in chips, $2.45 bounty) 
Seat 7: mis Yuliya (96307 in chips, $3.67 bounty) 
Seat 8: u.andrei.md (22843 in chips, $4.89 bounty) 
PinguaMito: posts the ante 250
jim5432: posts the ante 250
HENREMAXFREITAS: posts the ante 250
Yura Est: posts the ante 250
Kevin12345Mc: posts the ante 250
mis Yuliya: posts the ante 250
u.andrei.md: posts the ante 250
PinguaMito: posts small blind 900
jim5432: posts big blind 1800
*** HOLE CARDS ***
Dealt to Kevin12345Mc [4s 5s]
HENREMAXFREITAS: folds 
dolay127 is disconnected 
Yura Est: folds 
Kevin12345Mc: raises 2340 to 4140
mis Yuliya: folds 
u.andrei.md: raises 18453 to 22593 and is all-in
PinguaMito: folds 
jim5432: folds 
Kevin12345Mc: folds 
Uncalled bet (18453) returned to u.andrei.md
u.andrei.md collected 12730 from pot
u.andrei.md: doesn't show hand 
*** SUMMARY ***
Total pot 12730 | Rake 0 
Seat 1: PinguaMito (small blind) folded before Flop
Seat 2: jim5432 (big blind) folded before Flop
Seat 3: HENREMAXFREITAS folded before Flop (didn't bet)
Seat 4: Yura Est folded before Flop (didn't bet)
Seat 6: Kevin12345Mc folded before Flop
Seat 7: mis Yuliya folded before Flop (didn't bet)
Seat 8: u.andrei.md (button) collected (12730)



PokerStars Hand #254865094933: Tournament #3856223586, $2.45+$2.45+$0.60 USD Hold'em No Limit - Level XV (900/1800) - 2025/02/14 19:42:18 WET [2025/02/14 14:42:18 ET]
Table '3856223586 110' 8-max Seat #1 is the button
Seat 1: PinguaMito (61080 in chips, $3.67 bounty) 
Seat 2: jim5432 (167579 in chips, $9.77 bounty) 
Seat 3: HENREMAXFREITAS (44786 in chips, $6.11 bounty) 
Seat 4: Yura Est (151122 in chips, $5.50 bounty) 
Seat 5: dolay127 (73625 in chips, $4.89 bounty) 
Seat 6: Kevin12345Mc (91689 in chips, $2.45 bounty) 
Seat 7: mis Yuliya (96057 in chips, $3.67 bounty) 
Seat 8: u.andrei.md (31183 in chips, $4.89 bounty) 
PinguaMito: posts the ante 250
jim5432: posts the ante 250
HENREMAXFREITAS: posts the ante 250
Yura Est: posts the ante 250
dolay127: posts the ante 250
Kevin12345Mc: posts the ante 250
mis Yuliya: posts the ante 250
u.andrei.md: posts the ante 250
jim5432: posts small blind 900
HENREMAXFREITAS: posts big blind 1800
*** HOLE CARDS ***
Dealt to Kevin12345Mc [3h 4c]
Yura Est: folds 
dolay127: folds 
Kevin12345Mc: folds 
mis Yuliya: folds 
u.andrei.md: folds 
PinguaMito: folds 
jim5432: raises 1800 to 3600
HENREMAXFREITAS: folds 
Uncalled bet (1800) returned to jim5432
jim5432 collected 5600 from pot
jim5432: doesn't show hand 
*** SUMMARY ***
Total pot 5600 | Rake 0 
Seat 1: PinguaMito (button) folded before Flop (didn't bet)
Seat 2: jim5432 (small blind) collected (5600)
Seat 3: HENREMAXFREITAS (big blind) folded before Flop
Seat 4: Yura Est folded before Flop (didn't bet)
Seat 5: dolay127 folded before Flop (didn't bet)
Seat 6: Kevin12345Mc folded before Flop (didn't bet)
Seat 7: mis Yuliya folded before Flop (didn't bet)
Seat 8: u.andrei.md folded before Flop (didn't bet)



PokerStars Hand #254865100369: Tournament #3856223586, $2.45+$2.45+$0.60 USD Hold'em No Limit - Level XV (900/1800) - 2025/02/14 19:42:39 WET [2025/02/14 14:42:39 ET]
Table '3856223586 110' 8-max Seat #2 is the button
Seat 1: PinguaMito (60830 in chips, $3.67 bounty) 
Seat 2: jim5432 (171129 in chips, $9.77 bounty) 
Seat 3: HENREMAXFREITAS (42736 in chips, $6.11 bounty) 
Seat 4: Yura Est (150872 in chips, $5.50 bounty) 
Seat 5: dolay127 (73375 in chips, $4.89 bounty) 
Seat 6: Kevin12345Mc (91439 in chips, $2.45 bounty) 
Seat 7: mis Yuliya (95807 in chips, $3.67 bounty) 
Seat 8: u.andrei.md (30933 in chips, $4.89 bounty) 
PinguaMito: posts the ante 250
jim5432: posts the ante 250
HENREMAXFREITAS: posts the ante 250
Yura Est: posts the ante 250
dolay127: posts the ante 250
Kevin12345Mc: posts the ante 250
mis Yuliya: posts the ante 250
u.andrei.md: posts the ante 250
HENREMAXFREITAS: posts small blind 900
Yura Est: posts big blind 1800
*** HOLE CARDS ***
Dealt to Kevin12345Mc [Ad Qd]
dolay127: folds 
Kevin12345Mc: raises 2340 to 4140
mis Yuliya: folds 
u.andrei.md: folds 
PinguaMito: folds 
jim5432: calls 4140
HENREMAXFREITAS: folds 
Yura Est: calls 2340
*** FLOP *** [5h Ah 4s]
Yura Est: checks 
Kevin12345Mc: bets 5056
jim5432: calls 5056
Yura Est: calls 5056
*** TURN *** [5h Ah 4s] [Qc]
Yura Est: checks 
Kevin12345Mc: bets 17044
jim5432: folds 
Yura Est: folds 
Uncalled bet (17044) returned to Kevin12345Mc
Kevin12345Mc collected 30488 from pot
Kevin12345Mc: doesn't show hand 
*** SUMMARY ***
Total pot 30488 | Rake 0 
Board [5h Ah 4s Qc]
Seat 1: PinguaMito folded before Flop (didn't bet)
Seat 2: jim5432 (button) folded on the Turn
Seat 3: HENREMAXFREITAS (small blind) folded before Flop
Seat 4: Yura Est (big blind) folded on the Turn
Seat 5: dolay127 folded before Flop (didn't bet)
Seat 6: Kevin12345Mc collected (30488)
Seat 7: mis Yuliya folded before Flop (didn't bet)
Seat 8: u.andrei.md folded before Flop (didn't bet)



PokerStars Hand #254865113376: Tournament #3856223586, $2.45+$2.45+$0.60 USD Hold'em No Limit - Level XV (900/1800) - 2025/02/14 19:43:28 WET [2025/02/14 14:43:28 ET]
Table '3856223586 110' 8-max Seat #3 is the button
Seat 1: PinguaMito (60580 in chips, $3.67 bounty) 
Seat 2: jim5432 (161683 in chips, $9.77 bounty) 
Seat 3: HENREMAXFREITAS (41586 in chips, $6.11 bounty) 
Seat 4: Yura Est (141426 in chips, $5.50 bounty) 
Seat 5: dolay127 (73125 in chips, $4.89 bounty) 
Seat 6: Kevin12345Mc (112481 in chips, $2.45 bounty) 
Seat 7: mis Yuliya (95557 in chips, $3.67 bounty) 
Seat 8: u.andrei.md (30683 in chips, $4.89 bounty) 
PinguaMito: posts the ante 250
jim5432: posts the ante 250
HENREMAXFREITAS: posts the ante 250
Yura Est: posts the ante 250
dolay127: posts the ante 250
Kevin12345Mc: posts the ante 250
mis Yuliya: posts the ante 250
u.andrei.md: posts the ante 250
Yura Est: posts small blind 900
dolay127: posts big blind 1800
*** HOLE CARDS ***
Dealt to Kevin12345Mc [7s 9h]
Kevin12345Mc: folds 
mis Yuliya: calls 1800
u.andrei.md: folds 
PinguaMito: raises 4500 to 6300
jim5432: folds 
HENREMAXFREITAS: folds 
Yura Est: folds 
dolay127: calls 4500
mis Yuliya: folds 
*** FLOP *** [8h Td Qc]
dolay127: checks 
PinguaMito: bets 8131
dolay127: calls 8131
*** TURN *** [8h Td Qc] [Ah]
dolay127: checks 
PinguaMito: checks 
*** RIVER *** [8h Td Qc Ah] [7h]
dolay127: checks 
PinguaMito: checks 
*** SHOW DOWN ***
dolay127: shows [Js Ac] (a pair of Aces)
PinguaMito: mucks hand 
dolay127 collected 33562 from pot
*** SUMMARY ***
Total pot 33562 | Rake 0 
Board [8h Td Qc Ah 7h]
Seat 1: PinguaMito mucked [Kh Kc]
Seat 2: jim5432 folded before Flop (didn't bet)
Seat 3: HENREMAXFREITAS (button) folded before Flop (didn't bet)
Seat 4: Yura Est (small blind) folded before Flop
Seat 5: dolay127 (big blind) showed [Js Ac] and won (33562) with a pair of Aces
Seat 6: Kevin12345Mc folded before Flop (didn't bet)
Seat 7: mis Yuliya folded before Flop
Seat 8: u.andrei.md folded before Flop (didn't bet)



PokerStars Hand #254865126088: Tournament #3856223586, $2.45+$2.45+$0.60 USD Hold'em No Limit - Level XV (900/1800) - 2025/02/14 19:44:16 WET [2025/02/14 14:44:16 ET]
Table '3856223586 110' 8-max Seat #4 is the button
Seat 1: PinguaMito (45899 in chips, $3.67 bounty) 
Seat 2: jim5432 (161433 in chips, $9.77 bounty) 
Seat 3: HENREMAXFREITAS (41336 in chips, $6.11 bounty) 
Seat 4: Yura Est (140276 in chips, $5.50 bounty) 
Seat 5: dolay127 (92006 in chips, $4.89 bounty) 
Seat 6: Kevin12345Mc (112231 in chips, $2.45 bounty) 
Seat 7: mis Yuliya (93507 in chips, $3.67 bounty) 
Seat 8: u.andrei.md (30433 in chips, $4.89 bounty) 
PinguaMito: posts the ante 250
jim5432: posts the ante 250
HENREMAXFREITAS: posts the ante 250
Yura Est: posts the ante 250
dolay127: posts the ante 250
Kevin12345Mc: posts the ante 250
mis Yuliya: posts the ante 250
u.andrei.md: posts the ante 250
dolay127: posts small blind 900
Kevin12345Mc: posts big blind 1800
*** HOLE CARDS ***
Dealt to Kevin12345Mc [Ac Qh]
mis Yuliya: folds 
u.andrei.md: folds 
PinguaMito: raises 1800 to 3600
jim5432: folds 
HENREMAXFREITAS: folds 
Yura Est: folds 
dolay127: folds 
Kevin12345Mc: raises 108381 to 111981 and is all-in
PinguaMito: folds 
Uncalled bet (108381) returned to Kevin12345Mc
Kevin12345Mc collected 10100 from pot
Kevin12345Mc: doesn't show hand 
*** SUMMARY ***
Total pot 10100 | Rake 0 
Seat 1: PinguaMito folded before Flop
Seat 2: jim5432 folded before Flop (didn't bet)
Seat 3: HENREMAXFREITAS folded before Flop (didn't bet)
Seat 4: Yura Est (button) folded before Flop (didn't bet)
Seat 5: dolay127 (small blind) folded before Flop
Seat 6: Kevin12345Mc (big blind) collected (10100)
Seat 7: mis Yuliya folded before Flop (didn't bet)
Seat 8: u.andrei.md folded before Flop (didn't bet)



PokerStars Hand #254865134788: Tournament #3856223586, $2.45+$2.45+$0.60 USD Hold'em No Limit - Level XVI (1000/2000) - 2025/02/14 19:44:49 WET [2025/02/14 14:44:49 ET]
Table '3856223586 110' 8-max Seat #5 is the button
Seat 1: PinguaMito (42049 in chips, $3.67 bounty) 
Seat 2: jim5432 (161183 in chips, $9.77 bounty) 
Seat 3: HENREMAXFREITAS (41086 in chips, $6.11 bounty) 
Seat 4: Yura Est (140026 in chips, $5.50 bounty) 
Seat 5: dolay127 (90856 in chips, $4.89 bounty) 
Seat 6: Kevin12345Mc (118481 in chips, $2.45 bounty) 
Seat 7: mis Yuliya (93257 in chips, $3.67 bounty) 
Seat 8: u.andrei.md (30183 in chips, $4.89 bounty) 
PinguaMito: posts the ante 300
jim5432: posts the ante 300
HENREMAXFREITAS: posts the ante 300
Yura Est: posts the ante 300
dolay127: posts the ante 300
Kevin12345Mc: posts the ante 300
mis Yuliya: posts the ante 300
u.andrei.md: posts the ante 300
Kevin12345Mc: posts small blind 1000
mis Yuliya: posts big blind 2000
*** HOLE CARDS ***
Dealt to Kevin12345Mc [Jh 4s]
u.andrei.md: folds 
PinguaMito: folds 
jim5432: raises 2000 to 4000
HENREMAXFREITAS: folds 
Yura Est: folds 
dolay127: folds 
Kevin12345Mc: folds 
mis Yuliya: calls 2000
*** FLOP *** [2c Qc 3s]
mis Yuliya: checks 
jim5432: bets 5700
mis Yuliya: folds 
Uncalled bet (5700) returned to jim5432
jim5432 collected 11400 from pot
jim5432: doesn't show hand 
*** SUMMARY ***
Total pot 11400 | Rake 0 
Board [2c Qc 3s]
Seat 1: PinguaMito folded before Flop (didn't bet)
Seat 2: jim5432 collected (11400)
Seat 3: HENREMAXFREITAS folded before Flop (didn't bet)
Seat 4: Yura Est folded before Flop (didn't bet)
Seat 5: dolay127 (button) folded before Flop (didn't bet)
Seat 6: Kevin12345Mc (small blind) folded before Flop
Seat 7: mis Yuliya (big blind) folded on the Flop
Seat 8: u.andrei.md folded before Flop (didn't bet)



PokerStars Hand #254865141743: Tournament #3856223586, $2.45+$2.45+$0.60 USD Hold'em No Limit - Level XVI (1000/2000) - 2025/02/14 19:45:16 WET [2025/02/14 14:45:16 ET]
Table '3856223586 110' 8-max Seat #6 is the button
Seat 1: PinguaMito (41749 in chips, $3.67 bounty) 
Seat 2: jim5432 (168283 in chips, $9.77 bounty) 
Seat 3: HENREMAXFREITAS (40786 in chips, $6.11 bounty) 
Seat 4: Yura Est (139726 in chips, $5.50 bounty) 
Seat 5: dolay127 (90556 in chips, $4.89 bounty) 
Seat 6: Kevin12345Mc (117181 in chips, $2.45 bounty) 
Seat 7: mis Yuliya (88957 in chips, $3.67 bounty) 
Seat 8: u.andrei.md (29883 in chips, $4.89 bounty) 
PinguaMito: posts the ante 300
jim5432: posts the ante 300
HENREMAXFREITAS: posts the ante 300
Yura Est: posts the ante 300
dolay127: posts the ante 300
Kevin12345Mc: posts the ante 300
mis Yuliya: posts the ante 300
u.andrei.md: posts the ante 300
mis Yuliya: posts small blind 1000
u.andrei.md: posts big blind 2000
*** HOLE CARDS ***
Dealt to Kevin12345Mc [Jh Kc]
PinguaMito: folds 
jim5432: folds 
HENREMAXFREITAS: folds 
Yura Est: folds 
dolay127: folds 
Kevin12345Mc: raises 2600 to 4600
mis Yuliya: folds 
u.andrei.md: folds 
Uncalled bet (2600) returned to Kevin12345Mc
Kevin12345Mc collected 7400 from pot
Kevin12345Mc: doesn't show hand 
*** SUMMARY ***
Total pot 7400 | Rake 0 
Seat 1: PinguaMito folded before Flop (didn't bet)
Seat 2: jim5432 folded before Flop (didn't bet)
Seat 3: HENREMAXFREITAS folded before Flop (didn't bet)
Seat 4: Yura Est folded before Flop (didn't bet)
Seat 5: dolay127 folded before Flop (didn't bet)
Seat 6: Kevin12345Mc (button) collected (7400)
Seat 7: mis Yuliya (small blind) folded before Flop
Seat 8: u.andrei.md (big blind) folded before Flop



PokerStars Hand #254865147326: Tournament #3856223586, $2.45+$2.45+$0.60 USD Hold'em No Limit - Level XVI (1000/2000) - 2025/02/14 19:45:37 WET [2025/02/14 14:45:37 ET]
Table '3856223586 110' 8-max Seat #7 is the button
Seat 1: PinguaMito (41449 in chips, $3.67 bounty) 
Seat 2: jim5432 (167983 in chips, $9.77 bounty) 
Seat 3: HENREMAXFREITAS (40486 in chips, $6.11 bounty) 
Seat 4: Yura Est (139426 in chips, $5.50 bounty) 
Seat 5: dolay127 (90256 in chips, $4.89 bounty) 
Seat 6: Kevin12345Mc (122281 in chips, $2.45 bounty) 
Seat 7: mis Yuliya (87657 in chips, $3.67 bounty) 
Seat 8: u.andrei.md (27583 in chips, $4.89 bounty) 
PinguaMito: posts the ante 300
jim5432: posts the ante 300
HENREMAXFREITAS: posts the ante 300
Yura Est: posts the ante 300
dolay127: posts the ante 300
Kevin12345Mc: posts the ante 300
mis Yuliya: posts the ante 300
u.andrei.md: posts the ante 300
u.andrei.md: posts small blind 1000
PinguaMito: posts big blind 2000
*** HOLE CARDS ***
Dealt to Kevin12345Mc [Kc 9s]
jim5432: folds 
HENREMAXFREITAS: folds 
Yura Est: folds 
dolay127: folds 
Kevin12345Mc: raises 2600 to 4600
mis Yuliya: folds 
u.andrei.md: folds 
PinguaMito: raises 7400 to 12000
Kevin12345Mc: folds 
Uncalled bet (7400) returned to PinguaMito
PinguaMito collected 12600 from pot
PinguaMito: doesn't show hand 
*** SUMMARY ***
Total pot 12600 | Rake 0 
Seat 1: PinguaMito (big blind) collected (12600)
Seat 2: jim5432 folded before Flop (didn't bet)
Seat 3: HENREMAXFREITAS folded before Flop (didn't bet)
Seat 4: Yura Est folded before Flop (didn't bet)
Seat 5: dolay127 folded before Flop (didn't bet)
Seat 6: Kevin12345Mc folded before Flop
Seat 7: mis Yuliya (button) folded before Flop (didn't bet)
Seat 8: u.andrei.md (small blind) folded before Flop



PokerStars Hand #254865154996: Tournament #3856223586, $2.45+$2.45+$0.60 USD Hold'em No Limit - Level XVI (1000/2000) - 2025/02/14 19:46:07 WET [2025/02/14 14:46:07 ET]
Table '3856223586 110' 8-max Seat #8 is the button
Seat 1: PinguaMito (49149 in chips, $3.67 bounty) 
Seat 2: jim5432 (167683 in chips, $9.77 bounty) 
Seat 3: HENREMAXFREITAS (40186 in chips, $6.11 bounty) 
Seat 4: Yura Est (139126 in chips, $5.50 bounty) 
Seat 5: dolay127 (89956 in chips, $4.89 bounty) 
Seat 6: Kevin12345Mc (117381 in chips, $2.45 bounty) 
Seat 7: mis Yuliya (87357 in chips, $3.67 bounty) 
Seat 8: u.andrei.md (26283 in chips, $4.89 bounty) 
PinguaMito: posts the ante 300
jim5432: posts the ante 300
HENREMAXFREITAS: posts the ante 300
Yura Est: posts the ante 300
dolay127: posts the ante 300
Kevin12345Mc: posts the ante 300
mis Yuliya: posts the ante 300
u.andrei.md: posts the ante 300
PinguaMito: posts small blind 1000
jim5432: posts big blind 2000
*** HOLE CARDS ***
Dealt to Kevin12345Mc [8c Js]
HENREMAXFREITAS: folds 
Yura Est: folds 
dolay127: raises 2000 to 4000
Kevin12345Mc: folds 
mis Yuliya: folds 
u.andrei.md: folds 
PinguaMito: folds 
jim5432: calls 2000
*** FLOP *** [Jd Tc 7h]
jim5432: checks 
dolay127: checks 
*** TURN *** [Jd Tc 7h] [2c]
jim5432: bets 11400
dolay127: folds 
Uncalled bet (11400) returned to jim5432
jim5432 collected 11400 from pot
jim5432: doesn't show hand 
*** SUMMARY ***
Total pot 11400 | Rake 0 
Board [Jd Tc 7h 2c]
Seat 1: PinguaMito (small blind) folded before Flop
Seat 2: jim5432 (big blind) collected (11400)
Seat 3: HENREMAXFREITAS folded before Flop (didn't bet)
Seat 4: Yura Est folded before Flop (didn't bet)
Seat 5: dolay127 folded on the Turn
Seat 6: Kevin12345Mc folded before Flop (didn't bet)
Seat 7: mis Yuliya folded before Flop (didn't bet)
Seat 8: u.andrei.md (button) folded before Flop (didn't bet)



PokerStars Hand #254865165668: Tournament #3856223586, $2.45+$2.45+$0.60 USD Hold'em No Limit - Level XVI (1000/2000) - 2025/02/14 19:46:47 WET [2025/02/14 14:46:47 ET]
Table '3856223586 110' 8-max Seat #1 is the button
Seat 1: PinguaMito (47849 in chips, $3.67 bounty) 
Seat 2: jim5432 (174783 in chips, $9.77 bounty) 
Seat 3: HENREMAXFREITAS (39886 in chips, $6.11 bounty) 
Seat 4: Yura Est (138826 in chips, $5.50 bounty) 
Seat 5: dolay127 (85656 in chips, $4.89 bounty) 
Seat 6: Kevin12345Mc (117081 in chips, $2.45 bounty) 
Seat 7: mis Yuliya (87057 in chips, $3.67 bounty) 
Seat 8: u.andrei.md (25983 in chips, $4.89 bounty) 
PinguaMito: posts the ante 300
jim5432: posts the ante 300
HENREMAXFREITAS: posts the ante 300
Yura Est: posts the ante 300
dolay127: posts the ante 300
Kevin12345Mc: posts the ante 300
mis Yuliya: posts the ante 300
u.andrei.md: posts the ante 300
jim5432: posts small blind 1000
HENREMAXFREITAS: posts big blind 2000
*** HOLE CARDS ***
Dealt to Kevin12345Mc [7d Jc]
Yura Est: folds 
dolay127: raises 2000 to 4000
Kevin12345Mc: folds 
mis Yuliya: folds 
u.andrei.md: folds 
PinguaMito: folds 
jim5432: calls 3000
HENREMAXFREITAS: calls 2000
*** FLOP *** [8s 9d 5s]
jim5432: checks 
HENREMAXFREITAS: checks 
dolay127: checks 
*** TURN *** [8s 9d 5s] [Kh]
jim5432: checks 
HENREMAXFREITAS: checks 
dolay127: checks 
*** RIVER *** [8s 9d 5s Kh] [9s]
jim5432: bets 11200
HENREMAXFREITAS: folds 
dolay127: folds 
Uncalled bet (11200) returned to jim5432
jim5432 collected 14400 from pot
jim5432: doesn't show hand 
*** SUMMARY ***
Total pot 14400 | Rake 0 
Board [8s 9d 5s Kh 9s]
Seat 1: PinguaMito (button) folded before Flop (didn't bet)
Seat 2: jim5432 (small blind) collected (14400)
Seat 3: HENREMAXFREITAS (big blind) folded on the River
Seat 4: Yura Est folded before Flop (didn't bet)
Seat 5: dolay127 folded on the River
Seat 6: Kevin12345Mc folded before Flop (didn't bet)
Seat 7: mis Yuliya folded before Flop (didn't bet)
Seat 8: u.andrei.md folded before Flop (didn't bet)



PokerStars Hand #254865183552: Tournament #3856223586, $2.45+$2.45+$0.60 USD Hold'em No Limit - Level XVI (1000/2000) - 2025/02/14 19:47:55 WET [2025/02/14 14:47:55 ET]
Table '3856223586 110' 8-max Seat #2 is the button
Seat 1: PinguaMito (47549 in chips, $3.67 bounty) 
Seat 2: jim5432 (184883 in chips, $9.77 bounty) 
Seat 3: HENREMAXFREITAS (35586 in chips, $6.11 bounty) 
Seat 4: Yura Est (138526 in chips, $5.50 bounty) 
Seat 5: dolay127 (81356 in chips, $4.89 bounty) 
Seat 6: Kevin12345Mc (116781 in chips, $2.45 bounty) 
Seat 7: mis Yuliya (86757 in chips, $3.67 bounty) 
Seat 8: u.andrei.md (25683 in chips, $4.89 bounty) 
PinguaMito: posts the ante 300
jim5432: posts the ante 300
HENREMAXFREITAS: posts the ante 300
Yura Est: posts the ante 300
dolay127: posts the ante 300
Kevin12345Mc: posts the ante 300
mis Yuliya: posts the ante 300
u.andrei.md: posts the ante 300
HENREMAXFREITAS: posts small blind 1000
Yura Est: posts big blind 2000
*** HOLE CARDS ***
Dealt to Kevin12345Mc [Jd Js]
dolay127: folds 
Kevin12345Mc: raises 2600 to 4600
mis Yuliya: folds 
u.andrei.md: folds 
PinguaMito: folds 
jim5432: folds 
HENREMAXFREITAS: folds 
Yura Est: folds 
Uncalled bet (2600) returned to Kevin12345Mc
Kevin12345Mc collected 7400 from pot
Kevin12345Mc: doesn't show hand 
*** SUMMARY ***
Total pot 7400 | Rake 0 
Seat 1: PinguaMito folded before Flop (didn't bet)
Seat 2: jim5432 (button) folded before Flop (didn't bet)
Seat 3: HENREMAXFREITAS (small blind) folded before Flop
Seat 4: Yura Est (big blind) folded before Flop
Seat 5: dolay127 folded before Flop (didn't bet)
Seat 6: Kevin12345Mc collected (7400)
Seat 7: mis Yuliya folded before Flop (didn't bet)
Seat 8: u.andrei.md folded before Flop (didn't bet)



PokerStars Hand #254865194705: Tournament #3856223586, $2.45+$2.45+$0.60 USD Hold'em No Limit - Level XVI (1000/2000) - 2025/02/14 19:48:36 WET [2025/02/14 14:48:36 ET]
Table '3856223586 110' 8-max Seat #3 is the button
Seat 1: PinguaMito (47249 in chips, $3.67 bounty) 
Seat 2: jim5432 (184583 in chips, $9.77 bounty) 
Seat 3: HENREMAXFREITAS (34286 in chips, $6.11 bounty) 
Seat 4: Yura Est (136226 in chips, $5.50 bounty) 
Seat 5: dolay127 (81056 in chips, $4.89 bounty) 
Seat 6: Kevin12345Mc (121881 in chips, $2.45 bounty) 
Seat 7: mis Yuliya (86457 in chips, $3.67 bounty) 
Seat 8: u.andrei.md (25383 in chips, $4.89 bounty) 
PinguaMito: posts the ante 300
jim5432: posts the ante 300
HENREMAXFREITAS: posts the ante 300
Yura Est: posts the ante 300
dolay127: posts the ante 300
Kevin12345Mc: posts the ante 300
mis Yuliya: posts the ante 300
u.andrei.md: posts the ante 300
Yura Est: posts small blind 1000
dolay127: posts big blind 2000
*** HOLE CARDS ***
Dealt to Kevin12345Mc [7h 7s]
Kevin12345Mc: raises 2600 to 4600
mis Yuliya: folds 
u.andrei.md: folds 
PinguaMito: folds 
jim5432: calls 4600
HENREMAXFREITAS: folds 
Yura Est: folds 
dolay127: folds 
*** FLOP *** [Kh 9c Ks]
Kevin12345Mc: bets 4818
jim5432: calls 4818
*** TURN *** [Kh 9c Ks] [2h]
Kevin12345Mc: bets 7998
jim5432: folds 
Uncalled bet (7998) returned to Kevin12345Mc
Kevin12345Mc collected 24236 from pot
Kevin12345Mc: doesn't show hand 
*** SUMMARY ***
Total pot 24236 | Rake 0 
Board [Kh 9c Ks 2h]
Seat 1: PinguaMito folded before Flop (didn't bet)
Seat 2: jim5432 folded on the Turn
Seat 3: HENREMAXFREITAS (button) folded before Flop (didn't bet)
Seat 4: Yura Est (small blind) folded before Flop
Seat 5: dolay127 (big blind) folded before Flop
Seat 6: Kevin12345Mc collected (24236)
Seat 7: mis Yuliya folded before Flop (didn't bet)
Seat 8: u.andrei.md folded before Flop (didn't bet)



PokerStars Hand #254865207036: Tournament #3856223586, $2.45+$2.45+$0.60 USD Hold'em No Limit - Level XVI (1000/2000) - 2025/02/14 19:49:23 WET [2025/02/14 14:49:23 ET]
Table '3856223586 110' 8-max Seat #4 is the button
Seat 1: PinguaMito (46949 in chips, $3.67 bounty) 
Seat 2: jim5432 (174865 in chips, $9.77 bounty) 
Seat 3: HENREMAXFREITAS (33986 in chips, $6.11 bounty) 
Seat 4: Yura Est (134926 in chips, $5.50 bounty) 
Seat 5: dolay127 (78756 in chips, $4.89 bounty) 
Seat 6: Kevin12345Mc (136399 in chips, $2.45 bounty) 
Seat 7: mis Yuliya (86157 in chips, $3.67 bounty) 
Seat 8: u.andrei.md (25083 in chips, $4.89 bounty) 
PinguaMito: posts the ante 300
jim5432: posts the ante 300
HENREMAXFREITAS: posts the ante 300
Yura Est: posts the ante 300
dolay127: posts the ante 300
Kevin12345Mc: posts the ante 300
mis Yuliya: posts the ante 300
u.andrei.md: posts the ante 300
dolay127: posts small blind 1000
Kevin12345Mc: posts big blind 2000
*** HOLE CARDS ***
Dealt to Kevin12345Mc [8h Ks]
mis Yuliya: folds 
u.andrei.md: folds 
PinguaMito: folds 
jim5432: folds 
HENREMAXFREITAS: folds 
Yura Est: folds 
dolay127: folds 
Uncalled bet (1000) returned to Kevin12345Mc
Kevin12345Mc collected 4400 from pot
Kevin12345Mc: doesn't show hand 
*** SUMMARY ***
Total pot 4400 | Rake 0 
Seat 1: PinguaMito folded before Flop (didn't bet)
Seat 2: jim5432 folded before Flop (didn't bet)
Seat 3: HENREMAXFREITAS folded before Flop (didn't bet)
Seat 4: Yura Est (button) folded before Flop (didn't bet)
Seat 5: dolay127 (small blind) folded before Flop
Seat 6: Kevin12345Mc (big blind) collected (4400)
Seat 7: mis Yuliya folded before Flop (didn't bet)
Seat 8: u.andrei.md folded before Flop (didn't bet)



PokerStars Hand #254865213920: Tournament #3856223586, $2.45+$2.45+$0.60 USD Hold'em No Limit - Level XVI (1000/2000) - 2025/02/14 19:49:49 WET [2025/02/14 14:49:49 ET]
Table '3856223586 110' 8-max Seat #5 is the button
Seat 1: PinguaMito (46649 in chips, $3.67 bounty) 
Seat 2: jim5432 (174565 in chips, $9.77 bounty) 
Seat 3: HENREMAXFREITAS (33686 in chips, $6.11 bounty) 
Seat 4: Yura Est (134626 in chips, $5.50 bounty) 
Seat 5: dolay127 (77456 in chips, $4.89 bounty) 
Seat 6: Kevin12345Mc (139499 in chips, $2.45 bounty) 
Seat 7: mis Yuliya (85857 in chips, $3.67 bounty) 
Seat 8: u.andrei.md (24783 in chips, $4.89 bounty) 
PinguaMito: posts the ante 300
jim5432: posts the ante 300
HENREMAXFREITAS: posts the ante 300
Yura Est: posts the ante 300
dolay127: posts the ante 300
Kevin12345Mc: posts the ante 300
mis Yuliya: posts the ante 300
u.andrei.md: posts the ante 300
Kevin12345Mc: posts small blind 1000
mis Yuliya: posts big blind 2000
*** HOLE CARDS ***
Dealt to Kevin12345Mc [3s 8c]
u.andrei.md: folds 
PinguaMito: folds 
jim5432: raises 2000 to 4000
HENREMAXFREITAS: folds 
Yura Est: folds 
dolay127: calls 4000
Kevin12345Mc: folds 
mis Yuliya: calls 2000
*** FLOP *** [Ac 4s Kd]
mis Yuliya: checks 
jim5432: bets 6000
dolay127: folds 
mis Yuliya: folds 
Uncalled bet (6000) returned to jim5432
jim5432 collected 15400 from pot
jim5432: doesn't show hand 
*** SUMMARY ***
Total pot 15400 | Rake 0 
Board [Ac 4s Kd]
Seat 1: PinguaMito folded before Flop (didn't bet)
Seat 2: jim5432 collected (15400)
Seat 3: HENREMAXFREITAS folded before Flop (didn't bet)
Seat 4: Yura Est folded before Flop (didn't bet)
Seat 5: dolay127 (button) folded on the Flop
Seat 6: Kevin12345Mc (small blind) folded before Flop
Seat 7: mis Yuliya (big blind) folded on the Flop
Seat 8: u.andrei.md folded before Flop (didn't bet)



PokerStars Hand #254865224612: Tournament #3856223586, $2.45+$2.45+$0.60 USD Hold'em No Limit - Level XVI (1000/2000) - 2025/02/14 19:50:30 WET [2025/02/14 14:50:30 ET]
Table '3856223586 110' 8-max Seat #6 is the button
Seat 1: PinguaMito (46349 in chips, $3.67 bounty) 
Seat 2: jim5432 (185665 in chips, $9.77 bounty) 
Seat 3: HENREMAXFREITAS (33386 in chips, $6.11 bounty) 
Seat 4: Yura Est (134326 in chips, $5.50 bounty) 
Seat 5: dolay127 (73156 in chips, $4.89 bounty) 
Seat 6: Kevin12345Mc (138199 in chips, $2.45 bounty) 
Seat 7: mis Yuliya (81557 in chips, $3.67 bounty) 
Seat 8: u.andrei.md (24483 in chips, $4.89 bounty) 
PinguaMito: posts the ante 300
jim5432: posts the ante 300
HENREMAXFREITAS: posts the ante 300
Yura Est: posts the ante 300
dolay127: posts the ante 300
Kevin12345Mc: posts the ante 300
mis Yuliya: posts the ante 300
u.andrei.md: posts the ante 300
mis Yuliya: posts small blind 1000
u.andrei.md: posts big blind 2000
*** HOLE CARDS ***
Dealt to Kevin12345Mc [7d 3c]
PinguaMito: raises 2000 to 4000
jim5432: folds 
HENREMAXFREITAS: folds 
Yura Est: folds 
dolay127: folds 
Kevin12345Mc: folds 
mis Yuliya: calls 3000
u.andrei.md: calls 2000
*** FLOP *** [Jc 7h 5c]
mis Yuliya: checks 
u.andrei.md: bets 20183 and is all-in
PinguaMito: folds 
mis Yuliya: folds 
Uncalled bet (20183) returned to u.andrei.md
u.andrei.md collected 14400 from pot
u.andrei.md: doesn't show hand 
*** SUMMARY ***
Total pot 14400 | Rake 0 
Board [Jc 7h 5c]
Seat 1: PinguaMito folded on the Flop
Seat 2: jim5432 folded before Flop (didn't bet)
Seat 3: HENREMAXFREITAS folded before Flop (didn't bet)
Seat 4: Yura Est folded before Flop (didn't bet)
Seat 5: dolay127 folded before Flop (didn't bet)
Seat 6: Kevin12345Mc (button) folded before Flop (didn't bet)
Seat 7: mis Yuliya (small blind) folded on the Flop
Seat 8: u.andrei.md (big blind) collected (14400)



PokerStars Hand #254865235723: Tournament #3856223586, $2.45+$2.45+$0.60 USD Hold'em No Limit - Level XVI (1000/2000) - 2025/02/14 19:51:11 WET [2025/02/14 14:51:11 ET]
Table '3856223586 110' 8-max Seat #7 is the button
Seat 1: PinguaMito (42049 in chips, $3.67 bounty) 
Seat 2: jim5432 (185365 in chips, $9.77 bounty) 
Seat 3: HENREMAXFREITAS (33086 in chips, $6.11 bounty) 
Seat 4: Yura Est (134026 in chips, $5.50 bounty) 
Seat 5: dolay127 (72856 in chips, $4.89 bounty) 
Seat 6: Kevin12345Mc (137899 in chips, $2.45 bounty) 
Seat 7: mis Yuliya (77257 in chips, $3.67 bounty) 
Seat 8: u.andrei.md (34583 in chips, $4.89 bounty) 
PinguaMito: posts the ante 300
jim5432: posts the ante 300
HENREMAXFREITAS: posts the ante 300
Yura Est: posts the ante 300
dolay127: posts the ante 300
Kevin12345Mc: posts the ante 300
mis Yuliya: posts the ante 300
u.andrei.md: posts the ante 300
u.andrei.md: posts small blind 1000
PinguaMito: posts big blind 2000
*** HOLE CARDS ***
Dealt to Kevin12345Mc [8s 6d]
jim5432: raises 2000 to 4000
HENREMAXFREITAS: folds 
Yura Est: folds 
dolay127: folds 
Kevin12345Mc: folds 
mis Yuliya: calls 4000
u.andrei.md: folds 
PinguaMito: folds 
*** FLOP *** [8c Ks Ts]
jim5432: bets 6700
mis Yuliya: calls 6700
*** TURN *** [8c Ks Ts] [4d]
jim5432: checks 
mis Yuliya: checks 
*** RIVER *** [8c Ks Ts 4d] [Kh]
jim5432: bets 15400
mis Yuliya: folds 
Uncalled bet (15400) returned to jim5432
jim5432 collected 26800 from pot
jim5432: doesn't show hand 
*** SUMMARY ***
Total pot 26800 | Rake 0 
Board [8c Ks Ts 4d Kh]
Seat 1: PinguaMito (big blind) folded before Flop
Seat 2: jim5432 collected (26800)
Seat 3: HENREMAXFREITAS folded before Flop (didn't bet)
Seat 4: Yura Est folded before Flop (didn't bet)
Seat 5: dolay127 folded before Flop (didn't bet)
Seat 6: Kevin12345Mc folded before Flop (didn't bet)
Seat 7: mis Yuliya (button) folded on the River
Seat 8: u.andrei.md (small blind) folded before Flop



PokerStars Hand #254865247820: Tournament #3856223586, $2.45+$2.45+$0.60 USD Hold'em No Limit - Level XVI (1000/2000) - 2025/02/14 19:51:57 WET [2025/02/14 14:51:57 ET]
Table '3856223586 110' 8-max Seat #8 is the button
Seat 1: PinguaMito (39749 in chips, $3.67 bounty) 
Seat 2: jim5432 (201165 in chips, $9.77 bounty) 
Seat 3: HENREMAXFREITAS (32786 in chips, $6.11 bounty) 
Seat 4: Yura Est (133726 in chips, $5.50 bounty) 
Seat 5: dolay127 (72556 in chips, $4.89 bounty) 
Seat 6: Kevin12345Mc (137599 in chips, $2.45 bounty) 
Seat 7: mis Yuliya (66257 in chips, $3.67 bounty) 
Seat 8: u.andrei.md (33283 in chips, $4.89 bounty) 
PinguaMito: posts the ante 300
jim5432: posts the ante 300
HENREMAXFREITAS: posts the ante 300
Yura Est: posts the ante 300
dolay127: posts the ante 300
Kevin12345Mc: posts the ante 300
mis Yuliya: posts the ante 300
u.andrei.md: posts the ante 300
PinguaMito: posts small blind 1000
jim5432: posts big blind 2000
*** HOLE CARDS ***
Dealt to Kevin12345Mc [Qh 2s]
HENREMAXFREITAS: folds 
Yura Est: folds 
dolay127: folds 
Kevin12345Mc: folds 
mis Yuliya: folds 
u.andrei.md: raises 2000 to 4000
PinguaMito: folds 
jim5432: calls 2000
*** FLOP *** [4s 7s 9d]
jim5432: checks 
u.andrei.md: checks 
*** TURN *** [4s 7s 9d] [4c]
jim5432: bets 5700
u.andrei.md: calls 5700
*** RIVER *** [4s 7s 9d 4c] [5h]
jim5432: bets 28800
u.andrei.md: folds 
Uncalled bet (28800) returned to jim5432
jim5432 collected 22800 from pot
jim5432: doesn't show hand 
*** SUMMARY ***
Total pot 22800 | Rake 0 
Board [4s 7s 9d 4c 5h]
Seat 1: PinguaMito (small blind) folded before Flop
Seat 2: jim5432 (big blind) collected (22800)
Seat 3: HENREMAXFREITAS folded before Flop (didn't bet)
Seat 4: Yura Est folded before Flop (didn't bet)
Seat 5: dolay127 folded before Flop (didn't bet)
Seat 6: Kevin12345Mc folded before Flop (didn't bet)
Seat 7: mis Yuliya folded before Flop (didn't bet)
Seat 8: u.andrei.md (button) folded on the River



PokerStars Hand #254865266344: Tournament #3856223586, $2.45+$2.45+$0.60 USD Hold'em No Limit - Level XVII (1250/2500) - 2025/02/14 19:53:07 WET [2025/02/14 14:53:07 ET]
Table '3856223586 110' 8-max Seat #1 is the button
Seat 1: PinguaMito (38449 in chips, $3.67 bounty) 
Seat 3: HENREMAXFREITAS (32486 in chips, $6.11 bounty) 
Seat 4: Yura Est (133426 in chips, $5.50 bounty) 
Seat 5: dolay127 (72256 in chips, $4.89 bounty) 
Seat 6: Kevin12345Mc (137299 in chips, $2.45 bounty) 
Seat 7: mis Yuliya (65957 in chips, $3.67 bounty) 
Seat 8: u.andrei.md (23283 in chips, $4.89 bounty) 
PinguaMito: posts the ante 350
HENREMAXFREITAS: posts the ante 350
Yura Est: posts the ante 350
dolay127: posts the ante 350
Kevin12345Mc: posts the ante 350
mis Yuliya: posts the ante 350
u.andrei.md: posts the ante 350
HENREMAXFREITAS: posts small blind 1250
Yura Est: posts big blind 2500
*** HOLE CARDS ***
Dealt to Kevin12345Mc [Td 6d]
dolay127: folds 
Kevin12345Mc: folds 
mis Yuliya: folds 
u.andrei.md: raises 20433 to 22933 and is all-in
PinguaMito: folds 
HENREMAXFREITAS: folds 
Yura Est: folds 
Uncalled bet (20433) returned to u.andrei.md
u.andrei.md collected 8700 from pot
u.andrei.md: doesn't show hand 
*** SUMMARY ***
Total pot 8700 | Rake 0 
Seat 1: PinguaMito (button) folded before Flop (didn't bet)
Seat 3: HENREMAXFREITAS (small blind) folded before Flop
Seat 4: Yura Est (big blind) folded before Flop
Seat 5: dolay127 folded before Flop (didn't bet)
Seat 6: Kevin12345Mc folded before Flop (didn't bet)
Seat 7: mis Yuliya folded before Flop (didn't bet)
Seat 8: u.andrei.md collected (8700)



PokerStars Hand #254865272168: Tournament #3856223586, $2.45+$2.45+$0.60 USD Hold'em No Limit - Level XVII (1250/2500) - 2025/02/14 19:53:29 WET [2025/02/14 14:53:29 ET]
Table '3856223586 110' 8-max Seat #3 is the button
Seat 1: PinguaMito (38099 in chips, $3.67 bounty) 
Seat 3: HENREMAXFREITAS (30886 in chips, $6.11 bounty) 
Seat 4: Yura Est (130576 in chips, $5.50 bounty) 
Seat 5: dolay127 (71906 in chips, $4.89 bounty) 
Seat 6: Kevin12345Mc (136949 in chips, $2.45 bounty) 
Seat 7: mis Yuliya (65607 in chips, $3.67 bounty) 
Seat 8: u.andrei.md (29133 in chips, $4.89 bounty) 
PinguaMito: posts the ante 350
HENREMAXFREITAS: posts the ante 350
Yura Est: posts the ante 350
dolay127: posts the ante 350
Kevin12345Mc: posts the ante 350
mis Yuliya: posts the ante 350
u.andrei.md: posts the ante 350
Yura Est: posts small blind 1250
dolay127: posts big blind 2500
*** HOLE CARDS ***
Dealt to Kevin12345Mc [Jd 9d]
Kevin12345Mc: raises 3250 to 5750
mis Yuliya: folds 
u.andrei.md: folds 
PinguaMito: folds 
HENREMAXFREITAS: folds 
Yura Est: folds 
dolay127: folds 
Uncalled bet (3250) returned to Kevin12345Mc
Kevin12345Mc collected 8700 from pot
Kevin12345Mc: doesn't show hand 
*** SUMMARY ***
Total pot 8700 | Rake 0 
Seat 1: PinguaMito folded before Flop (didn't bet)
Seat 3: HENREMAXFREITAS (button) folded before Flop (didn't bet)
Seat 4: Yura Est (small blind) folded before Flop
Seat 5: dolay127 (big blind) folded before Flop
Seat 6: Kevin12345Mc collected (8700)
Seat 7: mis Yuliya folded before Flop (didn't bet)
Seat 8: u.andrei.md folded before Flop (didn't bet)



PokerStars Hand #254865279801: Tournament #3856223586, $2.45+$2.45+$0.60 USD Hold'em No Limit - Level XVII (1250/2500) - 2025/02/14 19:53:58 WET [2025/02/14 14:53:58 ET]
Table '3856223586 110' 8-max Seat #4 is the button
Seat 1: PinguaMito (37749 in chips, $3.67 bounty) 
Seat 2: elguadas999 (87322 in chips, $11.60 bounty) 
Seat 3: HENREMAXFREITAS (30536 in chips, $6.11 bounty) 
Seat 4: Yura Est (128976 in chips, $5.50 bounty) 
Seat 5: dolay127 (69056 in chips, $4.89 bounty) 
Seat 6: Kevin12345Mc (142799 in chips, $2.45 bounty) 
Seat 7: mis Yuliya (65257 in chips, $3.67 bounty) 
Seat 8: u.andrei.md (28783 in chips, $4.89 bounty) 
PinguaMito: posts the ante 350
elguadas999: posts the ante 350
HENREMAXFREITAS: posts the ante 350
Yura Est: posts the ante 350
dolay127: posts the ante 350
Kevin12345Mc: posts the ante 350
mis Yuliya: posts the ante 350
u.andrei.md: posts the ante 350
dolay127: posts small blind 1250
Kevin12345Mc: posts big blind 2500
*** HOLE CARDS ***
Dealt to Kevin12345Mc [Tc 9h]
mis Yuliya: folds 
u.andrei.md: raises 25933 to 28433 and is all-in
PinguaMito: folds 
elguadas999: folds 
HENREMAXFREITAS: folds 
Yura Est: raises 100193 to 128626 and is all-in
dolay127: folds 
Kevin12345Mc: folds 
Uncalled bet (100193) returned to Yura Est
*** FLOP *** [2s 2d 7c]
*** TURN *** [2s 2d 7c] [Kd]
*** RIVER *** [2s 2d 7c Kd] [Js]
*** SHOW DOWN ***
u.andrei.md: shows [Ac Qs] (a pair of Deuces)
Yura Est: shows [Jc Jd] (a full house, Jacks full of Deuces)
Yura Est collected 63416 from pot
Yura Est wins $2.45 for eliminating u.andrei.md and their own bounty increases by $2.44 to $7.94
u.andrei.md finished the tournament in 912th place
*** SUMMARY ***
Total pot 63416 | Rake 0 
Board [2s 2d 7c Kd Js]
Seat 1: PinguaMito folded before Flop (didn't bet)
Seat 2: elguadas999 folded before Flop (didn't bet)
Seat 3: HENREMAXFREITAS folded before Flop (didn't bet)
Seat 4: Yura Est (button) showed [Jc Jd] and won (63416) with a full house, Jacks full of Deuces
Seat 5: dolay127 (small blind) folded before Flop
Seat 6: Kevin12345Mc (big blind) folded before Flop
Seat 7: mis Yuliya folded before Flop (didn't bet)
Seat 8: u.andrei.md showed [Ac Qs] and lost with a pair of Deuces



PokerStars Hand #254865287929: Tournament #3856223586, $2.45+$2.45+$0.60 USD Hold'em No Limit - Level XVII (1250/2500) - 2025/02/14 19:54:29 WET [2025/02/14 14:54:29 ET]
Table '3856223586 110' 8-max Seat #5 is the button
Seat 1: PinguaMito (37399 in chips, $3.67 bounty) 
Seat 2: elguadas999 (86972 in chips, $11.60 bounty) 
Seat 3: HENREMAXFREITAS (30186 in chips, $6.11 bounty) 
Seat 4: Yura Est (163609 in chips, $7.94 bounty) 
Seat 5: dolay127 (67456 in chips, $4.89 bounty) 
Seat 6: Kevin12345Mc (139949 in chips, $2.45 bounty) 
Seat 7: mis Yuliya (64907 in chips, $3.67 bounty) 
PinguaMito: posts the ante 350
elguadas999: posts the ante 350
HENREMAXFREITAS: posts the ante 350
Yura Est: posts the ante 350
dolay127: posts the ante 350
Kevin12345Mc: posts the ante 350
mis Yuliya: posts the ante 350
Kevin12345Mc: posts small blind 1250
mis Yuliya: posts big blind 2500
*** HOLE CARDS ***
Dealt to Kevin12345Mc [9c 8s]
PinguaMito: folds 
elguadas999: folds 
HENREMAXFREITAS: folds 
Yura Est: folds 
dolay127: raises 2500 to 5000
Kevin12345Mc: folds 
mis Yuliya: calls 2500
*** FLOP *** [5s Kd 5c]
mis Yuliya: checks 
dolay127: bets 2500
mis Yuliya: calls 2500
*** TURN *** [5s Kd 5c] [9d]
mis Yuliya: checks 
dolay127: bets 7500
mis Yuliya: calls 7500
*** RIVER *** [5s Kd 5c 9d] [Ah]
mis Yuliya: checks 
dolay127: checks 
*** SHOW DOWN ***
mis Yuliya: shows [Th Kh] (two pair, Kings and Fives)
dolay127: mucks hand 
mis Yuliya collected 33700 from pot
*** SUMMARY ***
Total pot 33700 | Rake 0 
Board [5s Kd 5c 9d Ah]
Seat 1: PinguaMito folded before Flop (didn't bet)
Seat 2: elguadas999 folded before Flop (didn't bet)
Seat 3: HENREMAXFREITAS folded before Flop (didn't bet)
Seat 4: Yura Est folded before Flop (didn't bet)
Seat 5: dolay127 (button) mucked [6h 6c]
Seat 6: Kevin12345Mc (small blind) folded before Flop
Seat 7: mis Yuliya (big blind) showed [Th Kh] and won (33700) with two pair, Kings and Fives



PokerStars Hand #254865387769: Tournament #3856223586, $2.45+$2.45+$0.60 USD Hold'em No Limit - Level XVII (1250/2500) - 2025/02/14 20:02:27 WET [2025/02/14 15:02:27 ET]
Table '3856223586 110' 8-max Seat #6 is the button
Seat 1: PinguaMito (37049 in chips, $3.67 bounty) 
Seat 2: elguadas999 (86622 in chips, $11.60 bounty) 
Seat 3: HENREMAXFREITAS (29836 in chips, $6.11 bounty) 
Seat 4: Yura Est (163259 in chips, $7.94 bounty) 
Seat 5: dolay127 (52106 in chips, $4.89 bounty) 
Seat 6: Kevin12345Mc (138349 in chips, $2.45 bounty) 
Seat 7: mis Yuliya (83257 in chips, $3.67 bounty) 
Seat 8: Can'tStopMee (187282 in chips, $6.27 bounty) 
PinguaMito: posts the ante 350
elguadas999: posts the ante 350
HENREMAXFREITAS: posts the ante 350
Yura Est: posts the ante 350
dolay127: posts the ante 350
Kevin12345Mc: posts the ante 350
mis Yuliya: posts the ante 350
Can'tStopMee: posts the ante 350
mis Yuliya: posts small blind 1250
Can'tStopMee: posts big blind 2500
*** HOLE CARDS ***
Dealt to Kevin12345Mc [6d 8c]
PinguaMito: folds 
elguadas999: folds 
HENREMAXFREITAS: folds 
Yura Est: raises 2500 to 5000
dolay127: calls 5000
Kevin12345Mc: folds 
mis Yuliya: calls 3750
Can'tStopMee: calls 2500
*** FLOP *** [6c Ad 6h]
mis Yuliya: checks 
Can'tStopMee: checks 
Yura Est: checks 
dolay127: checks 
*** TURN *** [6c Ad 6h] [2c]
mis Yuliya: checks 
Can'tStopMee: checks 
Yura Est: bets 6612
dolay127: folds 
mis Yuliya: calls 6612
Can'tStopMee: folds 
*** RIVER *** [6c Ad 6h 2c] [4s]
mis Yuliya: checks 
Yura Est: bets 28459
mis Yuliya: folds 
Uncalled bet (28459) returned to Yura Est
Yura Est collected 36024 from pot
Yura Est: doesn't show hand 
*** SUMMARY ***
Total pot 36024 | Rake 0 
Board [6c Ad 6h 2c 4s]
Seat 1: PinguaMito folded before Flop (didn't bet)
Seat 2: elguadas999 folded before Flop (didn't bet)
Seat 3: HENREMAXFREITAS folded before Flop (didn't bet)
Seat 4: Yura Est collected (36024)
Seat 5: dolay127 folded on the Turn
Seat 6: Kevin12345Mc (button) folded before Flop (didn't bet)
Seat 7: mis Yuliya (small blind) folded on the River
Seat 8: Can'tStopMee (big blind) folded on the Turn



PokerStars Hand #254865426512: Tournament #3856223586, $2.45+$2.45+$0.60 USD Hold'em No Limit - Level XVII (1250/2500) - 2025/02/14 20:04:52 WET [2025/02/14 15:04:52 ET]
Table '3856223586 110' 8-max Seat #7 is the button
Seat 1: PinguaMito (36699 in chips, $3.67 bounty) 
Seat 2: elguadas999 (86272 in chips, $11.60 bounty) 
Seat 3: HENREMAXFREITAS (29486 in chips, $6.11 bounty) 
Seat 4: Yura Est (187321 in chips, $7.94 bounty) 
Seat 5: dolay127 (46756 in chips, $4.89 bounty) 
Seat 6: Kevin12345Mc (137999 in chips, $2.45 bounty) 
Seat 7: mis Yuliya (71295 in chips, $3.67 bounty) 
Seat 8: Can'tStopMee (181932 in chips, $6.27 bounty) 
PinguaMito: posts the ante 350
elguadas999: posts the ante 350
HENREMAXFREITAS: posts the ante 350
Yura Est: posts the ante 350
dolay127: posts the ante 350
Kevin12345Mc: posts the ante 350
mis Yuliya: posts the ante 350
Can'tStopMee: posts the ante 350
Can'tStopMee: posts small blind 1250
PinguaMito: posts big blind 2500
*** HOLE CARDS ***
Dealt to Kevin12345Mc [Ah 5c]
elguadas999: folds 
HENREMAXFREITAS: folds 
Yura Est: raises 2500 to 5000
dolay127: calls 5000
Kevin12345Mc: folds 
mis Yuliya: folds 
Can'tStopMee: folds 
PinguaMito: raises 31349 to 36349 and is all-in
Yura Est: folds 
dolay127: calls 31349
*** FLOP *** [Kc 5d Jd]
*** TURN *** [Kc 5d Jd] [Th]
*** RIVER *** [Kc 5d Jd Th] [Kd]
*** SHOW DOWN ***
PinguaMito: shows [Js Ac] (two pair, Kings and Jacks)
dolay127: shows [Ts 9s] (two pair, Kings and Tens)
PinguaMito collected 81748 from pot
*** SUMMARY ***
Total pot 81748 | Rake 0 
Board [Kc 5d Jd Th Kd]
Seat 1: PinguaMito (big blind) showed [Js Ac] and won (81748) with two pair, Kings and Jacks
Seat 2: elguadas999 folded before Flop (didn't bet)
Seat 3: HENREMAXFREITAS folded before Flop (didn't bet)
Seat 4: Yura Est folded before Flop
Seat 5: dolay127 showed [Ts 9s] and lost with two pair, Kings and Tens
Seat 6: Kevin12345Mc folded before Flop (didn't bet)
Seat 7: mis Yuliya (button) folded before Flop (didn't bet)
Seat 8: Can'tStopMee (small blind) folded before Flop



PokerStars Hand #254865439331: Tournament #3856223586, $2.45+$2.45+$0.60 USD Hold'em No Limit - Level XVII (1250/2500) - 2025/02/14 20:05:39 WET [2025/02/14 15:05:39 ET]
Table '3856223586 110' 8-max Seat #8 is the button
Seat 1: PinguaMito (81748 in chips, $3.67 bounty) 
Seat 2: elguadas999 (85922 in chips, $11.60 bounty) 
Seat 3: HENREMAXFREITAS (29136 in chips, $6.11 bounty) 
Seat 4: Yura Est (181971 in chips, $7.94 bounty) 
Seat 5: dolay127 (10057 in chips, $4.89 bounty) 
Seat 6: Kevin12345Mc (137649 in chips, $2.45 bounty) 
Seat 7: mis Yuliya (70945 in chips, $3.67 bounty) 
Seat 8: Can'tStopMee (180332 in chips, $6.27 bounty) 
PinguaMito: posts the ante 350
elguadas999: posts the ante 350
HENREMAXFREITAS: posts the ante 350
Yura Est: posts the ante 350
dolay127: posts the ante 350
Kevin12345Mc: posts the ante 350
mis Yuliya: posts the ante 350
Can'tStopMee: posts the ante 350
PinguaMito: posts small blind 1250
elguadas999: posts big blind 2500
*** HOLE CARDS ***
Dealt to Kevin12345Mc [6d 7c]
HENREMAXFREITAS: folds 
Yura Est: folds 
dolay127: raises 7207 to 9707 and is all-in
Kevin12345Mc: folds 
mis Yuliya: folds 
Can'tStopMee: folds 
PinguaMito: folds 
elguadas999: calls 7207
*** FLOP *** [Th 5c Td]
*** TURN *** [Th 5c Td] [3c]
*** RIVER *** [Th 5c Td 3c] [2s]
*** SHOW DOWN ***
elguadas999: shows [Qs Kc] (a pair of Tens)
dolay127: shows [Ah 9h] (a pair of Tens - Ace kicker)
dolay127 collected 23464 from pot
*** SUMMARY ***
Total pot 23464 | Rake 0 
Board [Th 5c Td 3c 2s]
Seat 1: PinguaMito (small blind) folded before Flop
Seat 2: elguadas999 (big blind) showed [Qs Kc] and lost with a pair of Tens
Seat 3: HENREMAXFREITAS folded before Flop (didn't bet)
Seat 4: Yura Est folded before Flop (didn't bet)
Seat 5: dolay127 showed [Ah 9h] and won (23464) with a pair of Tens
Seat 6: Kevin12345Mc folded before Flop (didn't bet)
Seat 7: mis Yuliya folded before Flop (didn't bet)
Seat 8: Can'tStopMee (button) folded before Flop (didn't bet)



PokerStars Hand #254865448757: Tournament #3856223586, $2.45+$2.45+$0.60 USD Hold'em No Limit - Level XVII (1250/2500) - 2025/02/14 20:06:13 WET [2025/02/14 15:06:13 ET]
Table '3856223586 110' 8-max Seat #1 is the button
Seat 1: PinguaMito (80148 in chips, $3.67 bounty) 
Seat 2: elguadas999 (75865 in chips, $11.60 bounty) 
Seat 3: HENREMAXFREITAS (28786 in chips, $6.11 bounty) 
Seat 4: Yura Est (181621 in chips, $7.94 bounty) 
Seat 5: dolay127 (23464 in chips, $4.89 bounty) 
Seat 6: Kevin12345Mc (137299 in chips, $2.45 bounty) 
Seat 7: mis Yuliya (70595 in chips, $3.67 bounty) 
Seat 8: Can'tStopMee (179982 in chips, $6.27 bounty) 
PinguaMito: posts the ante 350
elguadas999: posts the ante 350
HENREMAXFREITAS: posts the ante 350
Yura Est: posts the ante 350
dolay127: posts the ante 350
Kevin12345Mc: posts the ante 350
mis Yuliya: posts the ante 350
Can'tStopMee: posts the ante 350
elguadas999: posts small blind 1250
HENREMAXFREITAS: posts big blind 2500
*** HOLE CARDS ***
Dealt to Kevin12345Mc [3c 2s]
Yura Est: folds 
dolay127: folds 
Kevin12345Mc: folds 
mis Yuliya: folds 
Can'tStopMee: folds 
PinguaMito: raises 2500 to 5000
elguadas999: calls 3750
HENREMAXFREITAS: calls 2500
*** FLOP *** [Jh 7c Ac]
elguadas999: checks 
HENREMAXFREITAS: checks 
PinguaMito: bets 4450
elguadas999: calls 4450
HENREMAXFREITAS: folds 
*** TURN *** [Jh 7c Ac] [Jd]
elguadas999: checks 
PinguaMito: checks 
*** RIVER *** [Jh 7c Ac Jd] [9s]
elguadas999: bets 20025
PinguaMito: folds 
Uncalled bet (20025) returned to elguadas999
elguadas999 collected 26700 from pot
*** SUMMARY ***
Total pot 26700 | Rake 0 
Board [Jh 7c Ac Jd 9s]
Seat 1: PinguaMito (button) folded on the River
Seat 2: elguadas999 (small blind) collected (26700)
Seat 3: HENREMAXFREITAS (big blind) folded on the Flop
Seat 4: Yura Est folded before Flop (didn't bet)
Seat 5: dolay127 folded before Flop (didn't bet)
Seat 6: Kevin12345Mc folded before Flop (didn't bet)
Seat 7: mis Yuliya folded before Flop (didn't bet)
Seat 8: Can'tStopMee folded before Flop (didn't bet)



PokerStars Hand #254865467536: Tournament #3856223586, $2.45+$2.45+$0.60 USD Hold'em No Limit - Level XVII (1250/2500) - 2025/02/14 20:07:21 WET [2025/02/14 15:07:21 ET]
Table '3856223586 110' 8-max Seat #2 is the button
Seat 1: PinguaMito (70348 in chips, $3.67 bounty) 
Seat 2: elguadas999 (92765 in chips, $11.60 bounty) 
Seat 3: HENREMAXFREITAS (23436 in chips, $6.11 bounty) 
Seat 4: Yura Est (181271 in chips, $7.94 bounty) 
Seat 5: dolay127 (23114 in chips, $4.89 bounty) 
Seat 6: Kevin12345Mc (136949 in chips, $2.45 bounty) 
Seat 7: mis Yuliya (70245 in chips, $3.67 bounty) 
Seat 8: Can'tStopMee (179632 in chips, $6.27 bounty) 
PinguaMito: posts the ante 350
elguadas999: posts the ante 350
HENREMAXFREITAS: posts the ante 350
Yura Est: posts the ante 350
dolay127: posts the ante 350
Kevin12345Mc: posts the ante 350
mis Yuliya: posts the ante 350
Can'tStopMee: posts the ante 350
HENREMAXFREITAS: posts small blind 1250
Yura Est: posts big blind 2500
*** HOLE CARDS ***
Dealt to Kevin12345Mc [3h Tc]
dolay127: raises 20264 to 22764 and is all-in
Kevin12345Mc: folds 
mis Yuliya: folds 
Can'tStopMee: calls 22764
PinguaMito: folds 
elguadas999: raises 69651 to 92415 and is all-in
HENREMAXFREITAS: folds 
Yura Est: folds 
Can'tStopMee: folds 
Uncalled bet (69651) returned to elguadas999
*** FLOP *** [Ts 8s Jd]
*** TURN *** [Ts 8s Jd] [Kd]
*** RIVER *** [Ts 8s Jd Kd] [5d]
*** SHOW DOWN ***
dolay127: shows [6d Ac] (high card Ace)
elguadas999: shows [Ah As] (a pair of Aces)
elguadas999 collected 74842 from pot
elguadas999 wins $2.45 for eliminating dolay127 and their own bounty increases by $2.44 to $14.04
dolay127 finished the tournament in 817th place
*** SUMMARY ***
Total pot 74842 | Rake 0 
Board [Ts 8s Jd Kd 5d]
Seat 1: PinguaMito folded before Flop (didn't bet)
Seat 2: elguadas999 (button) showed [Ah As] and won (74842) with a pair of Aces
Seat 3: HENREMAXFREITAS (small blind) folded before Flop
Seat 4: Yura Est (big blind) folded before Flop
Seat 5: dolay127 showed [6d Ac] and lost with high card Ace
Seat 6: Kevin12345Mc folded before Flop (didn't bet)
Seat 7: mis Yuliya folded before Flop (didn't bet)
Seat 8: Can'tStopMee folded before Flop



PokerStars Hand #254865495133: Tournament #3856223586, $2.45+$2.45+$0.60 USD Hold'em No Limit - Level XVIII (1500/3000) - 2025/02/14 20:09:00 WET [2025/02/14 15:09:00 ET]
Table '3856223586 233' 8-max Seat #2 is the button
Seat 1: LeCharentai (66106 in chips, $4.89 bounty) 
Seat 2: fingon149118 (258442 in chips, $9.63 bounty) 
Seat 3: Venycyos (93402 in chips, $5.81 bounty) 
Seat 4: Kevin12345Mc (136599 in chips, $2.45 bounty) 
Seat 5: Gomez224 (106973 in chips, $4.89 bounty) 
Seat 6: smoke aces7 (109332 in chips, $4.89 bounty) 
Seat 7: mimacach (72026 in chips, $3.67 bounty) 
Seat 8: High Goblin (187623 in chips, $14.96 bounty) 
LeCharentai: posts the ante 400
fingon149118: posts the ante 400
Venycyos: posts the ante 400
Kevin12345Mc: posts the ante 400
Gomez224: posts the ante 400
smoke aces7: posts the ante 400
mimacach: posts the ante 400
High Goblin: posts the ante 400
Venycyos: posts small blind 1500
Kevin12345Mc: posts big blind 3000
*** HOLE CARDS ***
Dealt to Kevin12345Mc [Ad 2d]
Gomez224: folds 
smoke aces7: folds 
mimacach: raises 3000 to 6000
High Goblin: folds 
LeCharentai: folds 
fingon149118: folds 
Venycyos: folds 
Kevin12345Mc: calls 3000
*** FLOP *** [8c 7d 9h]
Kevin12345Mc: checks 
mimacach: bets 6000
Kevin12345Mc: folds 
Uncalled bet (6000) returned to mimacach
mimacach collected 16700 from pot
mimacach: doesn't show hand 
*** SUMMARY ***
Total pot 16700 | Rake 0 
Board [8c 7d 9h]
Seat 1: LeCharentai folded before Flop (didn't bet)
Seat 2: fingon149118 (button) folded before Flop (didn't bet)
Seat 3: Venycyos (small blind) folded before Flop
Seat 4: Kevin12345Mc (big blind) folded on the Flop
Seat 5: Gomez224 folded before Flop (didn't bet)
Seat 6: smoke aces7 folded before Flop (didn't bet)
Seat 7: mimacach collected (16700)
Seat 8: High Goblin folded before Flop (didn't bet)



PokerStars Hand #254865504557: Tournament #3856223586, $2.45+$2.45+$0.60 USD Hold'em No Limit - Level XVIII (1500/3000) - 2025/02/14 20:09:34 WET [2025/02/14 15:09:34 ET]
Table '3856223586 233' 8-max Seat #3 is the button
Seat 1: LeCharentai (65706 in chips, $4.89 bounty) 
Seat 2: fingon149118 (258042 in chips, $9.63 bounty) 
Seat 3: Venycyos (91502 in chips, $5.81 bounty) 
Seat 4: Kevin12345Mc (130199 in chips, $2.45 bounty) 
Seat 5: Gomez224 (106573 in chips, $4.89 bounty) 
Seat 6: smoke aces7 (108932 in chips, $4.89 bounty) 
Seat 7: mimacach (82326 in chips, $3.67 bounty) 
Seat 8: High Goblin (187223 in chips, $14.96 bounty) 
LeCharentai: posts the ante 400
fingon149118: posts the ante 400
Venycyos: posts the ante 400
Kevin12345Mc: posts the ante 400
Gomez224: posts the ante 400
smoke aces7: posts the ante 400
mimacach: posts the ante 400
High Goblin: posts the ante 400
Kevin12345Mc: posts small blind 1500
Gomez224: posts big blind 3000
*** HOLE CARDS ***
Dealt to Kevin12345Mc [Jc Ks]
smoke aces7: folds 
mimacach: folds 
High Goblin: folds 
LeCharentai: folds 
fingon149118: calls 3000
Venycyos: folds 
Kevin12345Mc: calls 1500
Gomez224: checks 
*** FLOP *** [Ts Qc 8h]
Kevin12345Mc: checks 
Gomez224: checks 
fingon149118: checks 
*** TURN *** [Ts Qc 8h] [4d]
Kevin12345Mc: checks 
Gomez224: bets 6000
fingon149118: calls 6000
Kevin12345Mc: calls 6000
*** RIVER *** [Ts Qc 8h 4d] [9s]
Kevin12345Mc: checks 
Gomez224: checks 
fingon149118: checks 
*** SHOW DOWN ***
Kevin12345Mc: shows [Jc Ks] (a straight, Nine to King)
Gomez224: mucks hand 
fingon149118: mucks hand 
Kevin12345Mc collected 30200 from pot
*** SUMMARY ***
Total pot 30200 | Rake 0 
Board [Ts Qc 8h 4d 9s]
Seat 1: LeCharentai folded before Flop (didn't bet)
Seat 2: fingon149118 mucked [Kc 4c]
Seat 3: Venycyos (button) folded before Flop (didn't bet)
Seat 4: Kevin12345Mc (small blind) showed [Jc Ks] and won (30200) with a straight, Nine to King
Seat 5: Gomez224 (big blind) mucked [Th Ah]
Seat 6: smoke aces7 folded before Flop (didn't bet)
Seat 7: mimacach folded before Flop (didn't bet)
Seat 8: High Goblin folded before Flop (didn't bet)



PokerStars Hand #254865517469: Tournament #3856223586, $2.45+$2.45+$0.60 USD Hold'em No Limit - Level XVIII (1500/3000) - 2025/02/14 20:10:20 WET [2025/02/14 15:10:20 ET]
Table '3856223586 233' 8-max Seat #4 is the button
Seat 1: LeCharentai (65306 in chips, $4.89 bounty) 
Seat 2: fingon149118 (248642 in chips, $9.63 bounty) 
Seat 3: Venycyos (91102 in chips, $5.81 bounty) 
Seat 4: Kevin12345Mc (150999 in chips, $2.45 bounty) 
Seat 5: Gomez224 (97173 in chips, $4.89 bounty) 
Seat 6: smoke aces7 (108532 in chips, $4.89 bounty) 
Seat 7: mimacach (81926 in chips, $3.67 bounty) 
Seat 8: High Goblin (186823 in chips, $14.96 bounty) 
LeCharentai: posts the ante 400
fingon149118: posts the ante 400
Venycyos: posts the ante 400
Kevin12345Mc: posts the ante 400
Gomez224: posts the ante 400
smoke aces7: posts the ante 400
mimacach: posts the ante 400
High Goblin: posts the ante 400
Gomez224: posts small blind 1500
smoke aces7: posts big blind 3000
*** HOLE CARDS ***
Dealt to Kevin12345Mc [2c 4c]
mimacach: folds 
High Goblin: folds 
LeCharentai: folds 
fingon149118: folds 
Venycyos: folds 
Kevin12345Mc: folds 
Gomez224: folds 
Uncalled bet (1500) returned to smoke aces7
smoke aces7 collected 6200 from pot
smoke aces7: doesn't show hand 
*** SUMMARY ***
Total pot 6200 | Rake 0 
Seat 1: LeCharentai folded before Flop (didn't bet)
Seat 2: fingon149118 folded before Flop (didn't bet)
Seat 3: Venycyos folded before Flop (didn't bet)
Seat 4: Kevin12345Mc (button) folded before Flop (didn't bet)
Seat 5: Gomez224 (small blind) folded before Flop
Seat 6: smoke aces7 (big blind) collected (6200)
Seat 7: mimacach folded before Flop (didn't bet)
Seat 8: High Goblin folded before Flop (didn't bet)



PokerStars Hand #254865520967: Tournament #3856223586, $2.45+$2.45+$0.60 USD Hold'em No Limit - Level XVIII (1500/3000) - 2025/02/14 20:10:33 WET [2025/02/14 15:10:33 ET]
Table '3856223586 233' 8-max Seat #5 is the button
Seat 1: LeCharentai (64906 in chips, $4.89 bounty) 
Seat 2: fingon149118 (248242 in chips, $9.63 bounty) 
Seat 3: Venycyos (90702 in chips, $5.81 bounty) 
Seat 4: Kevin12345Mc (150599 in chips, $2.45 bounty) 
Seat 5: Gomez224 (95273 in chips, $4.89 bounty) 
Seat 6: smoke aces7 (112832 in chips, $4.89 bounty) 
Seat 7: mimacach (81526 in chips, $3.67 bounty) 
Seat 8: High Goblin (186423 in chips, $14.96 bounty) 
LeCharentai: posts the ante 400
fingon149118: posts the ante 400
Venycyos: posts the ante 400
Kevin12345Mc: posts the ante 400
Gomez224: posts the ante 400
smoke aces7: posts the ante 400
mimacach: posts the ante 400
High Goblin: posts the ante 400
smoke aces7: posts small blind 1500
mimacach: posts big blind 3000
*** HOLE CARDS ***
Dealt to Kevin12345Mc [5c 8d]
High Goblin: folds 
LeCharentai: raises 3000 to 6000
fingon149118: folds 
Venycyos: folds 
Kevin12345Mc: folds 
Gomez224: folds 
smoke aces7: folds 
mimacach: calls 3000
*** FLOP *** [3s 2s 4c]
mimacach: checks 
LeCharentai: bets 16700
mimacach: raises 58426 to 75126 and is all-in
LeCharentai: calls 41806 and is all-in
Uncalled bet (16620) returned to mimacach
*** TURN *** [3s 2s 4c] [Jh]
*** RIVER *** [3s 2s 4c Jh] [4d]
*** SHOW DOWN ***
mimacach: shows [4s 2h] (a full house, Fours full of Deuces)
LeCharentai: shows [Kd Kh] (two pair, Kings and Fours)
mimacach collected 133712 from pot
mimacach wins $2.45 for eliminating LeCharentai and their own bounty increases by $2.44 to $6.11
LeCharentai finished the tournament in 773rd place
*** SUMMARY ***
Total pot 133712 | Rake 0 
Board [3s 2s 4c Jh 4d]
Seat 1: LeCharentai showed [Kd Kh] and lost with two pair, Kings and Fours
Seat 2: fingon149118 folded before Flop (didn't bet)
Seat 3: Venycyos folded before Flop (didn't bet)
Seat 4: Kevin12345Mc folded before Flop (didn't bet)
Seat 5: Gomez224 (button) folded before Flop (didn't bet)
Seat 6: smoke aces7 (small blind) folded before Flop
Seat 7: mimacach (big blind) showed [4s 2h] and won (133712) with a full house, Fours full of Deuces
Seat 8: High Goblin folded before Flop (didn't bet)



PokerStars Hand #254865530651: Tournament #3856223586, $2.45+$2.45+$0.60 USD Hold'em No Limit - Level XVIII (1500/3000) - 2025/02/14 20:11:08 WET [2025/02/14 15:11:08 ET]
Table '3856223586 233' 8-max Seat #6 is the button
Seat 2: fingon149118 (247842 in chips, $9.63 bounty) 
Seat 3: Venycyos (90302 in chips, $5.81 bounty) 
Seat 4: Kevin12345Mc (150199 in chips, $2.45 bounty) 
Seat 5: Gomez224 (94873 in chips, $4.89 bounty) 
Seat 6: smoke aces7 (110932 in chips, $4.89 bounty) 
Seat 7: mimacach (150332 in chips, $6.11 bounty) 
Seat 8: High Goblin (186023 in chips, $14.96 bounty) 
fingon149118: posts the ante 400
Venycyos: posts the ante 400
Kevin12345Mc: posts the ante 400
Gomez224: posts the ante 400
smoke aces7: posts the ante 400
mimacach: posts the ante 400
High Goblin: posts the ante 400
mimacach: posts small blind 1500
High Goblin: posts big blind 3000
*** HOLE CARDS ***
Dealt to Kevin12345Mc [5d Ts]
fingon149118: folds 
Sergeygto is disconnected 
Venycyos: folds 
Kevin12345Mc: folds 
Gomez224: folds 
smoke aces7: folds 
mimacach: calls 1500
High Goblin: checks 
*** FLOP *** [Th 5h Qc]
mimacach: bets 3000
High Goblin: folds 
Uncalled bet (3000) returned to mimacach
mimacach collected 8800 from pot
mimacach: doesn't show hand 
*** SUMMARY ***
Total pot 8800 | Rake 0 
Board [Th 5h Qc]
Seat 2: fingon149118 folded before Flop (didn't bet)
Seat 3: Venycyos folded before Flop (didn't bet)
Seat 4: Kevin12345Mc folded before Flop (didn't bet)
Seat 5: Gomez224 folded before Flop (didn't bet)
Seat 6: smoke aces7 (button) folded before Flop (didn't bet)
Seat 7: mimacach (small blind) collected (8800)
Seat 8: High Goblin (big blind) folded on the Flop



PokerStars Hand #254865545532: Tournament #3856223586, $2.45+$2.45+$0.60 USD Hold'em No Limit - Level XVIII (1500/3000) - 2025/02/14 20:12:02 WET [2025/02/14 15:12:02 ET]
Table '3856223586 233' 8-max Seat #7 is the button
Seat 1: Sergeygto (104872 in chips, $5.50 bounty) 
Seat 2: fingon149118 (247442 in chips, $9.63 bounty) 
Seat 3: Venycyos (89902 in chips, $5.81 bounty) 
Seat 4: Kevin12345Mc (149799 in chips, $2.45 bounty) 
Seat 5: Gomez224 (94473 in chips, $4.89 bounty) 
Seat 6: smoke aces7 (110532 in chips, $4.89 bounty) 
Seat 7: mimacach (155732 in chips, $6.11 bounty) 
Seat 8: High Goblin (182623 in chips, $14.96 bounty) 
Sergeygto: posts the ante 400
fingon149118: posts the ante 400
Venycyos: posts the ante 400
Kevin12345Mc: posts the ante 400
Gomez224: posts the ante 400
smoke aces7: posts the ante 400
mimacach: posts the ante 400
High Goblin: posts the ante 400
High Goblin: posts small blind 1500
Sergeygto: posts big blind 3000
*** HOLE CARDS ***
Dealt to Kevin12345Mc [Ks 3h]
fingon149118: folds 
Venycyos: raises 3000 to 6000
Kevin12345Mc: folds 
Gomez224: folds 
smoke aces7: folds 
mimacach: calls 6000
High Goblin: folds 
Sergeygto: calls 3000
*** FLOP *** [6d 7d Jc]
Sergeygto: checks 
Venycyos: bets 7491
mimacach: folds 
Sergeygto: calls 7491
*** TURN *** [6d 7d Jc] [8h]
Sergeygto: bets 24000
Venycyos: folds 
Uncalled bet (24000) returned to Sergeygto
Sergeygto collected 37682 from pot
Sergeygto: doesn't show hand 
*** SUMMARY ***
Total pot 37682 | Rake 0 
Board [6d 7d Jc 8h]
Seat 1: Sergeygto (big blind) collected (37682)
Seat 2: fingon149118 folded before Flop (didn't bet)
Seat 3: Venycyos folded on the Turn
Seat 4: Kevin12345Mc folded before Flop (didn't bet)
Seat 5: Gomez224 folded before Flop (didn't bet)
Seat 6: smoke aces7 folded before Flop (didn't bet)
Seat 7: mimacach (button) folded on the Flop
Seat 8: High Goblin (small blind) folded before Flop



PokerStars Hand #254865559587: Tournament #3856223586, $2.45+$2.45+$0.60 USD Hold'em No Limit - Level XVIII (1500/3000) - 2025/02/14 20:12:52 WET [2025/02/14 15:12:52 ET]
Table '3856223586 233' 8-max Seat #8 is the button
Seat 1: Sergeygto (128663 in chips, $5.50 bounty) 
Seat 2: fingon149118 (247042 in chips, $9.63 bounty) 
Seat 3: Venycyos (76011 in chips, $5.81 bounty) 
Seat 4: Kevin12345Mc (149399 in chips, $2.45 bounty) 
Seat 5: Gomez224 (94073 in chips, $4.89 bounty) 
Seat 6: smoke aces7 (110132 in chips, $4.89 bounty) 
Seat 7: mimacach (149332 in chips, $6.11 bounty) 
Seat 8: High Goblin (180723 in chips, $14.96 bounty) 
Sergeygto: posts the ante 400
fingon149118: posts the ante 400
Venycyos: posts the ante 400
Kevin12345Mc: posts the ante 400
Gomez224: posts the ante 400
smoke aces7: posts the ante 400
mimacach: posts the ante 400
High Goblin: posts the ante 400
Sergeygto: posts small blind 1500
fingon149118: posts big blind 3000
*** HOLE CARDS ***
Dealt to Kevin12345Mc [9s Ts]
Venycyos: folds 
Kevin12345Mc: raises 3900 to 6900
Gomez224: folds 
smoke aces7: folds 
mimacach: folds 
High Goblin: folds 
Sergeygto: folds 
fingon149118: folds 
Uncalled bet (3900) returned to Kevin12345Mc
Kevin12345Mc collected 10700 from pot
Kevin12345Mc: doesn't show hand 
*** SUMMARY ***
Total pot 10700 | Rake 0 
Seat 1: Sergeygto (small blind) folded before Flop
Seat 2: fingon149118 (big blind) folded before Flop
Seat 3: Venycyos folded before Flop (didn't bet)
Seat 4: Kevin12345Mc collected (10700)
Seat 5: Gomez224 folded before Flop (didn't bet)
Seat 6: smoke aces7 folded before Flop (didn't bet)
Seat 7: mimacach folded before Flop (didn't bet)
Seat 8: High Goblin (button) folded before Flop (didn't bet)



PokerStars Hand #254865566959: Tournament #3856223586, $2.45+$2.45+$0.60 USD Hold'em No Limit - Level XVIII (1500/3000) - 2025/02/14 20:13:18 WET [2025/02/14 15:13:18 ET]
Table '3856223586 233' 8-max Seat #1 is the button
Seat 1: Sergeygto (126763 in chips, $5.50 bounty) 
Seat 2: fingon149118 (243642 in chips, $9.63 bounty) 
Seat 3: Venycyos (75611 in chips, $5.81 bounty) 
Seat 4: Kevin12345Mc (156699 in chips, $2.45 bounty) 
Seat 5: Gomez224 (93673 in chips, $4.89 bounty) 
Seat 6: smoke aces7 (109732 in chips, $4.89 bounty) 
Seat 7: mimacach (148932 in chips, $6.11 bounty) 
Seat 8: High Goblin (180323 in chips, $14.96 bounty) 
Sergeygto: posts the ante 400
fingon149118: posts the ante 400
Venycyos: posts the ante 400
Kevin12345Mc: posts the ante 400
Gomez224: posts the ante 400
smoke aces7: posts the ante 400
mimacach: posts the ante 400
High Goblin: posts the ante 400
fingon149118: posts small blind 1500
Venycyos: posts big blind 3000
*** HOLE CARDS ***
Dealt to Kevin12345Mc [Ks Ad]
Kevin12345Mc: raises 3900 to 6900
Gomez224: folds 
smoke aces7: folds 
mimacach: folds 
High Goblin: folds 
Sergeygto: folds 
fingon149118: folds 
Venycyos: folds 
Uncalled bet (3900) returned to Kevin12345Mc
Kevin12345Mc collected 10700 from pot
Kevin12345Mc: doesn't show hand 
*** SUMMARY ***
Total pot 10700 | Rake 0 
Seat 1: Sergeygto (button) folded before Flop (didn't bet)
Seat 2: fingon149118 (small blind) folded before Flop
Seat 3: Venycyos (big blind) folded before Flop
Seat 4: Kevin12345Mc collected (10700)
Seat 5: Gomez224 folded before Flop (didn't bet)
Seat 6: smoke aces7 folded before Flop (didn't bet)
Seat 7: mimacach folded before Flop (didn't bet)
Seat 8: High Goblin folded before Flop (didn't bet)



PokerStars Hand #254865576969: Tournament #3856223586, $2.45+$2.45+$0.60 USD Hold'em No Limit - Level XVIII (1500/3000) - 2025/02/14 20:13:54 WET [2025/02/14 15:13:54 ET]
Table '3856223586 233' 8-max Seat #2 is the button
Seat 1: Sergeygto (126363 in chips, $5.50 bounty) 
Seat 2: fingon149118 (241742 in chips, $9.63 bounty) 
Seat 3: Venycyos (72211 in chips, $5.81 bounty) 
Seat 4: Kevin12345Mc (163999 in chips, $2.45 bounty) 
Seat 5: Gomez224 (93273 in chips, $4.89 bounty) 
Seat 6: smoke aces7 (109332 in chips, $4.89 bounty) 
Seat 7: mimacach (148532 in chips, $6.11 bounty) 
Seat 8: High Goblin (179923 in chips, $14.96 bounty) 
Sergeygto: posts the ante 400
fingon149118: posts the ante 400
Venycyos: posts the ante 400
Kevin12345Mc: posts the ante 400
Gomez224: posts the ante 400
smoke aces7: posts the ante 400
mimacach: posts the ante 400
High Goblin: posts the ante 400
Venycyos: posts small blind 1500
Kevin12345Mc: posts big blind 3000
*** HOLE CARDS ***
Dealt to Kevin12345Mc [2d 4c]
Gomez224: raises 3300 to 6300
smoke aces7: folds 
mimacach: folds 
High Goblin: folds 
Sergeygto: calls 6300
fingon149118: folds 
Venycyos: folds 
Kevin12345Mc: folds 
*** FLOP *** [6c 8h 5c]
Gomez224: bets 9000
Sergeygto: folds 
Uncalled bet (9000) returned to Gomez224
Gomez224 collected 20300 from pot
Gomez224: doesn't show hand 
*** SUMMARY ***
Total pot 20300 | Rake 0 
Board [6c 8h 5c]
Seat 1: Sergeygto folded on the Flop
Seat 2: fingon149118 (button) folded before Flop (didn't bet)
Seat 3: Venycyos (small blind) folded before Flop
Seat 4: Kevin12345Mc (big blind) folded before Flop
Seat 5: Gomez224 collected (20300)
Seat 6: smoke aces7 folded before Flop (didn't bet)
Seat 7: mimacach folded before Flop (didn't bet)
Seat 8: High Goblin folded before Flop (didn't bet)



PokerStars Hand #254865591216: Tournament #3856223586, $2.45+$2.45+$0.60 USD Hold'em No Limit - Level XVIII (1500/3000) - 2025/02/14 20:14:44 WET [2025/02/14 15:14:44 ET]
Table '3856223586 233' 8-max Seat #3 is the button
Seat 1: Sergeygto (119663 in chips, $5.50 bounty) 
Seat 2: fingon149118 (241342 in chips, $9.63 bounty) 
Seat 3: Venycyos (70311 in chips, $5.81 bounty) 
Seat 4: Kevin12345Mc (160599 in chips, $2.45 bounty) 
Seat 5: Gomez224 (106873 in chips, $4.89 bounty) 
Seat 6: smoke aces7 (108932 in chips, $4.89 bounty) 
Seat 7: mimacach (148132 in chips, $6.11 bounty) 
Seat 8: High Goblin (179523 in chips, $14.96 bounty) 
Sergeygto: posts the ante 400
fingon149118: posts the ante 400
Venycyos: posts the ante 400
Kevin12345Mc: posts the ante 400
Gomez224: posts the ante 400
smoke aces7: posts the ante 400
mimacach: posts the ante 400
High Goblin: posts the ante 400
Kevin12345Mc: posts small blind 1500
Gomez224: posts big blind 3000
*** HOLE CARDS ***
Dealt to Kevin12345Mc [3h 7h]
smoke aces7: folds 
mimacach: raises 3000 to 6000
High Goblin: folds 
Sergeygto: folds 
fingon149118: folds 
Venycyos: calls 6000
Kevin12345Mc: folds 
Gomez224: calls 3000
*** FLOP *** [Ad As Jc]
Gomez224: checks 
mimacach: bets 9000
Venycyos: folds 
Gomez224: folds 
Uncalled bet (9000) returned to mimacach
mimacach collected 22700 from pot
mimacach: doesn't show hand 
*** SUMMARY ***
Total pot 22700 | Rake 0 
Board [Ad As Jc]
Seat 1: Sergeygto folded before Flop (didn't bet)
Seat 2: fingon149118 folded before Flop (didn't bet)
Seat 3: Venycyos (button) folded on the Flop
Seat 4: Kevin12345Mc (small blind) folded before Flop
Seat 5: Gomez224 (big blind) folded on the Flop
Seat 6: smoke aces7 folded before Flop (didn't bet)
Seat 7: mimacach collected (22700)
Seat 8: High Goblin folded before Flop (didn't bet)



PokerStars Hand #254865603457: Tournament #3856223586, $2.45+$2.45+$0.60 USD Hold'em No Limit - Level XVIII (1500/3000) - 2025/02/14 20:15:28 WET [2025/02/14 15:15:28 ET]
Table '3856223586 233' 8-max Seat #4 is the button
Seat 1: Sergeygto (119263 in chips, $5.50 bounty) 
Seat 2: fingon149118 (240942 in chips, $9.63 bounty) 
Seat 3: Venycyos (63911 in chips, $5.81 bounty) 
Seat 4: Kevin12345Mc (158699 in chips, $2.45 bounty) 
Seat 5: Gomez224 (100473 in chips, $4.89 bounty) 
Seat 6: smoke aces7 (108532 in chips, $4.89 bounty) 
Seat 7: mimacach (164432 in chips, $6.11 bounty) 
Seat 8: High Goblin (179123 in chips, $14.96 bounty) 
Sergeygto: posts the ante 400
fingon149118: posts the ante 400
Venycyos: posts the ante 400
Kevin12345Mc: posts the ante 400
Gomez224: posts the ante 400
smoke aces7: posts the ante 400
mimacach: posts the ante 400
High Goblin: posts the ante 400
Gomez224: posts small blind 1500
smoke aces7: posts big blind 3000
*** HOLE CARDS ***
Dealt to Kevin12345Mc [7d Jc]
mimacach: folds 
High Goblin: folds 
Sergeygto: folds 
fingon149118: folds 
Venycyos: raises 3000 to 6000
Kevin12345Mc: folds 
Gomez224: folds 
smoke aces7: folds 
Uncalled bet (3000) returned to Venycyos
Venycyos collected 10700 from pot
Venycyos: doesn't show hand 
*** SUMMARY ***
Total pot 10700 | Rake 0 
Seat 1: Sergeygto folded before Flop (didn't bet)
Seat 2: fingon149118 folded before Flop (didn't bet)
Seat 3: Venycyos collected (10700)
Seat 4: Kevin12345Mc (button) folded before Flop (didn't bet)
Seat 5: Gomez224 (small blind) folded before Flop
Seat 6: smoke aces7 (big blind) folded before Flop
Seat 7: mimacach folded before Flop (didn't bet)
Seat 8: High Goblin folded before Flop (didn't bet)



PokerStars Hand #254865613252: Tournament #3856223586, $2.45+$2.45+$0.60 USD Hold'em No Limit - Level XIX (2000/4000) - 2025/02/14 20:16:03 WET [2025/02/14 15:16:03 ET]
Table '3856223586 233' 8-max Seat #5 is the button
Seat 1: Sergeygto (118863 in chips, $5.50 bounty) 
Seat 2: fingon149118 (240542 in chips, $9.63 bounty) 
Seat 3: Venycyos (71211 in chips, $5.81 bounty) 
Seat 4: Kevin12345Mc (158299 in chips, $2.45 bounty) 
Seat 5: Gomez224 (98573 in chips, $4.89 bounty) 
Seat 6: smoke aces7 (105132 in chips, $4.89 bounty) 
Seat 7: mimacach (164032 in chips, $6.11 bounty) 
Seat 8: High Goblin (178723 in chips, $14.96 bounty) 
Sergeygto: posts the ante 500
fingon149118: posts the ante 500
Venycyos: posts the ante 500
Kevin12345Mc: posts the ante 500
Gomez224: posts the ante 500
smoke aces7: posts the ante 500
mimacach: posts the ante 500
High Goblin: posts the ante 500
smoke aces7: posts small blind 2000
mimacach: posts big blind 4000
*** HOLE CARDS ***
Dealt to Kevin12345Mc [8d 9c]
High Goblin: folds 
Sergeygto: folds 
fingon149118: calls 4000
Venycyos: folds 
Kevin12345Mc: folds 
Gomez224: folds 
smoke aces7: folds 
mimacach: checks 
*** FLOP *** [Jh 8c Ts]
mimacach: checks 
fingon149118: bets 4000
mimacach: calls 4000
*** TURN *** [Jh 8c Ts] [Kh]
mimacach: checks 
fingon149118: checks 
*** RIVER *** [Jh 8c Ts Kh] [Qc]
mimacach: checks 
fingon149118: checks 
*** SHOW DOWN ***
mimacach: shows [2s 7d] (high card King)
fingon149118: shows [6d 6s] (a pair of Sixes)
fingon149118 collected 22000 from pot
*** SUMMARY ***
Total pot 22000 | Rake 0 
Board [Jh 8c Ts Kh Qc]
Seat 1: Sergeygto folded before Flop (didn't bet)
Seat 2: fingon149118 showed [6d 6s] and won (22000) with a pair of Sixes
Seat 3: Venycyos folded before Flop (didn't bet)
Seat 4: Kevin12345Mc folded before Flop (didn't bet)
Seat 5: Gomez224 (button) folded before Flop (didn't bet)
Seat 6: smoke aces7 (small blind) folded before Flop
Seat 7: mimacach (big blind) showed [2s 7d] and lost with high card King
Seat 8: High Goblin folded before Flop (didn't bet)



PokerStars Hand #254866348163: Tournament #3856223586, $2.45+$2.45+$0.60 USD Hold'em No Limit - Level XXIII (4000/8000) - 2025/02/14 21:01:26 WET [2025/02/14 16:01:26 ET]
Table '3856223586 233' 8-max Seat #6 is the button
Seat 1: MarceloRLC (104708 in chips, $8.55 bounty) 
Seat 2: slothi (580210 in chips, $14.96 bounty) 
Seat 3: Venycyos (551774 in chips, $8.56 bounty) 
Seat 4: Kevin12345Mc (201940 in chips, $7.30 bounty) 
Seat 5: Gomez224 (216417 in chips, $4.89 bounty) 
Seat 6: scoubyyy (363658 in chips, $9.77 bounty) 
Seat 7: SauloBet (131788 in chips, $6.72 bounty) 
Seat 8: High Goblin (295053 in chips, $18.01 bounty) 
MarceloRLC: posts the ante 1000
slothi: posts the ante 1000
Venycyos: posts the ante 1000
Kevin12345Mc: posts the ante 1000
Gomez224: posts the ante 1000
scoubyyy: posts the ante 1000
SauloBet: posts the ante 1000
High Goblin: posts the ante 1000
SauloBet: posts small blind 4000
High Goblin: posts big blind 8000
*** HOLE CARDS ***
Dealt to Kevin12345Mc [9c 8d]
MarceloRLC: folds 
slothi: folds 
Venycyos: raises 8000 to 16000
Kevin12345Mc: folds 
Gomez224: folds 
scoubyyy: calls 16000
SauloBet: folds 
High Goblin: folds 
*** FLOP *** [Js Kc 7d]
Venycyos: bets 17160
scoubyyy: calls 17160
*** TURN *** [Js Kc 7d] [Qc]
Venycyos: checks 
scoubyyy: bets 43160
Venycyos: calls 43160
*** RIVER *** [Js Kc 7d Qc] [4d]
Venycyos: checks 
scoubyyy: bets 70320
Venycyos: calls 70320
*** SHOW DOWN ***
scoubyyy: shows [9h Ts] (a straight, Nine to King)
Venycyos: mucks hand 
scoubyyy collected 313280 from pot
*** SUMMARY ***
Total pot 313280 | Rake 0 
Board [Js Kc 7d Qc 4d]
Seat 1: MarceloRLC folded before Flop (didn't bet)
Seat 2: slothi folded before Flop (didn't bet)
Seat 3: Venycyos mucked [Qs Ah]
Seat 4: Kevin12345Mc folded before Flop (didn't bet)
Seat 5: Gomez224 folded before Flop (didn't bet)
Seat 6: scoubyyy (button) showed [9h Ts] and won (313280) with a straight, Nine to King
Seat 7: SauloBet (small blind) folded before Flop
Seat 8: High Goblin (big blind) folded before Flop



PokerStars Hand #254866377912: Tournament #3856223586, $2.45+$2.45+$0.60 USD Hold'em No Limit - Level XXIV (5000/10000) - 2025/02/14 21:03:14 WET [2025/02/14 16:03:14 ET]
Table '3856223586 233' 8-max Seat #7 is the button
Seat 1: MarceloRLC (103708 in chips, $8.55 bounty) 
Seat 2: slothi (579210 in chips, $14.96 bounty) 
Seat 3: Venycyos (404134 in chips, $8.56 bounty) 
Seat 4: Kevin12345Mc (200940 in chips, $7.30 bounty) 
Seat 5: Gomez224 (215417 in chips, $4.89 bounty) 
Seat 6: scoubyyy (529298 in chips, $9.77 bounty) 
Seat 7: SauloBet (126788 in chips, $6.72 bounty) 
Seat 8: High Goblin (286053 in chips, $18.01 bounty) 
MarceloRLC: posts the ante 1250
slothi: posts the ante 1250
Venycyos: posts the ante 1250
Kevin12345Mc: posts the ante 1250
Gomez224: posts the ante 1250
scoubyyy: posts the ante 1250
SauloBet: posts the ante 1250
High Goblin: posts the ante 1250
High Goblin: posts small blind 5000
MarceloRLC: posts big blind 10000
*** HOLE CARDS ***
Dealt to Kevin12345Mc [7c 5s]
slothi: folds 
Venycyos: folds 
Kevin12345Mc: folds 
Gomez224: folds 
scoubyyy: raises 15000 to 25000
SauloBet: folds 
High Goblin: folds 
MarceloRLC: calls 15000
*** FLOP *** [9s Jh Jc]
MarceloRLC: checks 
scoubyyy: checks 
*** TURN *** [9s Jh Jc] [Kd]
MarceloRLC: bets 10000
scoubyyy: calls 10000
*** RIVER *** [9s Jh Jc Kd] [8c]
MarceloRLC: checks 
scoubyyy: bets 493048 and is all-in
MarceloRLC: calls 67458 and is all-in
Uncalled bet (425590) returned to scoubyyy
*** SHOW DOWN ***
scoubyyy: shows [Ks Ac] (two pair, Kings and Jacks)
MarceloRLC: shows [Qd Jd] (three of a kind, Jacks)
MarceloRLC collected 219916 from pot
*** SUMMARY ***
Total pot 219916 | Rake 0 
Board [9s Jh Jc Kd 8c]
Seat 1: MarceloRLC (big blind) showed [Qd Jd] and won (219916) with three of a kind, Jacks
Seat 2: slothi folded before Flop (didn't bet)
Seat 3: Venycyos folded before Flop (didn't bet)
Seat 4: Kevin12345Mc folded before Flop (didn't bet)
Seat 5: Gomez224 folded before Flop (didn't bet)
Seat 6: scoubyyy showed [Ks Ac] and lost with two pair, Kings and Jacks
Seat 7: SauloBet (button) folded before Flop (didn't bet)
Seat 8: High Goblin (small blind) folded before Flop



PokerStars Hand #254866391687: Tournament #3856223586, $2.45+$2.45+$0.60 USD Hold'em No Limit - Level XXIV (5000/10000) - 2025/02/14 21:04:03 WET [2025/02/14 16:04:03 ET]
Table '3856223586 233' 8-max Seat #8 is the button
Seat 1: MarceloRLC (219916 in chips, $8.55 bounty) 
Seat 2: slothi (577960 in chips, $14.96 bounty) 
Seat 3: Venycyos (402884 in chips, $8.56 bounty) 
Seat 4: Kevin12345Mc (199690 in chips, $7.30 bounty) 
Seat 5: Gomez224 (214167 in chips, $4.89 bounty) 
Seat 6: scoubyyy (425590 in chips, $9.77 bounty) 
Seat 7: SauloBet (125538 in chips, $6.72 bounty) 
Seat 8: High Goblin (279803 in chips, $18.01 bounty) 
MarceloRLC: posts the ante 1250
slothi: posts the ante 1250
Venycyos: posts the ante 1250
Kevin12345Mc: posts the ante 1250
Gomez224: posts the ante 1250
scoubyyy: posts the ante 1250
SauloBet: posts the ante 1250
High Goblin: posts the ante 1250
MarceloRLC: posts small blind 5000
slothi: posts big blind 10000
*** HOLE CARDS ***
Dealt to Kevin12345Mc [3h 2h]
Venycyos: folds 
Kevin12345Mc: folds 
Gomez224: folds 
scoubyyy: folds 
SauloBet: raises 10000 to 20000
High Goblin: folds 
MarceloRLC: folds 
slothi: calls 10000
*** FLOP *** [Js 4c 6h]
slothi: checks 
SauloBet: checks 
*** TURN *** [Js 4c 6h] [5c]
slothi: bets 21450
SauloBet: calls 21450
*** RIVER *** [Js 4c 6h 5c] [3c]
slothi: checks 
SauloBet: bets 82838 and is all-in
slothi: calls 82838
*** SHOW DOWN ***
SauloBet: shows [As 7s] (a straight, Three to Seven)
slothi: shows [Tc Jh] (a pair of Jacks)
SauloBet collected 263576 from pot
*** SUMMARY ***
Total pot 263576 | Rake 0 
Board [Js 4c 6h 5c 3c]
Seat 1: MarceloRLC (small blind) folded before Flop
Seat 2: slothi (big blind) showed [Tc Jh] and lost with a pair of Jacks
Seat 3: Venycyos folded before Flop (didn't bet)
Seat 4: Kevin12345Mc folded before Flop (didn't bet)
Seat 5: Gomez224 folded before Flop (didn't bet)
Seat 6: scoubyyy folded before Flop (didn't bet)
Seat 7: SauloBet showed [As 7s] and won (263576) with a straight, Three to Seven
Seat 8: High Goblin (button) folded before Flop (didn't bet)



PokerStars Hand #254866413137: Tournament #3856223586, $2.45+$2.45+$0.60 USD Hold'em No Limit - Level XXIV (5000/10000) - 2025/02/14 21:05:18 WET [2025/02/14 16:05:18 ET]
Table '3856223586 233' 8-max Seat #1 is the button
Seat 1: MarceloRLC (213666 in chips, $8.55 bounty) 
Seat 2: slothi (452422 in chips, $14.96 bounty) 
Seat 3: Venycyos (401634 in chips, $8.56 bounty) 
Seat 4: Kevin12345Mc (198440 in chips, $7.30 bounty) 
Seat 5: Gomez224 (212917 in chips, $4.89 bounty) 
Seat 6: scoubyyy (424340 in chips, $9.77 bounty) 
Seat 7: SauloBet (263576 in chips, $6.72 bounty) 
Seat 8: High Goblin (278553 in chips, $18.01 bounty) 
MarceloRLC: posts the ante 1250
slothi: posts the ante 1250
Venycyos: posts the ante 1250
Kevin12345Mc: posts the ante 1250
Gomez224: posts the ante 1250
scoubyyy: posts the ante 1250
SauloBet: posts the ante 1250
High Goblin: posts the ante 1250
slothi: posts small blind 5000
Venycyos: posts big blind 10000
*** HOLE CARDS ***
Dealt to Kevin12345Mc [Jc 4h]
Kevin12345Mc: folds 
Gomez224: folds 
scoubyyy: folds 
SauloBet: folds 
High Goblin: raises 10000 to 20000
MarceloRLC: folds 
slothi: folds 
Venycyos: calls 10000
*** FLOP *** [Ks Ah Kc]
Venycyos: checks 
High Goblin: bets 10000
Venycyos: folds 
Uncalled bet (10000) returned to High Goblin
High Goblin collected 55000 from pot
High Goblin: doesn't show hand 
*** SUMMARY ***
Total pot 55000 | Rake 0 
Board [Ks Ah Kc]
Seat 1: MarceloRLC (button) folded before Flop (didn't bet)
Seat 2: slothi (small blind) folded before Flop
Seat 3: Venycyos (big blind) folded on the Flop
Seat 4: Kevin12345Mc folded before Flop (didn't bet)
Seat 5: Gomez224 folded before Flop (didn't bet)
Seat 6: scoubyyy folded before Flop (didn't bet)
Seat 7: SauloBet folded before Flop (didn't bet)
Seat 8: High Goblin collected (55000)



PokerStars Hand #254866425306: Tournament #3856223586, $2.45+$2.45+$0.60 USD Hold'em No Limit - Level XXIV (5000/10000) - 2025/02/14 21:06:00 WET [2025/02/14 16:06:00 ET]
Table '3856223586 233' 8-max Seat #2 is the button
Seat 1: MarceloRLC (212416 in chips, $8.55 bounty) 
Seat 2: slothi (446172 in chips, $14.96 bounty) 
Seat 3: Venycyos (380384 in chips, $8.56 bounty) 
Seat 4: Kevin12345Mc (197190 in chips, $7.30 bounty) 
Seat 5: Gomez224 (211667 in chips, $4.89 bounty) 
Seat 6: scoubyyy (423090 in chips, $9.77 bounty) 
Seat 7: SauloBet (262326 in chips, $6.72 bounty) 
Seat 8: High Goblin (312303 in chips, $18.01 bounty) 
MarceloRLC: posts the ante 1250
slothi: posts the ante 1250
Venycyos: posts the ante 1250
Kevin12345Mc: posts the ante 1250
Gomez224: posts the ante 1250
scoubyyy: posts the ante 1250
SauloBet: posts the ante 1250
High Goblin: posts the ante 1250
Venycyos: posts small blind 5000
Kevin12345Mc: posts big blind 10000
*** HOLE CARDS ***
Dealt to Kevin12345Mc [3c Tc]
Gomez224: folds 
scoubyyy: folds 
SauloBet: folds 
High Goblin: raises 10000 to 20000
MarceloRLC: folds 
slothi: folds 
Venycyos: folds 
Kevin12345Mc: calls 10000
*** FLOP *** [Js Kd 9c]
Kevin12345Mc: checks 
High Goblin: bets 15000
Kevin12345Mc: folds 
Uncalled bet (15000) returned to High Goblin
High Goblin collected 55000 from pot
High Goblin: doesn't show hand 
*** SUMMARY ***
Total pot 55000 | Rake 0 
Board [Js Kd 9c]
Seat 1: MarceloRLC folded before Flop (didn't bet)
Seat 2: slothi (button) folded before Flop (didn't bet)
Seat 3: Venycyos (small blind) folded before Flop
Seat 4: Kevin12345Mc (big blind) folded on the Flop
Seat 5: Gomez224 folded before Flop (didn't bet)
Seat 6: scoubyyy folded before Flop (didn't bet)
Seat 7: SauloBet folded before Flop (didn't bet)
Seat 8: High Goblin collected (55000)



PokerStars Hand #254866437406: Tournament #3856223586, $2.45+$2.45+$0.60 USD Hold'em No Limit - Level XXIV (5000/10000) - 2025/02/14 21:06:42 WET [2025/02/14 16:06:42 ET]
Table '3856223586 233' 8-max Seat #3 is the button
Seat 1: MarceloRLC (211166 in chips, $8.55 bounty) 
Seat 2: slothi (444922 in chips, $14.96 bounty) 
Seat 3: Venycyos (374134 in chips, $8.56 bounty) 
Seat 4: Kevin12345Mc (175940 in chips, $7.30 bounty) 
Seat 5: Gomez224 (210417 in chips, $4.89 bounty) 
Seat 6: scoubyyy (421840 in chips, $9.77 bounty) 
Seat 7: SauloBet (261076 in chips, $6.72 bounty) 
Seat 8: High Goblin (346053 in chips, $18.01 bounty) 
MarceloRLC: posts the ante 1250
slothi: posts the ante 1250
Venycyos: posts the ante 1250
Kevin12345Mc: posts the ante 1250
Gomez224: posts the ante 1250
scoubyyy: posts the ante 1250
SauloBet: posts the ante 1250
High Goblin: posts the ante 1250
Kevin12345Mc: posts small blind 5000
Gomez224: posts big blind 10000
*** HOLE CARDS ***
Dealt to Kevin12345Mc [Td 4d]
scoubyyy: raises 15000 to 25000
SauloBet: folds 
High Goblin: folds 
MarceloRLC: folds 
slothi: folds 
Venycyos: calls 25000
Kevin12345Mc: folds 
Gomez224: folds 
*** FLOP *** [Kd Jh 7d]
scoubyyy: bets 20000
Venycyos: calls 20000
*** TURN *** [Kd Jh 7d] [5d]
scoubyyy: checks 
Venycyos: checks 
*** RIVER *** [Kd Jh 7d 5d] [2c]
scoubyyy: checks 
Venycyos: checks 
*** SHOW DOWN ***
scoubyyy: shows [Ac Kc] (a pair of Kings)
Venycyos: mucks hand 
scoubyyy collected 115000 from pot
*** SUMMARY ***
Total pot 115000 | Rake 0 
Board [Kd Jh 7d 5d 2c]
Seat 1: MarceloRLC folded before Flop (didn't bet)
Seat 2: slothi folded before Flop (didn't bet)
Seat 3: Venycyos (button) mucked [Jc 9c]
Seat 4: Kevin12345Mc (small blind) folded before Flop
Seat 5: Gomez224 (big blind) folded before Flop
Seat 6: scoubyyy showed [Ac Kc] and won (115000) with a pair of Kings
Seat 7: SauloBet folded before Flop (didn't bet)
Seat 8: High Goblin folded before Flop (didn't bet)



PokerStars Hand #254866451918: Tournament #3856223586, $2.45+$2.45+$0.60 USD Hold'em No Limit - Level XXIV (5000/10000) - 2025/02/14 21:07:32 WET [2025/02/14 16:07:32 ET]
Table '3856223586 233' 8-max Seat #4 is the button
Seat 1: MarceloRLC (209916 in chips, $8.55 bounty) 
Seat 2: slothi (443672 in chips, $14.96 bounty) 
Seat 3: Venycyos (327884 in chips, $8.56 bounty) 
Seat 4: Kevin12345Mc (169690 in chips, $7.30 bounty) 
Seat 5: Gomez224 (199167 in chips, $4.89 bounty) 
Seat 6: scoubyyy (490590 in chips, $9.77 bounty) 
Seat 7: SauloBet (259826 in chips, $6.72 bounty) 
Seat 8: High Goblin (344803 in chips, $18.01 bounty) 
MarceloRLC: posts the ante 1250
slothi: posts the ante 1250
Venycyos: posts the ante 1250
Kevin12345Mc: posts the ante 1250
Gomez224: posts the ante 1250
scoubyyy: posts the ante 1250
SauloBet: posts the ante 1250
High Goblin: posts the ante 1250
Gomez224: posts small blind 5000
scoubyyy: posts big blind 10000
*** HOLE CARDS ***
Dealt to Kevin12345Mc [5s Qs]
SauloBet: folds 
High Goblin: folds 
MarceloRLC: folds 
slothi: folds 
Venycyos: raises 10000 to 20000
Kevin12345Mc: folds 
Gomez224: folds 
scoubyyy: raises 40000 to 60000
Venycyos: calls 40000
*** FLOP *** [3h 4h 8c]
scoubyyy: bets 40000
Venycyos: calls 40000
*** TURN *** [3h 4h 8c] [8s]
scoubyyy: bets 389340 and is all-in
Venycyos: calls 226634 and is all-in
Uncalled bet (162706) returned to scoubyyy
*** RIVER *** [3h 4h 8c 8s] [Kd]
*** SHOW DOWN ***
scoubyyy: shows [Jc Jd] (two pair, Jacks and Eights)
Venycyos: shows [7s 7d] (two pair, Eights and Sevens)
scoubyyy collected 668268 from pot
scoubyyy wins $4.28 for eliminating Venycyos and their own bounty increases by $4.28 to $14.05
Venycyos finished the tournament in 279th place and received $7.92.
*** SUMMARY ***
Total pot 668268 | Rake 0 
Board [3h 4h 8c 8s Kd]
Seat 1: MarceloRLC folded before Flop (didn't bet)
Seat 2: slothi folded before Flop (didn't bet)
Seat 3: Venycyos showed [7s 7d] and lost with two pair, Eights and Sevens
Seat 4: Kevin12345Mc (button) folded before Flop (didn't bet)
Seat 5: Gomez224 (small blind) folded before Flop
Seat 6: scoubyyy (big blind) showed [Jc Jd] and won (668268) with two pair, Jacks and Eights
Seat 7: SauloBet folded before Flop (didn't bet)
Seat 8: High Goblin folded before Flop (didn't bet)



PokerStars Hand #254866473596: Tournament #3856223586, $2.45+$2.45+$0.60 USD Hold'em No Limit - Level XXIV (5000/10000) - 2025/02/14 21:08:47 WET [2025/02/14 16:08:47 ET]
Table '3856223586 233' 8-max Seat #5 is the button
Seat 1: MarceloRLC (208666 in chips, $8.55 bounty) 
Seat 2: slothi (442422 in chips, $14.96 bounty) 
Seat 4: Kevin12345Mc (168440 in chips, $7.30 bounty) 
Seat 5: Gomez224 (192917 in chips, $4.89 bounty) 
Seat 6: scoubyyy (830974 in chips, $14.05 bounty) 
Seat 7: SauloBet (258576 in chips, $6.72 bounty) 
Seat 8: High Goblin (343553 in chips, $18.01 bounty) 
MarceloRLC: posts the ante 1250
slothi: posts the ante 1250
Kevin12345Mc: posts the ante 1250
Gomez224: posts the ante 1250
scoubyyy: posts the ante 1250
SauloBet: posts the ante 1250
High Goblin: posts the ante 1250
scoubyyy: posts small blind 5000
SauloBet: posts big blind 10000
*** HOLE CARDS ***
Dealt to Kevin12345Mc [As 4d]
High Goblin: folds 
MarceloRLC: folds 
slothi: folds 
Kevin12345Mc: folds 
Gomez224: folds 
scoubyyy: calls 5000
SauloBet: checks 
*** FLOP *** [Qc Th Js]
scoubyyy: bets 10000
sachajon is disconnected 
SauloBet: calls 10000
*** TURN *** [Qc Th Js] [7h]
scoubyyy: bets 68750
SauloBet: folds 
Uncalled bet (68750) returned to scoubyyy
scoubyyy collected 48750 from pot
scoubyyy: doesn't show hand 
*** SUMMARY ***
Total pot 48750 | Rake 0 
Board [Qc Th Js 7h]
Seat 1: MarceloRLC folded before Flop (didn't bet)
Seat 2: slothi folded before Flop (didn't bet)
Seat 4: Kevin12345Mc folded before Flop (didn't bet)
Seat 5: Gomez224 (button) folded before Flop (didn't bet)
Seat 6: scoubyyy (small blind) collected (48750)
Seat 7: SauloBet (big blind) folded on the Turn
Seat 8: High Goblin folded before Flop (didn't bet)



PokerStars Hand #254866494345: Tournament #3856223586, $2.45+$2.45+$0.60 USD Hold'em No Limit - Level XXIV (5000/10000) - 2025/02/14 21:10:00 WET [2025/02/14 16:10:00 ET]
Table '3856223586 233' 8-max Seat #6 is the button
Seat 1: MarceloRLC (207416 in chips, $8.55 bounty) 
Seat 2: slothi (441172 in chips, $14.96 bounty) 
Seat 3: sachajon (304035 in chips, $7.33 bounty) 
Seat 4: Kevin12345Mc (167190 in chips, $7.30 bounty) 
Seat 5: Gomez224 (191667 in chips, $4.89 bounty) 
Seat 6: scoubyyy (858474 in chips, $14.05 bounty) 
Seat 7: SauloBet (237326 in chips, $6.72 bounty) 
Seat 8: High Goblin (342303 in chips, $18.01 bounty) 
MarceloRLC: posts the ante 1250
slothi: posts the ante 1250
sachajon: posts the ante 1250
Kevin12345Mc: posts the ante 1250
Gomez224: posts the ante 1250
scoubyyy: posts the ante 1250
SauloBet: posts the ante 1250
High Goblin: posts the ante 1250
SauloBet: posts small blind 5000
High Goblin: posts big blind 10000
*** HOLE CARDS ***
Dealt to Kevin12345Mc [7h 6s]
MarceloRLC: folds 
slothi: folds 
sachajon: folds 
Kevin12345Mc: folds 
Gomez224: raises 12000 to 22000
scoubyyy: folds 
SauloBet: folds 
High Goblin: folds 
Uncalled bet (12000) returned to Gomez224
Gomez224 collected 35000 from pot
Gomez224: doesn't show hand 
*** SUMMARY ***
Total pot 35000 | Rake 0 
Seat 1: MarceloRLC folded before Flop (didn't bet)
Seat 2: slothi folded before Flop (didn't bet)
Seat 3: sachajon folded before Flop (didn't bet)
Seat 4: Kevin12345Mc folded before Flop (didn't bet)
Seat 5: Gomez224 collected (35000)
Seat 6: scoubyyy (button) folded before Flop (didn't bet)
Seat 7: SauloBet (small blind) folded before Flop
Seat 8: High Goblin (big blind) folded before Flop



PokerStars Hand #254866499765: Tournament #3856223586, $2.45+$2.45+$0.60 USD Hold'em No Limit - Level XXV (6000/12000) - 2025/02/14 21:10:19 WET [2025/02/14 16:10:19 ET]
Table '3856223586 233' 8-max Seat #7 is the button
Seat 1: MarceloRLC (206166 in chips, $8.55 bounty) 
Seat 2: slothi (439922 in chips, $14.96 bounty) 
Seat 3: sachajon (302785 in chips, $7.33 bounty) 
Seat 4: Kevin12345Mc (165940 in chips, $7.30 bounty) 
Seat 5: Gomez224 (215417 in chips, $4.89 bounty) 
Seat 6: scoubyyy (857224 in chips, $14.05 bounty) 
Seat 7: SauloBet (231076 in chips, $6.72 bounty) 
Seat 8: High Goblin (331053 in chips, $18.01 bounty) 
MarceloRLC: posts the ante 1500
slothi: posts the ante 1500
sachajon: posts the ante 1500
Kevin12345Mc: posts the ante 1500
Gomez224: posts the ante 1500
scoubyyy: posts the ante 1500
SauloBet: posts the ante 1500
High Goblin: posts the ante 1500
High Goblin: posts small blind 6000
MarceloRLC: posts big blind 12000
*** HOLE CARDS ***
Dealt to Kevin12345Mc [9c 6h]
slothi: folds 
sachajon: calls 12000
Kevin12345Mc: folds 
Gomez224: folds 
scoubyyy: folds 
SauloBet: calls 12000
High Goblin: calls 6000
MarceloRLC: checks 
*** FLOP *** [Th 9s 7h]
High Goblin: checks 
MarceloRLC: checks 
sachajon: bets 30000
SauloBet: calls 30000
High Goblin: raises 49500 to 79500
MarceloRLC: folds 
sachajon: raises 209785 to 289285 and is all-in
SauloBet: folds 
High Goblin: calls 209785
*** TURN *** [Th 9s 7h] [Ts]
*** RIVER *** [Th 9s 7h Ts] [Qd]
*** SHOW DOWN ***
High Goblin: shows [Jd 8s] (a straight, Eight to Queen)
sachajon: shows [8h 9h] (two pair, Tens and Nines)
High Goblin collected 668570 from pot
High Goblin wins $3.67 for eliminating sachajon and their own bounty increases by $3.66 to $21.67
sachajon finished the tournament in 265th place and received $7.92.
*** SUMMARY ***
Total pot 668570 | Rake 0 
Board [Th 9s 7h Ts Qd]
Seat 1: MarceloRLC (big blind) folded on the Flop
Seat 2: slothi folded before Flop (didn't bet)
Seat 3: sachajon showed [8h 9h] and lost with two pair, Tens and Nines
Seat 4: Kevin12345Mc folded before Flop (didn't bet)
Seat 5: Gomez224 folded before Flop (didn't bet)
Seat 6: scoubyyy folded before Flop (didn't bet)
Seat 7: SauloBet (button) folded on the Flop
Seat 8: High Goblin (small blind) showed [Jd 8s] and won (668570) with a straight, Eight to Queen



PokerStars Hand #254866532440: Tournament #3856223586, $2.45+$2.45+$0.60 USD Hold'em No Limit - Level XXV (6000/12000) - 2025/02/14 21:12:11 WET [2025/02/14 16:12:11 ET]
Table '3856223586 150' 8-max Seat #4 is the button
Seat 1: Lynxzen (771606 in chips, $24.88 bounty) 
Seat 2: lucsFTG (590054 in chips, $21.67 bounty) 
Seat 3: KennenLt (545178 in chips, $2.45 bounty) 
Seat 4: gora8905 (833654 in chips, $20.76 bounty) 
Seat 5: Dimi757 (24132 in chips, $7.33 bounty) is sitting out
Seat 7: Kevin12345Mc (164440 in chips, $7.30 bounty) 
Seat 8: V HC Vega (197448 in chips, $6.72 bounty) 
Lynxzen: posts the ante 1500
lucsFTG: posts the ante 1500
KennenLt: posts the ante 1500
gora8905: posts the ante 1500
Dimi757: posts the ante 1500
Kevin12345Mc: posts the ante 1500
V HC Vega: posts the ante 1500
Dimi757: posts small blind 6000
Kevin12345Mc: posts big blind 12000
*** HOLE CARDS ***
Dealt to Kevin12345Mc [Th Qs]
V HC Vega: raises 13200 to 25200
Lynxzen: calls 25200
lucsFTG: folds 
KennenLt: folds 
urzugi is disconnected 
gora8905: calls 25200
Dimi757: folds 
Kevin12345Mc: calls 13200
*** FLOP *** [2h As 9s]
Kevin12345Mc: checks 
V HC Vega: checks 
Lynxzen: checks 
gora8905: bets 77418
Kevin12345Mc: folds 
V HC Vega: folds 
Lynxzen: folds 
Uncalled bet (77418) returned to gora8905
gora8905 collected 117300 from pot
gora8905: doesn't show hand 
*** SUMMARY ***
Total pot 117300 | Rake 0 
Board [2h As 9s]
Seat 1: Lynxzen folded on the Flop
Seat 2: lucsFTG folded before Flop (didn't bet)
Seat 3: KennenLt folded before Flop (didn't bet)
Seat 4: gora8905 (button) collected (117300)
Seat 5: Dimi757 (small blind) folded before Flop
Seat 7: Kevin12345Mc (big blind) folded on the Flop
Seat 8: V HC Vega folded on the Flop



PokerStars Hand #254866549870: Tournament #3856223586, $2.45+$2.45+$0.60 USD Hold'em No Limit - Level XXV (6000/12000) - 2025/02/14 21:13:11 WET [2025/02/14 16:13:11 ET]
Table '3856223586 150' 8-max Seat #5 is the button
Seat 1: Lynxzen (744906 in chips, $24.88 bounty) 
Seat 2: lucsFTG (588554 in chips, $21.67 bounty) 
Seat 3: KennenLt (543678 in chips, $2.45 bounty) 
Seat 4: gora8905 (924254 in chips, $20.76 bounty) 
Seat 5: Dimi757 (16632 in chips, $7.33 bounty) is sitting out
Seat 6: urzugi (243153 in chips) out of hand (moved from another table into small blind)
Seat 7: Kevin12345Mc (137740 in chips, $7.30 bounty) 
Seat 8: V HC Vega (170748 in chips, $6.72 bounty) 
urzugi will be allowed to play after the button
Lynxzen: posts the ante 1500
lucsFTG: posts the ante 1500
KennenLt: posts the ante 1500
gora8905: posts the ante 1500
Dimi757: posts the ante 1500
Kevin12345Mc: posts the ante 1500
V HC Vega: posts the ante 1500
Kevin12345Mc: posts small blind 6000
V HC Vega: posts big blind 12000
*** HOLE CARDS ***
Dealt to Kevin12345Mc [9c Ks]
Lynxzen: folds 
lucsFTG: folds 
KennenLt: folds 
gora8905: folds 
Dimi757: folds 
Kevin12345Mc: raises 124240 to 136240 and is all-in
V HC Vega: folds 
Uncalled bet (124240) returned to Kevin12345Mc
Kevin12345Mc collected 34500 from pot
Kevin12345Mc: doesn't show hand 
*** SUMMARY ***
Total pot 34500 | Rake 0 
Seat 1: Lynxzen folded before Flop (didn't bet)
Seat 2: lucsFTG folded before Flop (didn't bet)
Seat 3: KennenLt folded before Flop (didn't bet)
Seat 4: gora8905 folded before Flop (didn't bet)
Seat 5: Dimi757 (button) folded before Flop (didn't bet)
Seat 7: Kevin12345Mc (small blind) collected (34500)
Seat 8: V HC Vega (big blind) folded before Flop



PokerStars Hand #254866556592: Tournament #3856223586, $2.45+$2.45+$0.60 USD Hold'em No Limit - Level XXV (6000/12000) - 2025/02/14 21:13:34 WET [2025/02/14 16:13:34 ET]
Table '3856223586 150' 8-max Seat #7 is the button
Seat 1: Lynxzen (743406 in chips, $24.88 bounty) 
Seat 2: lucsFTG (587054 in chips, $21.67 bounty) 
Seat 3: KennenLt (542178 in chips, $2.45 bounty) 
Seat 4: gora8905 (922754 in chips, $20.76 bounty) 
Seat 5: Dimi757 (15132 in chips, $7.33 bounty) is sitting out
Seat 6: urzugi (243153 in chips, $17.25 bounty) 
Seat 7: Kevin12345Mc (158740 in chips, $7.30 bounty) 
Seat 8: V HC Vega (157248 in chips, $6.72 bounty) 
Lynxzen: posts the ante 1500
lucsFTG: posts the ante 1500
KennenLt: posts the ante 1500
gora8905: posts the ante 1500
Dimi757: posts the ante 1500
urzugi: posts the ante 1500
Kevin12345Mc: posts the ante 1500
V HC Vega: posts the ante 1500
V HC Vega: posts small blind 6000
Lynxzen: posts big blind 12000
*** HOLE CARDS ***
Dealt to Kevin12345Mc [4s 9d]
lucsFTG: raises 12000 to 24000
KennenLt: folds 
gora8905: calls 24000
Dimi757: folds 
urzugi: folds 
Kevin12345Mc: folds 
V HC Vega: raises 131748 to 155748 and is all-in
Lynxzen: folds 
lucsFTG: calls 131748
gora8905: calls 131748
*** FLOP *** [2s Kc 8h]
lucsFTG: checks 
gora8905: checks 
*** TURN *** [2s Kc 8h] [3c]
lucsFTG: checks 
gora8905: checks 
*** RIVER *** [2s Kc 8h 3c] [Th]
lucsFTG: checks 
gora8905: checks 
*** SHOW DOWN ***
V HC Vega: shows [Qc Qd] (a pair of Queens)
lucsFTG: mucks hand 
gora8905: mucks hand 
V HC Vega collected 491244 from pot
*** SUMMARY ***
Total pot 491244 | Rake 0 
Board [2s Kc 8h 3c Th]
Seat 1: Lynxzen (big blind) folded before Flop
Seat 2: lucsFTG mucked [9h Ah]
Seat 3: KennenLt folded before Flop (didn't bet)
Seat 4: gora8905 mucked [Js Jd]
Seat 5: Dimi757 folded before Flop (didn't bet)
Seat 6: urzugi folded before Flop (didn't bet)
Seat 7: Kevin12345Mc (button) folded before Flop (didn't bet)
Seat 8: V HC Vega (small blind) showed [Qc Qd] and won (491244) with a pair of Queens



PokerStars Hand #254866570738: Tournament #3856223586, $2.45+$2.45+$0.60 USD Hold'em No Limit - Level XXV (6000/12000) - 2025/02/14 21:14:23 WET [2025/02/14 16:14:23 ET]
Table '3856223586 150' 8-max Seat #8 is the button
Seat 1: Lynxzen (729906 in chips, $24.88 bounty) 
Seat 2: lucsFTG (429806 in chips, $21.67 bounty) 
Seat 3: KennenLt (540678 in chips, $2.45 bounty) 
Seat 4: gora8905 (765506 in chips, $20.76 bounty) 
Seat 5: Dimi757 (13632 in chips, $7.33 bounty) is sitting out
Seat 6: urzugi (241653 in chips, $17.25 bounty) 
Seat 7: Kevin12345Mc (157240 in chips, $7.30 bounty) 
Seat 8: V HC Vega (491244 in chips, $6.72 bounty) 
Lynxzen: posts the ante 1500
lucsFTG: posts the ante 1500
KennenLt: posts the ante 1500
gora8905: posts the ante 1500
Dimi757: posts the ante 1500
urzugi: posts the ante 1500
Kevin12345Mc: posts the ante 1500
V HC Vega: posts the ante 1500
Lynxzen: posts small blind 6000
lucsFTG: posts big blind 12000
*** HOLE CARDS ***
Dealt to Kevin12345Mc [3c 3s]
KennenLt: folds 
gora8905: folds 
Dimi757: folds 
urzugi: folds 
Kevin12345Mc: raises 143740 to 155740 and is all-in
V HC Vega: folds 
Lynxzen: folds 
lucsFTG: folds 
Uncalled bet (143740) returned to Kevin12345Mc
Kevin12345Mc collected 42000 from pot
Kevin12345Mc: doesn't show hand 
*** SUMMARY ***
Total pot 42000 | Rake 0 
Seat 1: Lynxzen (small blind) folded before Flop
Seat 2: lucsFTG (big blind) folded before Flop
Seat 3: KennenLt folded before Flop (didn't bet)
Seat 4: gora8905 folded before Flop (didn't bet)
Seat 5: Dimi757 folded before Flop (didn't bet)
Seat 6: urzugi folded before Flop (didn't bet)
Seat 7: Kevin12345Mc collected (42000)
Seat 8: V HC Vega (button) folded before Flop (didn't bet)



PokerStars Hand #254866578109: Tournament #3856223586, $2.45+$2.45+$0.60 USD Hold'em No Limit - Level XXV (6000/12000) - 2025/02/14 21:14:48 WET [2025/02/14 16:14:48 ET]
Table '3856223586 150' 8-max Seat #1 is the button
Seat 1: Lynxzen (722406 in chips, $24.88 bounty) 
Seat 2: lucsFTG (416306 in chips, $21.67 bounty) 
Seat 3: KennenLt (539178 in chips, $2.45 bounty) 
Seat 4: gora8905 (764006 in chips, $20.76 bounty) 
Seat 5: Dimi757 (12132 in chips, $7.33 bounty) is sitting out
Seat 6: urzugi (240153 in chips, $17.25 bounty) 
Seat 7: Kevin12345Mc (185740 in chips, $7.30 bounty) 
Seat 8: V HC Vega (489744 in chips, $6.72 bounty) 
Lynxzen: posts the ante 1500
lucsFTG: posts the ante 1500
KennenLt: posts the ante 1500
gora8905: posts the ante 1500
Dimi757: posts the ante 1500
urzugi: posts the ante 1500
Kevin12345Mc: posts the ante 1500
V HC Vega: posts the ante 1500
lucsFTG: posts small blind 6000
KennenLt: posts big blind 12000
*** HOLE CARDS ***
Dealt to Kevin12345Mc [8h 8c]
gora8905: folds 
Dimi757: folds 
urzugi: folds 
Kevin12345Mc: raises 172240 to 184240 and is all-in
V HC Vega: folds 
Lynxzen: folds 
lucsFTG: folds 
KennenLt: folds 
Uncalled bet (172240) returned to Kevin12345Mc
Kevin12345Mc collected 42000 from pot
Kevin12345Mc: doesn't show hand 
*** SUMMARY ***
Total pot 42000 | Rake 0 
Seat 1: Lynxzen (button) folded before Flop (didn't bet)
Seat 2: lucsFTG (small blind) folded before Flop
Seat 3: KennenLt (big blind) folded before Flop
Seat 4: gora8905 folded before Flop (didn't bet)
Seat 5: Dimi757 folded before Flop (didn't bet)
Seat 6: urzugi folded before Flop (didn't bet)
Seat 7: Kevin12345Mc collected (42000)
Seat 8: V HC Vega folded before Flop (didn't bet)



PokerStars Hand #254866585536: Tournament #3856223586, $2.45+$2.45+$0.60 USD Hold'em No Limit - Level XXV (6000/12000) - 2025/02/14 21:15:13 WET [2025/02/14 16:15:13 ET]
Table '3856223586 150' 8-max Seat #2 is the button
Seat 1: Lynxzen (720906 in chips, $24.88 bounty) 
Seat 2: lucsFTG (408806 in chips, $21.67 bounty) 
Seat 3: KennenLt (525678 in chips, $2.45 bounty) 
Seat 4: gora8905 (762506 in chips, $20.76 bounty) 
Seat 5: Dimi757 (10632 in chips, $7.33 bounty) is sitting out
Seat 6: urzugi (238653 in chips, $17.25 bounty) 
Seat 7: Kevin12345Mc (214240 in chips, $7.30 bounty) 
Seat 8: V HC Vega (488244 in chips, $6.72 bounty) 
Lynxzen: posts the ante 1500
lucsFTG: posts the ante 1500
KennenLt: posts the ante 1500
gora8905: posts the ante 1500
Dimi757: posts the ante 1500
urzugi: posts the ante 1500
Kevin12345Mc: posts the ante 1500
V HC Vega: posts the ante 1500
KennenLt: posts small blind 6000
gora8905: posts big blind 12000
*** HOLE CARDS ***
Dealt to Kevin12345Mc [4s As]
Dimi757: folds 
urzugi: raises 24000 to 36000
Kevin12345Mc: folds 
V HC Vega: folds 
Lynxzen: folds 
lucsFTG: folds 
KennenLt: folds 
gora8905: calls 24000
*** FLOP *** [Kh Jc 6s]
gora8905: checks 
urzugi: bets 201153 and is all-in
gora8905: folds 
Uncalled bet (201153) returned to urzugi
urzugi collected 90000 from pot
*** SUMMARY ***
Total pot 90000 | Rake 0 
Board [Kh Jc 6s]
Seat 1: Lynxzen folded before Flop (didn't bet)
Seat 2: lucsFTG (button) folded before Flop (didn't bet)
Seat 3: KennenLt (small blind) folded before Flop
Seat 4: gora8905 (big blind) folded on the Flop
Seat 5: Dimi757 folded before Flop (didn't bet)
Seat 6: urzugi collected (90000)
Seat 7: Kevin12345Mc folded before Flop (didn't bet)
Seat 8: V HC Vega folded before Flop (didn't bet)



PokerStars Hand #254866597500: Tournament #3856223586, $2.45+$2.45+$0.60 USD Hold'em No Limit - Level XXV (6000/12000) - 2025/02/14 21:15:54 WET [2025/02/14 16:15:54 ET]
Table '3856223586 150' 8-max Seat #3 is the button
Seat 1: Lynxzen (719406 in chips, $24.88 bounty) 
Seat 2: lucsFTG (407306 in chips, $21.67 bounty) 
Seat 3: KennenLt (518178 in chips, $2.45 bounty) 
Seat 4: gora8905 (725006 in chips, $20.76 bounty) 
Seat 5: Dimi757 (9132 in chips, $7.33 bounty) is sitting out
Seat 6: urzugi (291153 in chips, $17.25 bounty) 
Seat 7: Kevin12345Mc (212740 in chips, $7.30 bounty) 
Seat 8: V HC Vega (486744 in chips, $6.72 bounty) 
Lynxzen: posts the ante 1500
lucsFTG: posts the ante 1500
KennenLt: posts the ante 1500
gora8905: posts the ante 1500
Dimi757: posts the ante 1500
urzugi: posts the ante 1500
Kevin12345Mc: posts the ante 1500
V HC Vega: posts the ante 1500
gora8905: posts small blind 6000
Dimi757: posts big blind 7632 and is all-in
*** HOLE CARDS ***
Dealt to Kevin12345Mc [5s 9s]
urzugi: folds 
Kevin12345Mc: folds 
V HC Vega: raises 28368 to 36000
Lynxzen: folds 
lucsFTG: calls 36000
KennenLt: folds 
gora8905: calls 30000
Dimi757: folds 
*** FLOP *** [Qh 7h Js]
gora8905: checks 
V HC Vega: checks 
lucsFTG: bets 63816
gora8905: folds 
V HC Vega: folds 
Uncalled bet (63816) returned to lucsFTG
lucsFTG collected 127632 from pot
lucsFTG wins $3.67 for eliminating Dimi757 and their own bounty increases by $3.66 to $25.33
Dimi757 finished the tournament in 237th place and received $7.92.
*** SUMMARY ***
Total pot 127632 | Rake 0 
Board [Qh 7h Js]
Seat 1: Lynxzen folded before Flop (didn't bet)
Seat 2: lucsFTG collected (127632)
Seat 3: KennenLt (button) folded before Flop (didn't bet)
Seat 4: gora8905 (small blind) folded on the Flop
Seat 5: Dimi757 (big blind) folded before Flop
Seat 6: urzugi folded before Flop (didn't bet)
Seat 7: Kevin12345Mc folded before Flop (didn't bet)
Seat 8: V HC Vega folded on the Flop



PokerStars Hand #254866613348: Tournament #3856223586, $2.45+$2.45+$0.60 USD Hold'em No Limit - Level XXV (6000/12000) - 2025/02/14 21:16:48 WET [2025/02/14 16:16:48 ET]
Table '3856223586 150' 8-max Seat #4 is the button
Seat 1: Lynxzen (717906 in chips, $24.88 bounty) 
Seat 2: lucsFTG (497438 in chips, $25.33 bounty) 
Seat 3: KennenLt (516678 in chips, $2.45 bounty) 
Seat 4: gora8905 (687506 in chips, $20.76 bounty) 
Seat 6: urzugi (289653 in chips, $17.25 bounty) 
Seat 7: Kevin12345Mc (211240 in chips, $7.30 bounty) 
Seat 8: V HC Vega (449244 in chips, $6.72 bounty) 
Lynxzen: posts the ante 1500
lucsFTG: posts the ante 1500
KennenLt: posts the ante 1500
gora8905: posts the ante 1500
urzugi: posts the ante 1500
Kevin12345Mc: posts the ante 1500
V HC Vega: posts the ante 1500
urzugi: posts small blind 6000
Kevin12345Mc: posts big blind 12000
*** HOLE CARDS ***
Dealt to Kevin12345Mc [Ac 3d]
V HC Vega: folds 
Lynxzen: folds 
lucsFTG: folds 
KennenLt: folds 
gora8905: raises 12000 to 24000
artur145 is disconnected 
urzugi: folds 
Kevin12345Mc: raises 185740 to 209740 and is all-in
gora8905: folds 
Uncalled bet (185740) returned to Kevin12345Mc
Kevin12345Mc collected 64500 from pot
Kevin12345Mc: doesn't show hand 
*** SUMMARY ***
Total pot 64500 | Rake 0 
Seat 1: Lynxzen folded before Flop (didn't bet)
Seat 2: lucsFTG folded before Flop (didn't bet)
Seat 3: KennenLt folded before Flop (didn't bet)
Seat 4: gora8905 (button) folded before Flop
Seat 6: urzugi (small blind) folded before Flop
Seat 7: Kevin12345Mc (big blind) collected (64500)
Seat 8: V HC Vega folded before Flop (didn't bet)



PokerStars Hand #254866621520: Tournament #3856223586, $2.45+$2.45+$0.60 USD Hold'em No Limit - Level XXV (6000/12000) - 2025/02/14 21:17:17 WET [2025/02/14 16:17:17 ET]
Table '3856223586 150' 8-max Seat #6 is the button
Seat 1: Lynxzen (716406 in chips, $24.88 bounty) 
Seat 2: lucsFTG (495938 in chips, $25.33 bounty) 
Seat 3: KennenLt (515178 in chips, $2.45 bounty) 
Seat 4: gora8905 (662006 in chips, $20.76 bounty) 
Seat 5: artur145 (645117 in chips, $15.11 bounty) 
Seat 6: urzugi (282153 in chips, $17.25 bounty) 
Seat 7: Kevin12345Mc (250240 in chips, $7.30 bounty) 
Seat 8: V HC Vega (447744 in chips, $6.72 bounty) 
Lynxzen: posts the ante 1500
lucsFTG: posts the ante 1500
KennenLt: posts the ante 1500
gora8905: posts the ante 1500
artur145: posts the ante 1500
urzugi: posts the ante 1500
Kevin12345Mc: posts the ante 1500
V HC Vega: posts the ante 1500
Kevin12345Mc: posts small blind 6000
V HC Vega: posts big blind 12000
*** HOLE CARDS ***
Dealt to Kevin12345Mc [Kd Qh]
Lynxzen: folds 
lucsFTG: folds 
KennenLt: folds 
gora8905: folds 
artur145: folds 
urzugi: folds 
Kevin12345Mc: raises 24000 to 36000
V HC Vega: raises 410244 to 446244 and is all-in
Kevin12345Mc: calls 212740 and is all-in
Uncalled bet (197504) returned to V HC Vega
*** FLOP *** [Qd 9d 4d]
*** TURN *** [Qd 9d 4d] [Jc]
*** RIVER *** [Qd 9d 4d Jc] [Ks]
*** SHOW DOWN ***
Kevin12345Mc: shows [Kd Qh] (two pair, Kings and Queens)
V HC Vega: shows [7h Ac] (high card Ace)
Kevin12345Mc collected 509480 from pot
*** SUMMARY ***
Total pot 509480 | Rake 0 
Board [Qd 9d 4d Jc Ks]
Seat 1: Lynxzen folded before Flop (didn't bet)
Seat 2: lucsFTG folded before Flop (didn't bet)
Seat 3: KennenLt folded before Flop (didn't bet)
Seat 4: gora8905 folded before Flop (didn't bet)
Seat 5: artur145 folded before Flop (didn't bet)
Seat 6: urzugi (button) folded before Flop (didn't bet)
Seat 7: Kevin12345Mc (small blind) showed [Kd Qh] and won (509480) with two pair, Kings and Queens
Seat 8: V HC Vega (big blind) showed [7h Ac] and lost with high card Ace



PokerStars Hand #254866633565: Tournament #3856223586, $2.45+$2.45+$0.60 USD Hold'em No Limit - Level XXV (6000/12000) - 2025/02/14 21:17:58 WET [2025/02/14 16:17:58 ET]
Table '3856223586 150' 8-max Seat #7 is the button
Seat 1: Lynxzen (714906 in chips, $24.88 bounty) 
Seat 2: lucsFTG (494438 in chips, $25.33 bounty) 
Seat 3: KennenLt (513678 in chips, $2.45 bounty) 
Seat 4: gora8905 (660506 in chips, $20.76 bounty) 
Seat 5: artur145 (643617 in chips, $15.11 bounty) 
Seat 6: urzugi (280653 in chips, $17.25 bounty) 
Seat 7: Kevin12345Mc (509480 in chips, $7.30 bounty) 
Seat 8: V HC Vega (197504 in chips, $6.72 bounty) 
Lynxzen: posts the ante 1500
lucsFTG: posts the ante 1500
KennenLt: posts the ante 1500
gora8905: posts the ante 1500
artur145: posts the ante 1500
urzugi: posts the ante 1500
Kevin12345Mc: posts the ante 1500
V HC Vega: posts the ante 1500
V HC Vega: posts small blind 6000
Lynxzen: posts big blind 12000
*** HOLE CARDS ***
Dealt to Kevin12345Mc [2c 8d]
lucsFTG: folds 
KennenLt: folds 
gora8905: folds 
artur145: folds 
urzugi: folds 
Kevin12345Mc: folds 
V HC Vega: calls 6000
Lynxzen: checks 
*** FLOP *** [3d 6h 4s]
V HC Vega: bets 12000
Lynxzen: calls 12000
*** TURN *** [3d 6h 4s] [4d]
V HC Vega: checks 
Lynxzen: checks 
*** RIVER *** [3d 6h 4s 4d] [6c]
V HC Vega: checks 
Lynxzen: checks 
*** SHOW DOWN ***
V HC Vega: shows [8s Kc] (two pair, Sixes and Fours)
Lynxzen: mucks hand 
V HC Vega collected 60000 from pot
*** SUMMARY ***
Total pot 60000 | Rake 0 
Board [3d 6h 4s 4d 6c]
Seat 1: Lynxzen (big blind) mucked [Th 7c]
Seat 2: lucsFTG folded before Flop (didn't bet)
Seat 3: KennenLt folded before Flop (didn't bet)
Seat 4: gora8905 folded before Flop (didn't bet)
Seat 5: artur145 folded before Flop (didn't bet)
Seat 6: urzugi folded before Flop (didn't bet)
Seat 7: Kevin12345Mc (button) folded before Flop (didn't bet)
Seat 8: V HC Vega (small blind) showed [8s Kc] and won (60000) with two pair, Sixes and Fours



PokerStars Hand #254866649322: Tournament #3856223586, $2.45+$2.45+$0.60 USD Hold'em No Limit - Level XXVI (7000/14000) - 2025/02/14 21:18:51 WET [2025/02/14 16:18:51 ET]
Table '3856223586 150' 8-max Seat #8 is the button
Seat 1: Lynxzen (689406 in chips, $24.88 bounty) 
Seat 2: lucsFTG (492938 in chips, $25.33 bounty) 
Seat 3: KennenLt (512178 in chips, $2.45 bounty) 
Seat 4: gora8905 (659006 in chips, $20.76 bounty) 
Seat 5: artur145 (642117 in chips, $15.11 bounty) 
Seat 6: urzugi (279153 in chips, $17.25 bounty) 
Seat 7: Kevin12345Mc (507980 in chips, $7.30 bounty) 
Seat 8: V HC Vega (232004 in chips, $6.72 bounty) 
Lynxzen: posts the ante 1750
lucsFTG: posts the ante 1750
KennenLt: posts the ante 1750
gora8905: posts the ante 1750
artur145: posts the ante 1750
urzugi: posts the ante 1750
Kevin12345Mc: posts the ante 1750
V HC Vega: posts the ante 1750
Lynxzen: posts small blind 7000
lucsFTG: posts big blind 14000
*** HOLE CARDS ***
Dealt to Kevin12345Mc [2s 3d]
KennenLt: folds 
gora8905: folds 
artur145: folds 
urzugi: folds 
Kevin12345Mc: folds 
V HC Vega: folds 
Lynxzen: folds 
Uncalled bet (7000) returned to lucsFTG
lucsFTG collected 28000 from pot
*** SUMMARY ***
Total pot 28000 | Rake 0 
Seat 1: Lynxzen (small blind) folded before Flop
Seat 2: lucsFTG (big blind) collected (28000)
Seat 3: KennenLt folded before Flop (didn't bet)
Seat 4: gora8905 folded before Flop (didn't bet)
Seat 5: artur145 folded before Flop (didn't bet)
Seat 6: urzugi folded before Flop (didn't bet)
Seat 7: Kevin12345Mc folded before Flop (didn't bet)
Seat 8: V HC Vega (button) folded before Flop (didn't bet)



PokerStars Hand #254866656259: Tournament #3856223586, $2.45+$2.45+$0.60 USD Hold'em No Limit - Level XXVI (7000/14000) - 2025/02/14 21:19:15 WET [2025/02/14 16:19:15 ET]
Table '3856223586 150' 8-max Seat #1 is the button
Seat 1: Lynxzen (680656 in chips, $24.88 bounty) 
Seat 2: lucsFTG (512188 in chips, $25.33 bounty) 
Seat 3: KennenLt (510428 in chips, $2.45 bounty) 
Seat 4: gora8905 (657256 in chips, $20.76 bounty) 
Seat 5: artur145 (640367 in chips, $15.11 bounty) 
Seat 6: urzugi (277403 in chips, $17.25 bounty) 
Seat 7: Kevin12345Mc (506230 in chips, $7.30 bounty) 
Seat 8: V HC Vega (230254 in chips, $6.72 bounty) 
Lynxzen: posts the ante 1750
lucsFTG: posts the ante 1750
KennenLt: posts the ante 1750
gora8905: posts the ante 1750
artur145: posts the ante 1750
urzugi: posts the ante 1750
Kevin12345Mc: posts the ante 1750
V HC Vega: posts the ante 1750
lucsFTG: posts small blind 7000
KennenLt: posts big blind 14000
*** HOLE CARDS ***
Dealt to Kevin12345Mc [Td Tc]
gora8905: folds 
artur145: folds 
urzugi: folds 
Kevin12345Mc: raises 16800 to 30800
V HC Vega: folds 
Lynxzen: raises 100800 to 131600
lucsFTG: folds 
KennenLt: folds 
Kevin12345Mc: raises 372880 to 504480 and is all-in
Lynxzen: calls 372880
*** FLOP *** [6d 2h As]
*** TURN *** [6d 2h As] [4h]
*** RIVER *** [6d 2h As 4h] [Kc]
*** SHOW DOWN ***
Kevin12345Mc: shows [Td Tc] (a pair of Tens)
Lynxzen: shows [Ac Ks] (two pair, Aces and Kings)
Lynxzen collected 1043960 from pot
Lynxzen wins $3.65 for eliminating Kevin12345Mc and their own bounty increases by $3.65 to $28.53
Kevin12345Mc finished the tournament in 220th place and received $7.92.
*** SUMMARY ***
Total pot 1043960 | Rake 0 
Board [6d 2h As 4h Kc]
Seat 1: Lynxzen (button) showed [Ac Ks] and won (1043960) with two pair, Aces and Kings
Seat 2: lucsFTG (small blind) folded before Flop
Seat 3: KennenLt (big blind) folded before Flop
Seat 4: gora8905 folded before Flop (didn't bet)
Seat 5: artur145 folded before Flop (didn't bet)
Seat 6: urzugi folded before Flop (didn't bet)
Seat 7: Kevin12345Mc showed [Td Tc] and lost with a pair of Tens
Seat 8: V HC Vega folded before Flop (didn't bet)



