PokerStars Hand #254985288563: Tournament #3860676529, $0.46+$1.50+$0.24 USD Hold'em No Limit - Level I (25/50) - 2025/02/22 14:29:55 WET [2025/02/22 9:29:55 ET]
Table '3860676529 25' 8-max Seat #1 is the button
Seat 1: bohoto1 (5000 in chips, $1.50 bounty) 
Seat 2: Till1010 (5000 in chips, $1.50 bounty) 
Seat 3: Leoszt66 (5000 in chips, $1.50 bounty) 
Seat 4: Befree_B3 (5000 in chips, $1.50 bounty) 
Seat 5: yoj777464 (5000 in chips, $1.50 bounty) 
Seat 6: Sasiado (5000 in chips, $1.50 bounty) 
Seat 7: I eat glass (5000 in chips, $1.50 bounty) 
Seat 8: Kevin12345Mc (5000 in chips, $1.50 bounty) 
bohoto1: posts the ante 8
Till1010: posts the ante 8
Leoszt66: posts the ante 8
Befree_B3: posts the ante 8
yoj777464: posts the ante 8
Sasiado: posts the ante 8
I eat glass: posts the ante 8
Kevin12345Mc: posts the ante 8
Till1010: posts small blind 25
Leoszt66: posts big blind 50
*** HOLE CARDS ***
Dealt to Kevin12345Mc [5c 9c]
Befree_B3: folds 
yoj777464: calls 50
Sasiado: folds 
I eat glass: folds 
Kevin12345Mc: folds 
bohoto1: folds 
Till1010: raises 60 to 110
Leoszt66: folds 
yoj777464: calls 60
*** FLOP *** [As Tc 7c]
Till1010: bets 150
yoj777464: calls 150
*** TURN *** [As Tc 7c] [Qs]
Till1010: bets 250
yoj777464: raises 500 to 750
Till1010: calls 500
*** RIVER *** [As Tc 7c Qs] [Th]
Till1010: checks 
yoj777464: bets 3982 and is all-in
Till1010: calls 3982 and is all-in
*** SHOW DOWN ***
yoj777464: shows [Td Qc] (a full house, Tens full of Queens)
Till1010: shows [Ts Js] (three of a kind, Tens)
yoj777464 collected 10098 from pot
yoj777464 wins $0.75 for eliminating Till1010 and their own bounty increases by $0.75 to $2.25
Till1010 finished the tournament
*** SUMMARY ***
Total pot 10098 | Rake 0 
Board [As Tc 7c Qs Th]
Seat 1: bohoto1 (button) folded before Flop (didn't bet)
Seat 2: Till1010 (small blind) showed [Ts Js] and lost with three of a kind, Tens
Seat 3: Leoszt66 (big blind) folded before Flop
Seat 4: Befree_B3 folded before Flop (didn't bet)
Seat 5: yoj777464 showed [Td Qc] and won (10098) with a full house, Tens full of Queens
Seat 6: Sasiado folded before Flop (didn't bet)
Seat 7: I eat glass folded before Flop (didn't bet)
Seat 8: Kevin12345Mc folded before Flop (didn't bet)



PokerStars Hand #254985299528: Tournament #3860676529, $0.46+$1.50+$0.24 USD Hold'em No Limit - Level I (25/50) - 2025/02/22 14:30:53 WET [2025/02/22 9:30:53 ET]
Table '3860676529 25' 8-max Seat #3 is the button
Seat 1: bohoto1 (4992 in chips, $1.50 bounty) 
Seat 3: Leoszt66 (4942 in chips, $1.50 bounty) 
Seat 4: Befree_B3 (4992 in chips, $1.50 bounty) 
Seat 5: yoj777464 (10098 in chips, $2.25 bounty) 
Seat 6: Sasiado (4992 in chips, $1.50 bounty) 
Seat 7: I eat glass (4992 in chips, $1.50 bounty) 
Seat 8: Kevin12345Mc (4992 in chips, $1.50 bounty) 
bohoto1: posts the ante 8
Leoszt66: posts the ante 8
Befree_B3: posts the ante 8
yoj777464: posts the ante 8
Sasiado: posts the ante 8
I eat glass: posts the ante 8
Kevin12345Mc: posts the ante 8
Befree_B3: posts small blind 25
yoj777464: posts big blind 50
*** HOLE CARDS ***
Dealt to Kevin12345Mc [7c 5s]
Sasiado: folds 
I eat glass: calls 50
Kevin12345Mc: folds 
bohoto1: folds 
Leoszt66: raises 50 to 100
Befree_B3: folds 
yoj777464: calls 50
I eat glass: calls 50
*** FLOP *** [5c Ah Jh]
yoj777464: checks 
I eat glass: bets 100
Leoszt66: folds 
yoj777464: folds 
Uncalled bet (100) returned to I eat glass
I eat glass collected 381 from pot
*** SUMMARY ***
Total pot 381 | Rake 0 
Board [5c Ah Jh]
Seat 1: bohoto1 folded before Flop (didn't bet)
Seat 3: Leoszt66 (button) folded on the Flop
Seat 4: Befree_B3 (small blind) folded before Flop
Seat 5: yoj777464 (big blind) folded on the Flop
Seat 6: Sasiado folded before Flop (didn't bet)
Seat 7: I eat glass collected (381)
Seat 8: Kevin12345Mc folded before Flop (didn't bet)



PokerStars Hand #254985308961: Tournament #3860676529, $0.46+$1.50+$0.24 USD Hold'em No Limit - Level I (25/50) - 2025/02/22 14:31:43 WET [2025/02/22 9:31:43 ET]
Table '3860676529 25' 8-max Seat #4 is the button
Seat 1: bohoto1 (4984 in chips, $1.50 bounty) 
Seat 2: Chiochetta34 (5000 in chips, $1.50 bounty) 
Seat 3: Leoszt66 (4834 in chips, $1.50 bounty) 
Seat 4: Befree_B3 (4959 in chips, $1.50 bounty) 
Seat 5: yoj777464 (9990 in chips, $2.25 bounty) 
Seat 6: Sasiado (4984 in chips, $1.50 bounty) 
Seat 7: I eat glass (5265 in chips, $1.50 bounty) 
Seat 8: Kevin12345Mc (4984 in chips, $1.50 bounty) 
bohoto1: posts the ante 8
Chiochetta34: posts the ante 8
Leoszt66: posts the ante 8
Befree_B3: posts the ante 8
yoj777464: posts the ante 8
Sasiado: posts the ante 8
I eat glass: posts the ante 8
Kevin12345Mc: posts the ante 8
yoj777464: posts small blind 25
Sasiado: posts big blind 50
*** HOLE CARDS ***
Dealt to Kevin12345Mc [3c Ad]
I eat glass: raises 50 to 100
Kevin12345Mc: folds 
bohoto1: folds 
Chiochetta34: calls 100
Leoszt66: folds 
Befree_B3: calls 100
yoj777464: calls 75
Sasiado: calls 50
*** FLOP *** [2s 9h 5h]
yoj777464: checks 
Sasiado: checks 
I eat glass: bets 150
Chiochetta34: folds 
Befree_B3: folds 
yoj777464: folds 
Sasiado: folds 
Uncalled bet (150) returned to I eat glass
I eat glass collected 564 from pot
*** SUMMARY ***
Total pot 564 | Rake 0 
Board [2s 9h 5h]
Seat 1: bohoto1 folded before Flop (didn't bet)
Seat 2: Chiochetta34 folded on the Flop
Seat 3: Leoszt66 folded before Flop (didn't bet)
Seat 4: Befree_B3 (button) folded on the Flop
Seat 5: yoj777464 (small blind) folded on the Flop
Seat 6: Sasiado (big blind) folded on the Flop
Seat 7: I eat glass collected (564)
Seat 8: Kevin12345Mc folded before Flop (didn't bet)



PokerStars Hand #254985321400: Tournament #3860676529, $0.46+$1.50+$0.24 USD Hold'em No Limit - Level I (25/50) - 2025/02/22 14:32:48 WET [2025/02/22 9:32:48 ET]
Table '3860676529 25' 8-max Seat #5 is the button
Seat 2: Chiochetta34 (4892 in chips, $1.50 bounty) 
Seat 3: Leoszt66 (4826 in chips, $1.50 bounty) 
Seat 4: Befree_B3 (4851 in chips, $1.50 bounty) 
Seat 5: yoj777464 (9882 in chips, $2.25 bounty) 
Seat 6: Sasiado (4876 in chips, $1.50 bounty) 
Seat 7: I eat glass (5721 in chips, $1.50 bounty) 
Seat 8: Kevin12345Mc (4976 in chips, $1.50 bounty) 
Chiochetta34: posts the ante 8
Leoszt66: posts the ante 8
Befree_B3: posts the ante 8
yoj777464: posts the ante 8
Sasiado: posts the ante 8
I eat glass: posts the ante 8
Kevin12345Mc: posts the ante 8
Sasiado: posts small blind 25
I eat glass: posts big blind 50
*** HOLE CARDS ***
Dealt to Kevin12345Mc [3d 2s]
Kevin12345Mc: folds 
Chiochetta34: folds 
Leoszt66: raises 50 to 100
Befree_B3: folds 
Tango Habana is disconnected 
yoj777464: calls 100
Sasiado: folds 
I eat glass: raises 200 to 300
Leoszt66: raises 781 to 1081
yoj777464: folds 
I eat glass: raises 4632 to 5713 and is all-in
Leoszt66: calls 3737 and is all-in
Uncalled bet (895) returned to I eat glass
*** FLOP *** [Jh 8c Kc]
*** TURN *** [Jh 8c Kc] [2d]
*** RIVER *** [Jh 8c Kc 2d] [Qd]
*** SHOW DOWN ***
I eat glass: shows [Ks Kh] (three of a kind, Kings)
Leoszt66: shows [Jd Ad] (a pair of Jacks)
I eat glass collected 9817 from pot
I eat glass wins $0.75 for eliminating Leoszt66 and their own bounty increases by $0.75 to $2.25
Leoszt66 finished the tournament
*** SUMMARY ***
Total pot 9817 | Rake 0 
Board [Jh 8c Kc 2d Qd]
Seat 2: Chiochetta34 folded before Flop (didn't bet)
Seat 3: Leoszt66 showed [Jd Ad] and lost with a pair of Jacks
Seat 4: Befree_B3 folded before Flop (didn't bet)
Seat 5: yoj777464 (button) folded before Flop
Seat 6: Sasiado (small blind) folded before Flop
Seat 7: I eat glass (big blind) showed [Ks Kh] and won (9817) with three of a kind, Kings
Seat 8: Kevin12345Mc folded before Flop (didn't bet)



PokerStars Hand #254985330010: Tournament #3860676529, $0.46+$1.50+$0.24 USD Hold'em No Limit - Level I (25/50) - 2025/02/22 14:33:34 WET [2025/02/22 9:33:34 ET]
Table '3860676529 25' 8-max Seat #6 is the button
Seat 1: Tango Habana (5000 in chips, $1.50 bounty) 
Seat 2: Chiochetta34 (4884 in chips, $1.50 bounty) 
Seat 4: Befree_B3 (4843 in chips, $1.50 bounty) 
Seat 5: yoj777464 (9774 in chips, $2.25 bounty) 
Seat 6: Sasiado (4843 in chips, $1.50 bounty) 
Seat 7: I eat glass (10712 in chips, $2.25 bounty) 
Seat 8: Kevin12345Mc (4968 in chips, $1.50 bounty) 
Tango Habana: posts the ante 8
Chiochetta34: posts the ante 8
Befree_B3: posts the ante 8
yoj777464: posts the ante 8
Sasiado: posts the ante 8
I eat glass: posts the ante 8
Kevin12345Mc: posts the ante 8
I eat glass: posts small blind 25
Kevin12345Mc: posts big blind 50
*** HOLE CARDS ***
Dealt to Kevin12345Mc [Kd 8h]
Tango Habana: folds 
félix2011 is disconnected 
Chiochetta34: calls 50
Befree_B3: folds 
yoj777464: calls 50
Sasiado: folds 
I eat glass: calls 25
Kevin12345Mc: checks 
*** FLOP *** [Ah 6d 3s]
I eat glass: checks 
Kevin12345Mc: checks 
Chiochetta34: checks 
yoj777464: checks 
*** TURN *** [Ah 6d 3s] [Th]
I eat glass: checks 
Kevin12345Mc: checks 
Chiochetta34: checks 
yoj777464: checks 
*** RIVER *** [Ah 6d 3s Th] [2h]
I eat glass: checks 
Kevin12345Mc: checks 
Chiochetta34: bets 100
yoj777464: raises 850 to 950
I eat glass: folds 
Kevin12345Mc: folds 
Chiochetta34: calls 850
*** SHOW DOWN ***
yoj777464: shows [4c 5c] (a straight, Deuce to Six)
Chiochetta34: mucks hand 
yoj777464 collected 2156 from pot
*** SUMMARY ***
Total pot 2156 | Rake 0 
Board [Ah 6d 3s Th 2h]
Seat 1: Tango Habana folded before Flop (didn't bet)
Seat 2: Chiochetta34 mucked [Ts 8s]
Seat 4: Befree_B3 folded before Flop (didn't bet)
Seat 5: yoj777464 showed [4c 5c] and won (2156) with a straight, Deuce to Six
Seat 6: Sasiado (button) folded before Flop (didn't bet)
Seat 7: I eat glass (small blind) folded on the River
Seat 8: Kevin12345Mc (big blind) folded on the River



PokerStars Hand #254985346191: Tournament #3860676529, $0.46+$1.50+$0.24 USD Hold'em No Limit - Level I (25/50) - 2025/02/22 14:34:58 WET [2025/02/22 9:34:58 ET]
Table '3860676529 25' 8-max Seat #7 is the button
Seat 1: Tango Habana (4992 in chips, $1.50 bounty) 
Seat 2: Chiochetta34 (3876 in chips, $1.50 bounty) 
Seat 3: félix2011 (5000 in chips, $1.50 bounty) 
Seat 4: Befree_B3 (4835 in chips, $1.50 bounty) 
Seat 5: yoj777464 (10922 in chips, $2.25 bounty) 
Seat 6: Sasiado (4835 in chips, $1.50 bounty) 
Seat 7: I eat glass (10654 in chips, $2.25 bounty) 
Seat 8: Kevin12345Mc (4910 in chips, $1.50 bounty) 
Tango Habana: posts the ante 8
Chiochetta34: posts the ante 8
félix2011: posts the ante 8
Befree_B3: posts the ante 8
yoj777464: posts the ante 8
Sasiado: posts the ante 8
I eat glass: posts the ante 8
Kevin12345Mc: posts the ante 8
Kevin12345Mc: posts small blind 25
Tango Habana: posts big blind 50
*** HOLE CARDS ***
Dealt to Kevin12345Mc [8d 8c]
Chiochetta34: folds 
félix2011: folds 
Befree_B3: folds 
yoj777464: folds 
Sasiado: raises 75 to 125
I eat glass: folds 
Kevin12345Mc: raises 375 to 500
Tango Habana: folds 
Sasiado: calls 375
*** FLOP *** [Jc As 8h]
Kevin12345Mc: bets 368
Sasiado: calls 368
*** TURN *** [Jc As 8h] [Td]
Kevin12345Mc: bets 1321
Sasiado: folds 
Uncalled bet (1321) returned to Kevin12345Mc
Kevin12345Mc collected 1850 from pot
Kevin12345Mc: doesn't show hand 
*** SUMMARY ***
Total pot 1850 | Rake 0 
Board [Jc As 8h Td]
Seat 1: Tango Habana (big blind) folded before Flop
Seat 2: Chiochetta34 folded before Flop (didn't bet)
Seat 3: félix2011 folded before Flop (didn't bet)
Seat 4: Befree_B3 folded before Flop (didn't bet)
Seat 5: yoj777464 folded before Flop (didn't bet)
Seat 6: Sasiado folded on the Turn
Seat 7: I eat glass (button) folded before Flop (didn't bet)
Seat 8: Kevin12345Mc (small blind) collected (1850)



PokerStars Hand #254985364427: Tournament #3860676529, $0.46+$1.50+$0.24 USD Hold'em No Limit - Level I (25/50) - 2025/02/22 14:36:33 WET [2025/02/22 9:36:33 ET]
Table '3860676529 25' 8-max Seat #8 is the button
Seat 1: Tango Habana (4934 in chips, $1.50 bounty) 
Seat 2: Chiochetta34 (3868 in chips, $1.50 bounty) 
Seat 3: félix2011 (4992 in chips, $1.50 bounty) 
Seat 4: Befree_B3 (4827 in chips, $1.50 bounty) 
Seat 5: yoj777464 (10914 in chips, $2.25 bounty) 
Seat 6: Sasiado (3959 in chips, $1.50 bounty) 
Seat 7: I eat glass (10646 in chips, $2.25 bounty) 
Seat 8: Kevin12345Mc (5884 in chips, $1.50 bounty) 
Tango Habana: posts the ante 8
Chiochetta34: posts the ante 8
félix2011: posts the ante 8
Befree_B3: posts the ante 8
yoj777464: posts the ante 8
Sasiado: posts the ante 8
I eat glass: posts the ante 8
Kevin12345Mc: posts the ante 8
Tango Habana: posts small blind 25
Chiochetta34: posts big blind 50
*** HOLE CARDS ***
Dealt to Kevin12345Mc [7c 6h]
félix2011: folds 
Befree_B3: folds 
yoj777464: folds 
Sasiado: folds 
I eat glass: folds 
Kevin12345Mc: folds 
Tango Habana: raises 100 to 150
Chiochetta34: calls 100
*** FLOP *** [8d Qd Ac]
Tango Habana: bets 146
Chiochetta34: calls 146
*** TURN *** [8d Qd Ac] [Qc]
Tango Habana: bets 262
Chiochetta34: calls 262
*** RIVER *** [8d Qd Ac Qc] [5c]
Tango Habana: checks 
Chiochetta34: bets 590
Tango Habana: calls 590
*** SHOW DOWN ***
Chiochetta34: shows [8h Ah] (two pair, Aces and Queens)
Tango Habana: mucks hand 
Chiochetta34 collected 2360 from pot
*** SUMMARY ***
Total pot 2360 | Rake 0 
Board [8d Qd Ac Qc 5c]
Seat 1: Tango Habana (small blind) mucked [Ks Kc]
Seat 2: Chiochetta34 (big blind) showed [8h Ah] and won (2360) with two pair, Aces and Queens
Seat 3: félix2011 folded before Flop (didn't bet)
Seat 4: Befree_B3 folded before Flop (didn't bet)
Seat 5: yoj777464 folded before Flop (didn't bet)
Seat 6: Sasiado folded before Flop (didn't bet)
Seat 7: I eat glass folded before Flop (didn't bet)
Seat 8: Kevin12345Mc (button) folded before Flop (didn't bet)



PokerStars Hand #254985373245: Tournament #3860676529, $0.46+$1.50+$0.24 USD Hold'em No Limit - Level I (25/50) - 2025/02/22 14:37:18 WET [2025/02/22 9:37:18 ET]
Table '3860676529 25' 8-max Seat #1 is the button
Seat 1: Tango Habana (3778 in chips, $1.50 bounty) 
Seat 2: Chiochetta34 (5072 in chips, $1.50 bounty) 
Seat 3: félix2011 (4984 in chips, $1.50 bounty) 
Seat 5: yoj777464 (10906 in chips, $2.25 bounty) 
Seat 6: Sasiado (3951 in chips, $1.50 bounty) 
Seat 7: I eat glass (10638 in chips, $2.25 bounty) 
Seat 8: Kevin12345Mc (5876 in chips, $1.50 bounty) 
Tango Habana: posts the ante 8
Chiochetta34: posts the ante 8
félix2011: posts the ante 8
yoj777464: posts the ante 8
Sasiado: posts the ante 8
I eat glass: posts the ante 8
Kevin12345Mc: posts the ante 8
Chiochetta34: posts small blind 25
félix2011: posts big blind 50
*** HOLE CARDS ***
Dealt to Kevin12345Mc [7d 3s]
yoj777464: folds 
Sasiado: folds 
I eat glass: folds 
Kevin12345Mc: folds 
Tango Habana: raises 75 to 125
Chiochetta34: folds 
félix2011: calls 75
*** FLOP *** [Qd 4s Jd]
félix2011: checks 
Tango Habana: checks 
*** TURN *** [Qd 4s Jd] [3c]
félix2011: checks 
Tango Habana: checks 
*** RIVER *** [Qd 4s Jd 3c] [Qh]
félix2011: checks 
Tango Habana: checks 
*** SHOW DOWN ***
félix2011: shows [Td 7c] (a pair of Queens)
Tango Habana: shows [6c As] (a pair of Queens - Ace kicker)
Tango Habana collected 331 from pot
*** SUMMARY ***
Total pot 331 | Rake 0 
Board [Qd 4s Jd 3c Qh]
Seat 1: Tango Habana (button) showed [6c As] and won (331) with a pair of Queens
Seat 2: Chiochetta34 (small blind) folded before Flop
Seat 3: félix2011 (big blind) showed [Td 7c] and lost with a pair of Queens
Seat 5: yoj777464 folded before Flop (didn't bet)
Seat 6: Sasiado folded before Flop (didn't bet)
Seat 7: I eat glass folded before Flop (didn't bet)
Seat 8: Kevin12345Mc folded before Flop (didn't bet)



PokerStars Hand #254985389459: Tournament #3860676529, $0.46+$1.50+$0.24 USD Hold'em No Limit - Level II (30/60) - 2025/02/22 14:38:42 WET [2025/02/22 9:38:42 ET]
Table '3860676529 25' 8-max Seat #2 is the button
Seat 1: Tango Habana (3976 in chips, $1.50 bounty) 
Seat 2: Chiochetta34 (5039 in chips, $1.50 bounty) 
Seat 3: félix2011 (4851 in chips, $1.50 bounty) 
Seat 4: PexZz (5000 in chips, $1.50 bounty) 
Seat 5: yoj777464 (10898 in chips, $2.25 bounty) 
Seat 6: Sasiado (3943 in chips, $1.50 bounty) 
Seat 7: I eat glass (10630 in chips, $2.25 bounty) 
Seat 8: Kevin12345Mc (5868 in chips, $1.50 bounty) 
Tango Habana: posts the ante 9
Chiochetta34: posts the ante 9
félix2011: posts the ante 9
PexZz: posts the ante 9
yoj777464: posts the ante 9
Sasiado: posts the ante 9
I eat glass: posts the ante 9
Kevin12345Mc: posts the ante 9
félix2011: posts small blind 30
PexZz: posts big blind 60
*** HOLE CARDS ***
Dealt to Kevin12345Mc [As Kc]
yoj777464: folds 
Sasiado: folds 
I eat glass: folds 
Kevin12345Mc: raises 78 to 138
Tango Habana: folds 
Chiochetta34: calls 138
félix2011: folds 
PexZz: calls 78
*** FLOP *** [Qd 3s Js]
PexZz: checks 
Kevin12345Mc: bets 170
Chiochetta34: calls 170
PexZz: folds 
*** TURN *** [Qd 3s Js] [8d]
Kevin12345Mc: checks 
Chiochetta34: checks 
*** RIVER *** [Qd 3s Js 8d] [Qh]
Kevin12345Mc: checks 
Chiochetta34: checks 
*** SHOW DOWN ***
Kevin12345Mc: shows [As Kc] (a pair of Queens)
Chiochetta34: mucks hand 
Kevin12345Mc collected 856 from pot
*** SUMMARY ***
Total pot 856 | Rake 0 
Board [Qd 3s Js 8d Qh]
Seat 1: Tango Habana folded before Flop (didn't bet)
Seat 2: Chiochetta34 (button) mucked [7d 6d]
Seat 3: félix2011 (small blind) folded before Flop
Seat 4: PexZz (big blind) folded on the Flop
Seat 5: yoj777464 folded before Flop (didn't bet)
Seat 6: Sasiado folded before Flop (didn't bet)
Seat 7: I eat glass folded before Flop (didn't bet)
Seat 8: Kevin12345Mc showed [As Kc] and won (856) with a pair of Queens



PokerStars Hand #254985399960: Tournament #3860676529, $0.46+$1.50+$0.24 USD Hold'em No Limit - Level II (30/60) - 2025/02/22 14:39:37 WET [2025/02/22 9:39:37 ET]
Table '3860676529 25' 8-max Seat #3 is the button
Seat 1: Tango Habana (3967 in chips, $1.50 bounty) 
Seat 2: Chiochetta34 (4722 in chips, $1.50 bounty) 
Seat 3: félix2011 (4812 in chips, $1.50 bounty) 
Seat 4: PexZz (4853 in chips, $1.50 bounty) 
Seat 5: yoj777464 (10889 in chips, $2.25 bounty) 
Seat 6: Sasiado (3934 in chips, $1.50 bounty) 
Seat 7: I eat glass (10621 in chips, $2.25 bounty) 
Seat 8: Kevin12345Mc (6407 in chips, $1.50 bounty) 
Tango Habana: posts the ante 9
Chiochetta34: posts the ante 9
félix2011: posts the ante 9
PexZz: posts the ante 9
yoj777464: posts the ante 9
Sasiado: posts the ante 9
I eat glass: posts the ante 9
Kevin12345Mc: posts the ante 9
PexZz: posts small blind 30
yoj777464: posts big blind 60
*** HOLE CARDS ***
Dealt to Kevin12345Mc [2h Qh]
Sasiado: raises 90 to 150
I eat glass: folds 
Kevin12345Mc: folds 
Tango Habana: folds 
Chiochetta34: calls 150
félix2011: folds 
PexZz: folds 
yoj777464: folds 
*** FLOP *** [9h 2s 9c]
Sasiado: checks 
Chiochetta34: checks 
*** TURN *** [9h 2s 9c] [6s]
Sasiado: bets 291
Chiochetta34: calls 291
*** RIVER *** [9h 2s 9c 6s] [8c]
Sasiado: bets 441
Chiochetta34: folds 
Uncalled bet (441) returned to Sasiado
Sasiado collected 1044 from pot
Sasiado: doesn't show hand 
*** SUMMARY ***
Total pot 1044 | Rake 0 
Board [9h 2s 9c 6s 8c]
Seat 1: Tango Habana folded before Flop (didn't bet)
Seat 2: Chiochetta34 folded on the River
Seat 3: félix2011 (button) folded before Flop (didn't bet)
Seat 4: PexZz (small blind) folded before Flop
Seat 5: yoj777464 (big blind) folded before Flop
Seat 6: Sasiado collected (1044)
Seat 7: I eat glass folded before Flop (didn't bet)
Seat 8: Kevin12345Mc folded before Flop (didn't bet)



PokerStars Hand #254985411307: Tournament #3860676529, $0.46+$1.50+$0.24 USD Hold'em No Limit - Level II (30/60) - 2025/02/22 14:40:35 WET [2025/02/22 9:40:35 ET]
Table '3860676529 25' 8-max Seat #4 is the button
Seat 1: Tango Habana (3958 in chips, $1.50 bounty) 
Seat 2: Chiochetta34 (4272 in chips, $1.50 bounty) 
Seat 3: félix2011 (4803 in chips, $1.50 bounty) 
Seat 4: PexZz (4814 in chips, $1.50 bounty) 
Seat 5: yoj777464 (10820 in chips, $2.25 bounty) 
Seat 6: Sasiado (4528 in chips, $1.50 bounty) 
Seat 7: I eat glass (10612 in chips, $2.25 bounty) 
Seat 8: Kevin12345Mc (6398 in chips, $1.50 bounty) 
Tango Habana: posts the ante 9
Chiochetta34: posts the ante 9
félix2011: posts the ante 9
PexZz: posts the ante 9
yoj777464: posts the ante 9
Sasiado: posts the ante 9
I eat glass: posts the ante 9
Kevin12345Mc: posts the ante 9
yoj777464: posts small blind 30
Sasiado: posts big blind 60
*** HOLE CARDS ***
Dealt to Kevin12345Mc [4s 2d]
I eat glass: folds 
Kevin12345Mc: folds 
Tango Habana: folds 
Chiochetta34: folds 
félix2011: folds 
PexZz: raises 60 to 120
yoj777464: calls 90
Sasiado: folds 
*** FLOP *** [6h 4c Ks]
yoj777464: checks 
PexZz: bets 93
yoj777464: calls 93
*** TURN *** [6h 4c Ks] [Th]
yoj777464: checks 
PexZz: checks 
*** RIVER *** [6h 4c Ks Th] [4d]
yoj777464: bets 2640
PexZz: folds 
Uncalled bet (2640) returned to yoj777464
yoj777464 collected 558 from pot
*** SUMMARY ***
Total pot 558 | Rake 0 
Board [6h 4c Ks Th 4d]
Seat 1: Tango Habana folded before Flop (didn't bet)
Seat 2: Chiochetta34 folded before Flop (didn't bet)
Seat 3: félix2011 folded before Flop (didn't bet)
Seat 4: PexZz (button) folded on the River
Seat 5: yoj777464 (small blind) collected (558)
Seat 6: Sasiado (big blind) folded before Flop
Seat 7: I eat glass folded before Flop (didn't bet)
Seat 8: Kevin12345Mc folded before Flop (didn't bet)



PokerStars Hand #254985427859: Tournament #3860676529, $0.46+$1.50+$0.24 USD Hold'em No Limit - Level II (30/60) - 2025/02/22 14:42:00 WET [2025/02/22 9:42:00 ET]
Table '3860676529 25' 8-max Seat #5 is the button
Seat 1: Tango Habana (3949 in chips, $1.50 bounty) 
Seat 2: Chiochetta34 (4263 in chips, $1.50 bounty) 
Seat 3: félix2011 (4794 in chips, $1.50 bounty) 
Seat 4: PexZz (4592 in chips, $1.50 bounty) 
Seat 5: yoj777464 (11156 in chips, $2.25 bounty) 
Seat 6: Sasiado (4459 in chips, $1.50 bounty) 
Seat 7: I eat glass (10603 in chips, $2.25 bounty) 
Seat 8: Kevin12345Mc (6389 in chips, $1.50 bounty) 
Tango Habana: posts the ante 9
Chiochetta34: posts the ante 9
félix2011: posts the ante 9
PexZz: posts the ante 9
yoj777464: posts the ante 9
Sasiado: posts the ante 9
I eat glass: posts the ante 9
Kevin12345Mc: posts the ante 9
Sasiado: posts small blind 30
I eat glass: posts big blind 60
*** HOLE CARDS ***
Dealt to Kevin12345Mc [4d 7d]
Kevin12345Mc: folds 
Tango Habana: folds 
Chiochetta34: calls 60
félix2011: folds 
PexZz: raises 120 to 180
yoj777464: calls 180
Sasiado: calls 150
I eat glass: calls 120
Chiochetta34: calls 120
*** FLOP *** [Ts 2s 9h]
Sasiado: checks 
I eat glass: checks 
Chiochetta34: bets 120
PexZz: calls 120
yoj777464: calls 120
Sasiado: calls 120
I eat glass: raises 1452 to 1572
Chiochetta34: calls 1452
PexZz: folds 
yoj777464: folds 
Sasiado: folds 
*** TURN *** [Ts 2s 9h] [Qc]
I eat glass: bets 1020
Chiochetta34: raises 1020 to 2040
I eat glass: folds 
Uncalled bet (1020) returned to Chiochetta34
Chiochetta34 collected 6516 from pot
Chiochetta34: doesn't show hand 
*** SUMMARY ***
Total pot 6516 | Rake 0 
Board [Ts 2s 9h Qc]
Seat 1: Tango Habana folded before Flop (didn't bet)
Seat 2: Chiochetta34 collected (6516)
Seat 3: félix2011 folded before Flop (didn't bet)
Seat 4: PexZz folded on the Flop
Seat 5: yoj777464 (button) folded on the Flop
Seat 6: Sasiado (small blind) folded on the Flop
Seat 7: I eat glass (big blind) folded on the Turn
Seat 8: Kevin12345Mc folded before Flop (didn't bet)



PokerStars Hand #254985461293: Tournament #3860676529, $0.46+$1.50+$0.24 USD Hold'em No Limit - Level II (30/60) - 2025/02/22 14:44:51 WET [2025/02/22 9:44:51 ET]
Table '3860676529 25' 8-max Seat #6 is the button
Seat 1: Tango Habana (3940 in chips, $1.50 bounty) 
Seat 2: Chiochetta34 (7998 in chips, $1.50 bounty) 
Seat 3: félix2011 (4785 in chips, $1.50 bounty) 
Seat 4: PexZz (4283 in chips, $1.50 bounty) 
Seat 5: yoj777464 (10847 in chips, $2.25 bounty) 
Seat 6: Sasiado (4150 in chips, $1.50 bounty) 
Seat 7: I eat glass (7822 in chips, $2.25 bounty) 
Seat 8: Kevin12345Mc (6380 in chips, $1.50 bounty) 
Tango Habana: posts the ante 9
Chiochetta34: posts the ante 9
félix2011: posts the ante 9
PexZz: posts the ante 9
yoj777464: posts the ante 9
Sasiado: posts the ante 9
I eat glass: posts the ante 9
Kevin12345Mc: posts the ante 9
I eat glass: posts small blind 30
Kevin12345Mc: posts big blind 60
*** HOLE CARDS ***
Dealt to Kevin12345Mc [Ks Jd]
Tango Habana: raises 90 to 150
Chiochetta34: raises 462 to 612
félix2011: folds 
PexZz: folds 
yoj777464: folds 
Sasiado: folds 
I eat glass: folds 
Kevin12345Mc: folds 
Tango Habana: calls 462
*** FLOP *** [8c 5c 8h]
Tango Habana: checks 
Chiochetta34: bets 1386
Tango Habana: folds 
Uncalled bet (1386) returned to Chiochetta34
Chiochetta34 collected 1386 from pot
Chiochetta34: doesn't show hand 
*** SUMMARY ***
Total pot 1386 | Rake 0 
Board [8c 5c 8h]
Seat 1: Tango Habana folded on the Flop
Seat 2: Chiochetta34 collected (1386)
Seat 3: félix2011 folded before Flop (didn't bet)
Seat 4: PexZz folded before Flop (didn't bet)
Seat 5: yoj777464 folded before Flop (didn't bet)
Seat 6: Sasiado (button) folded before Flop (didn't bet)
Seat 7: I eat glass (small blind) folded before Flop
Seat 8: Kevin12345Mc (big blind) folded before Flop



PokerStars Hand #254985471297: Tournament #3860676529, $0.46+$1.50+$0.24 USD Hold'em No Limit - Level II (30/60) - 2025/02/22 14:45:43 WET [2025/02/22 9:45:43 ET]
Table '3860676529 25' 8-max Seat #7 is the button
Seat 1: Tango Habana (3319 in chips, $1.50 bounty) 
Seat 2: Chiochetta34 (8763 in chips, $1.50 bounty) 
Seat 3: félix2011 (4776 in chips, $1.50 bounty) 
Seat 4: PexZz (4274 in chips, $1.50 bounty) 
Seat 5: yoj777464 (10838 in chips, $2.25 bounty) 
Seat 6: Sasiado (4141 in chips, $1.50 bounty) 
Seat 7: I eat glass (7783 in chips, $2.25 bounty) 
Seat 8: Kevin12345Mc (6311 in chips, $1.50 bounty) 
Tango Habana: posts the ante 9
Chiochetta34: posts the ante 9
félix2011: posts the ante 9
PexZz: posts the ante 9
yoj777464: posts the ante 9
Sasiado: posts the ante 9
I eat glass: posts the ante 9
Kevin12345Mc: posts the ante 9
Kevin12345Mc: posts small blind 30
Tango Habana: posts big blind 60
*** HOLE CARDS ***
Dealt to Kevin12345Mc [Kh Kd]
Chiochetta34: folds 
félix2011: folds 
PexZz: folds 
yoj777464: calls 60
Sasiado: folds 
I eat glass: folds 
Kevin12345Mc: raises 138 to 198
Tango Habana: folds 
yoj777464: calls 138
*** FLOP *** [Td 9d 4c]
Kevin12345Mc: bets 174
yoj777464: calls 174
*** TURN *** [Td 9d 4c] [4h]
Kevin12345Mc: bets 638
yoj777464: calls 638
*** RIVER *** [Td 9d 4c 4h] [2c]
Kevin12345Mc: bets 1720
yoj777464: folds 
Uncalled bet (1720) returned to Kevin12345Mc
Kevin12345Mc collected 2152 from pot
Kevin12345Mc: doesn't show hand 
*** SUMMARY ***
Total pot 2152 | Rake 0 
Board [Td 9d 4c 4h 2c]
Seat 1: Tango Habana (big blind) folded before Flop
Seat 2: Chiochetta34 folded before Flop (didn't bet)
Seat 3: félix2011 folded before Flop (didn't bet)
Seat 4: PexZz folded before Flop (didn't bet)
Seat 5: yoj777464 folded on the River
Seat 6: Sasiado folded before Flop (didn't bet)
Seat 7: I eat glass (button) folded before Flop (didn't bet)
Seat 8: Kevin12345Mc (small blind) collected (2152)



PokerStars Hand #254985484022: Tournament #3860676529, $0.46+$1.50+$0.24 USD Hold'em No Limit - Level III (35/70) - 2025/02/22 14:46:48 WET [2025/02/22 9:46:48 ET]
Table '3860676529 25' 8-max Seat #8 is the button
Seat 1: Tango Habana (3250 in chips, $1.50 bounty) 
Seat 2: Chiochetta34 (8754 in chips, $1.50 bounty) 
Seat 3: félix2011 (4767 in chips, $1.50 bounty) 
Seat 4: PexZz (4265 in chips, $1.50 bounty) 
Seat 5: yoj777464 (9819 in chips, $2.25 bounty) 
Seat 6: Sasiado (4132 in chips, $1.50 bounty) 
Seat 7: I eat glass (7774 in chips, $2.25 bounty) 
Seat 8: Kevin12345Mc (7444 in chips, $1.50 bounty) 
Tango Habana: posts the ante 11
Chiochetta34: posts the ante 11
félix2011: posts the ante 11
PexZz: posts the ante 11
yoj777464: posts the ante 11
Sasiado: posts the ante 11
I eat glass: posts the ante 11
Kevin12345Mc: posts the ante 11
Tango Habana: posts small blind 35
Chiochetta34: posts big blind 70
*** HOLE CARDS ***
Dealt to Kevin12345Mc [2h Js]
félix2011: raises 77 to 147
PexZz: folds 
yoj777464: calls 147
Sasiado: folds 
I eat glass: calls 147
Kevin12345Mc: folds 
Tango Habana: folds 
Chiochetta34: folds 
*** FLOP *** [Kd 4c Td]
félix2011: checks 
yoj777464: checks 
I eat glass: bets 634
félix2011: calls 634
yoj777464: folds 
*** TURN *** [Kd 4c Td] [Kh]
félix2011: checks 
I eat glass: bets 951
félix2011: folds 
Uncalled bet (951) returned to I eat glass
I eat glass collected 1902 from pot
*** SUMMARY ***
Total pot 1902 | Rake 0 
Board [Kd 4c Td Kh]
Seat 1: Tango Habana (small blind) folded before Flop
Seat 2: Chiochetta34 (big blind) folded before Flop
Seat 3: félix2011 folded on the Turn
Seat 4: PexZz folded before Flop (didn't bet)
Seat 5: yoj777464 folded on the Flop
Seat 6: Sasiado folded before Flop (didn't bet)
Seat 7: I eat glass collected (1902)
Seat 8: Kevin12345Mc (button) folded before Flop (didn't bet)



PokerStars Hand #254985504152: Tournament #3860676529, $0.46+$1.50+$0.24 USD Hold'em No Limit - Level III (35/70) - 2025/02/22 14:48:31 WET [2025/02/22 9:48:31 ET]
Table '3860676529 25' 8-max Seat #1 is the button
Seat 1: Tango Habana (3204 in chips, $1.50 bounty) 
Seat 2: Chiochetta34 (8673 in chips, $1.50 bounty) 
Seat 3: félix2011 (3975 in chips, $1.50 bounty) 
Seat 4: PexZz (4254 in chips, $1.50 bounty) 
Seat 5: yoj777464 (9661 in chips, $2.25 bounty) 
Seat 6: Sasiado (4121 in chips, $1.50 bounty) 
Seat 7: I eat glass (8884 in chips, $2.25 bounty) 
Seat 8: Kevin12345Mc (7433 in chips, $1.50 bounty) 
Tango Habana: posts the ante 11
Chiochetta34: posts the ante 11
félix2011: posts the ante 11
PexZz: posts the ante 11
yoj777464: posts the ante 11
Sasiado: posts the ante 11
I eat glass: posts the ante 11
Kevin12345Mc: posts the ante 11
Chiochetta34: posts small blind 35
félix2011: posts big blind 70
*** HOLE CARDS ***
Dealt to Kevin12345Mc [Qd Kh]
PexZz: folds 
yoj777464: folds 
Sasiado: raises 105 to 175
I eat glass: folds 
Kevin12345Mc: calls 175
Tango Habana: folds 
Chiochetta34: folds 
félix2011 has timed out
félix2011: folds 
félix2011 is sitting out
*** FLOP *** [Ah 9d 5h]
félix2011 has returned
Sasiado: checks 
Kevin12345Mc: checks 
*** TURN *** [Ah 9d 5h] [Ad]
Sasiado: bets 210
Kevin12345Mc: raises 636 to 846
Sasiado: calls 636
*** RIVER *** [Ah 9d 5h Ad] [Jd]
Sasiado: checks 
Kevin12345Mc: bets 6401 and is all-in
Sasiado: folds 
Uncalled bet (6401) returned to Kevin12345Mc
Kevin12345Mc collected 2235 from pot
Kevin12345Mc: doesn't show hand 
*** SUMMARY ***
Total pot 2235 | Rake 0 
Board [Ah 9d 5h Ad Jd]
Seat 1: Tango Habana (button) folded before Flop (didn't bet)
Seat 2: Chiochetta34 (small blind) folded before Flop
Seat 3: félix2011 (big blind) folded before Flop
Seat 4: PexZz folded before Flop (didn't bet)
Seat 5: yoj777464 folded before Flop (didn't bet)
Seat 6: Sasiado folded on the River
Seat 7: I eat glass folded before Flop (didn't bet)
Seat 8: Kevin12345Mc collected (2235)



PokerStars Hand #254985533080: Tournament #3860676529, $0.46+$1.50+$0.24 USD Hold'em No Limit - Level III (35/70) - 2025/02/22 14:50:59 WET [2025/02/22 9:50:59 ET]
Table '3860676529 25' 8-max Seat #2 is the button
Seat 1: Tango Habana (3193 in chips, $1.50 bounty) 
Seat 2: Chiochetta34 (8627 in chips, $1.50 bounty) 
Seat 3: félix2011 (3894 in chips, $1.50 bounty) 
Seat 4: PexZz (4243 in chips, $1.50 bounty) 
Seat 5: yoj777464 (9650 in chips, $2.25 bounty) 
Seat 6: Sasiado (3089 in chips, $1.50 bounty) 
Seat 7: I eat glass (8873 in chips, $2.25 bounty) 
Seat 8: Kevin12345Mc (8636 in chips, $1.50 bounty) 
Tango Habana: posts the ante 11
Chiochetta34: posts the ante 11
félix2011: posts the ante 11
PexZz: posts the ante 11
yoj777464: posts the ante 11
Sasiado: posts the ante 11
I eat glass: posts the ante 11
Kevin12345Mc: posts the ante 11
félix2011: posts small blind 35
PexZz: posts big blind 70
*** HOLE CARDS ***
Dealt to Kevin12345Mc [Ac 9c]
yoj777464: raises 70 to 140
Sasiado: folds 
I eat glass: calls 140
Kevin12345Mc: calls 140
Tango Habana: calls 140
Chiochetta34: raises 70 to 210
félix2011: folds 
PexZz: folds 
yoj777464: calls 70
I eat glass: calls 70
Kevin12345Mc: calls 70
Tango Habana: calls 70
*** FLOP *** [Jd 7d 4d]
yoj777464: checks 
I eat glass: bets 552
Kevin12345Mc: folds 
Tango Habana: folds 
Chiochetta34: calls 552
yoj777464: folds 
*** TURN *** [Jd 7d 4d] [5h]
I eat glass: bets 1174
Chiochetta34: calls 1174
*** RIVER *** [Jd 7d 4d 5h] [Qh]
I eat glass: bets 1050
Chiochetta34: calls 1050
*** SHOW DOWN ***
I eat glass: shows [Jc Kd] (a pair of Jacks)
Chiochetta34: mucks hand 
I eat glass collected 6795 from pot
*** SUMMARY ***
Total pot 6795 | Rake 0 
Board [Jd 7d 4d 5h Qh]
Seat 1: Tango Habana folded on the Flop
Seat 2: Chiochetta34 (button) mucked [6c 6d]
Seat 3: félix2011 (small blind) folded before Flop
Seat 4: PexZz (big blind) folded before Flop
Seat 5: yoj777464 folded on the Flop
Seat 6: Sasiado folded before Flop (didn't bet)
Seat 7: I eat glass showed [Jc Kd] and won (6795) with a pair of Jacks
Seat 8: Kevin12345Mc folded on the Flop



PokerStars Hand #254985551689: Tournament #3860676529, $0.46+$1.50+$0.24 USD Hold'em No Limit - Level III (35/70) - 2025/02/22 14:52:34 WET [2025/02/22 9:52:34 ET]
Table '3860676529 25' 8-max Seat #3 is the button
Seat 1: Tango Habana (2972 in chips, $1.50 bounty) 
Seat 2: Chiochetta34 (5630 in chips, $1.50 bounty) 
Seat 3: félix2011 (3848 in chips, $1.50 bounty) 
Seat 4: PexZz (4162 in chips, $1.50 bounty) 
Seat 5: yoj777464 (9429 in chips, $2.25 bounty) 
Seat 6: Sasiado (3078 in chips, $1.50 bounty) 
Seat 7: I eat glass (12671 in chips, $2.25 bounty) 
Seat 8: Kevin12345Mc (8415 in chips, $1.50 bounty) 
Tango Habana: posts the ante 11
Chiochetta34: posts the ante 11
félix2011: posts the ante 11
PexZz: posts the ante 11
yoj777464: posts the ante 11
Sasiado: posts the ante 11
I eat glass: posts the ante 11
Kevin12345Mc: posts the ante 11
PexZz: posts small blind 35
yoj777464: posts big blind 70
*** HOLE CARDS ***
Dealt to Kevin12345Mc [2s 7d]
Sasiado: folds 
I eat glass: folds 
Kevin12345Mc: folds 
Tango Habana: folds 
Chiochetta34: folds 
félix2011: raises 77 to 147
PexZz: folds 
yoj777464: calls 77
*** FLOP *** [Th Qd 3h]
yoj777464: checks 
félix2011: bets 126
yoj777464: folds 
Uncalled bet (126) returned to félix2011
félix2011 collected 417 from pot
félix2011: doesn't show hand 
*** SUMMARY ***
Total pot 417 | Rake 0 
Board [Th Qd 3h]
Seat 1: Tango Habana folded before Flop (didn't bet)
Seat 2: Chiochetta34 folded before Flop (didn't bet)
Seat 3: félix2011 (button) collected (417)
Seat 4: PexZz (small blind) folded before Flop
Seat 5: yoj777464 (big blind) folded on the Flop
Seat 6: Sasiado folded before Flop (didn't bet)
Seat 7: I eat glass folded before Flop (didn't bet)
Seat 8: Kevin12345Mc folded before Flop (didn't bet)



PokerStars Hand #254985563812: Tournament #3860676529, $0.46+$1.50+$0.24 USD Hold'em No Limit - Level III (35/70) - 2025/02/22 14:53:36 WET [2025/02/22 9:53:36 ET]
Table '3860676529 25' 8-max Seat #4 is the button
Seat 1: Tango Habana (2961 in chips, $1.50 bounty) 
Seat 2: Chiochetta34 (5619 in chips, $1.50 bounty) 
Seat 3: félix2011 (4107 in chips, $1.50 bounty) 
Seat 4: PexZz (4116 in chips, $1.50 bounty) 
Seat 5: yoj777464 (9271 in chips, $2.25 bounty) 
Seat 6: Sasiado (3067 in chips, $1.50 bounty) 
Seat 7: I eat glass (12660 in chips, $2.25 bounty) 
Seat 8: Kevin12345Mc (8404 in chips, $1.50 bounty) 
Tango Habana: posts the ante 11
Chiochetta34: posts the ante 11
félix2011: posts the ante 11
PexZz: posts the ante 11
yoj777464: posts the ante 11
Sasiado: posts the ante 11
I eat glass: posts the ante 11
Kevin12345Mc: posts the ante 11
yoj777464: posts small blind 35
Sasiado: posts big blind 70
*** HOLE CARDS ***
Dealt to Kevin12345Mc [Qs Th]
I eat glass: folds 
Kevin12345Mc: folds 
Tango Habana: folds 
Chiochetta34: calls 70
félix2011: folds 
PexZz: folds 
yoj777464: calls 35
Sasiado: checks 
*** FLOP *** [8c Ah Td]
yoj777464: checks 
Sasiado: checks 
Chiochetta34: checks 
*** TURN *** [8c Ah Td] [3h]
yoj777464: checks 
Sasiado: checks 
Chiochetta34: checks 
*** RIVER *** [8c Ah Td 3h] [Qh]
yoj777464: checks 
Sasiado: checks 
Chiochetta34: checks 
*** SHOW DOWN ***
yoj777464: shows [Ks 9s] (high card Ace)
Sasiado: shows [3d 6s] (a pair of Threes)
Chiochetta34: shows [Qd 6h] (a pair of Queens)
Chiochetta34 collected 298 from pot
*** SUMMARY ***
Total pot 298 | Rake 0 
Board [8c Ah Td 3h Qh]
Seat 1: Tango Habana folded before Flop (didn't bet)
Seat 2: Chiochetta34 showed [Qd 6h] and won (298) with a pair of Queens
Seat 3: félix2011 folded before Flop (didn't bet)
Seat 4: PexZz (button) folded before Flop (didn't bet)
Seat 5: yoj777464 (small blind) showed [Ks 9s] and lost with high card Ace
Seat 6: Sasiado (big blind) showed [3d 6s] and lost with a pair of Threes
Seat 7: I eat glass folded before Flop (didn't bet)
Seat 8: Kevin12345Mc folded before Flop (didn't bet)



PokerStars Hand #254985574731: Tournament #3860676529, $0.46+$1.50+$0.24 USD Hold'em No Limit - Level IV (40/80) - 2025/02/22 14:54:31 WET [2025/02/22 9:54:31 ET]
Table '3860676529 25' 8-max Seat #5 is the button
Seat 1: Tango Habana (2950 in chips, $1.50 bounty) 
Seat 2: Chiochetta34 (5836 in chips, $1.50 bounty) 
Seat 3: félix2011 (4096 in chips, $1.50 bounty) 
Seat 4: PexZz (4105 in chips, $1.50 bounty) 
Seat 5: yoj777464 (9190 in chips, $2.25 bounty) 
Seat 6: Sasiado (2986 in chips, $1.50 bounty) 
Seat 7: I eat glass (12649 in chips, $2.25 bounty) 
Seat 8: Kevin12345Mc (8393 in chips, $1.50 bounty) 
Tango Habana: posts the ante 12
Chiochetta34: posts the ante 12
félix2011: posts the ante 12
PexZz: posts the ante 12
yoj777464: posts the ante 12
Sasiado: posts the ante 12
I eat glass: posts the ante 12
Kevin12345Mc: posts the ante 12
Sasiado: posts small blind 40
I eat glass: posts big blind 80
*** HOLE CARDS ***
Dealt to Kevin12345Mc [7c 4s]
Kevin12345Mc: folds 
Tango Habana: folds 
Chiochetta34: raises 80 to 160
félix2011: raises 320 to 480
PexZz: folds 
yoj777464: calls 480
Sasiado: folds 
I eat glass: folds 
Chiochetta34: calls 320
*** FLOP *** [6s 9c Th]
Chiochetta34: checks 
félix2011: bets 560
yoj777464: calls 560
Chiochetta34: calls 560
*** TURN *** [6s 9c Th] [3c]
Chiochetta34: checks 
félix2011: bets 3044 and is all-in
yoj777464: folds 
Chiochetta34: folds 
Uncalled bet (3044) returned to félix2011
félix2011 collected 3336 from pot
félix2011: doesn't show hand 
*** SUMMARY ***
Total pot 3336 | Rake 0 
Board [6s 9c Th 3c]
Seat 1: Tango Habana folded before Flop (didn't bet)
Seat 2: Chiochetta34 folded on the Turn
Seat 3: félix2011 collected (3336)
Seat 4: PexZz folded before Flop (didn't bet)
Seat 5: yoj777464 (button) folded on the Turn
Seat 6: Sasiado (small blind) folded before Flop
Seat 7: I eat glass (big blind) folded before Flop
Seat 8: Kevin12345Mc folded before Flop (didn't bet)



PokerStars Hand #254985663842: Tournament #3860676529, $0.46+$1.50+$0.24 USD Hold'em No Limit - Level IV (40/80) - 2025/02/22 15:03:14 WET [2025/02/22 10:03:14 ET]
Table '3860676529 25' 8-max Seat #7 is the button
Seat 1: Tango Habana (2938 in chips, $1.50 bounty) 
Seat 2: Chiochetta34 (4784 in chips, $1.50 bounty) 
Seat 3: félix2011 (6380 in chips, $1.50 bounty) 
Seat 4: PexZz (4093 in chips, $1.50 bounty) 
Seat 5: yoj777464 (8138 in chips, $2.25 bounty) 
Seat 6: motoboy13sp (5000 in chips, $1.50 bounty) 
Seat 7: I eat glass (12557 in chips, $2.25 bounty) 
Seat 8: Kevin12345Mc (8381 in chips, $1.50 bounty) 
Tango Habana: posts the ante 12
Chiochetta34: posts the ante 12
félix2011: posts the ante 12
PexZz: posts the ante 12
yoj777464: posts the ante 12
motoboy13sp: posts the ante 12
I eat glass: posts the ante 12
Kevin12345Mc: posts the ante 12
Kevin12345Mc: posts small blind 40
Tango Habana: posts big blind 80
*** HOLE CARDS ***
Dealt to Kevin12345Mc [6h 4s]
Chiochetta34 has timed out while disconnected
Chiochetta34: folds 
Chiochetta34 is sitting out
félix2011: folds 
PexZz: raises 80 to 160
yoj777464: calls 160
motoboy13sp: folds 
I eat glass: raises 320 to 480
Kevin12345Mc: folds 
Tango Habana: folds 
PexZz: folds 
yoj777464: calls 320
*** FLOP *** [8c 8s Qs]
yoj777464: checks 
I eat glass: bets 320
yoj777464: calls 320
*** TURN *** [8c 8s Qs] [Th]
yoj777464 is disconnected 
yoj777464 is connected 
yoj777464 is disconnected 
yoj777464 is connected 
yoj777464 has timed out
yoj777464: checks 
I eat glass: bets 988
yoj777464: calls 988
*** RIVER *** [8c 8s Qs Th] [5c]
yoj777464: checks 
I eat glass: bets 1176
yoj777464: raises 5162 to 6338 and is all-in
I eat glass: calls 5162
*** SHOW DOWN ***
yoj777464: shows [8h Qh] (a full house, Eights full of Queens)
I eat glass: shows [Kd Kc] (two pair, Kings and Eights)
yoj777464 collected 16628 from pot
*** SUMMARY ***
Total pot 16628 | Rake 0 
Board [8c 8s Qs Th 5c]
Seat 1: Tango Habana (big blind) folded before Flop
Seat 2: Chiochetta34 folded before Flop (didn't bet)
Seat 3: félix2011 folded before Flop (didn't bet)
Seat 4: PexZz folded before Flop
Seat 5: yoj777464 showed [8h Qh] and won (16628) with a full house, Eights full of Queens
Seat 6: motoboy13sp folded before Flop (didn't bet)
Seat 7: I eat glass (button) showed [Kd Kc] and lost with two pair, Kings and Eights
Seat 8: Kevin12345Mc (small blind) folded before Flop



PokerStars Hand #254985702843: Tournament #3860676529, $0.46+$1.50+$0.24 USD Hold'em No Limit - Level IV (40/80) - 2025/02/22 15:06:27 WET [2025/02/22 10:06:27 ET]
Table '3860676529 25' 8-max Seat #8 is the button
Seat 1: Tango Habana (2846 in chips, $1.50 bounty) 
Seat 2: Chiochetta34 (4772 in chips, $1.50 bounty) is sitting out
Seat 3: félix2011 (6368 in chips, $1.50 bounty) 
Seat 4: PexZz (3921 in chips, $1.50 bounty) 
Seat 5: yoj777464 (16628 in chips, $2.25 bounty) 
Seat 6: motoboy13sp (4988 in chips, $1.50 bounty) 
Seat 7: I eat glass (4419 in chips, $2.25 bounty) 
Seat 8: Kevin12345Mc (8329 in chips, $1.50 bounty) 
Tango Habana: posts the ante 12
Chiochetta34: posts the ante 12
félix2011: posts the ante 12
PexZz: posts the ante 12
yoj777464: posts the ante 12
motoboy13sp: posts the ante 12
I eat glass: posts the ante 12
Kevin12345Mc: posts the ante 12
Tango Habana: posts small blind 40
Chiochetta34: posts big blind 80
*** HOLE CARDS ***
Dealt to Kevin12345Mc [6h Th]
félix2011: folds 
PexZz: folds 
yoj777464 has timed out
yoj777464: folds 
yoj777464 is sitting out
yoj777464 has returned
motoboy13sp: folds 
I eat glass: folds 
Kevin12345Mc: folds 
Tango Habana: raises 80 to 160
Chiochetta34: folds 
Uncalled bet (80) returned to Tango Habana
Tango Habana collected 256 from pot
Tango Habana: doesn't show hand 
*** SUMMARY ***
Total pot 256 | Rake 0 
Seat 1: Tango Habana (small blind) collected (256)
Seat 2: Chiochetta34 (big blind) folded before Flop
Seat 3: félix2011 folded before Flop (didn't bet)
Seat 4: PexZz folded before Flop (didn't bet)
Seat 5: yoj777464 folded before Flop (didn't bet)
Seat 6: motoboy13sp folded before Flop (didn't bet)
Seat 7: I eat glass folded before Flop (didn't bet)
Seat 8: Kevin12345Mc (button) folded before Flop (didn't bet)



PokerStars Hand #254985709061: Tournament #3860676529, $0.46+$1.50+$0.24 USD Hold'em No Limit - Level IV (40/80) - 2025/02/22 15:06:58 WET [2025/02/22 10:06:58 ET]
Table '3860676529 25' 8-max Seat #1 is the button
Seat 1: Tango Habana (3010 in chips, $1.50 bounty) 
Seat 2: Chiochetta34 (4680 in chips, $1.50 bounty) is sitting out
Seat 3: félix2011 (6356 in chips, $1.50 bounty) 
Seat 4: PexZz (3909 in chips, $1.50 bounty) 
Seat 5: yoj777464 (16616 in chips, $2.25 bounty) 
Seat 6: motoboy13sp (4976 in chips, $1.50 bounty) 
Seat 7: I eat glass (4407 in chips, $2.25 bounty) 
Seat 8: Kevin12345Mc (8317 in chips, $1.50 bounty) 
Tango Habana: posts the ante 12
Chiochetta34: posts the ante 12
félix2011: posts the ante 12
PexZz: posts the ante 12
yoj777464: posts the ante 12
motoboy13sp: posts the ante 12
I eat glass: posts the ante 12
Kevin12345Mc: posts the ante 12
Chiochetta34: posts small blind 40
félix2011: posts big blind 80
*** HOLE CARDS ***
Dealt to Kevin12345Mc [Tc 3d]
PexZz: raises 80 to 160
yoj777464: calls 160
motoboy13sp: folds 
I eat glass: folds 
Kevin12345Mc: folds 
Tango Habana: folds 
Chiochetta34: folds 
félix2011: calls 80
*** FLOP *** [7h 2c 6h]
félix2011: checks 
PexZz: checks 
yoj777464: checks 
*** TURN *** [7h 2c 6h] [Jd]
félix2011: bets 407
PexZz: folds 
yoj777464: calls 407
*** RIVER *** [7h 2c 6h Jd] [2d]
félix2011: bets 715
yoj777464: calls 715
*** SHOW DOWN ***
félix2011: shows [Jc Qc] (two pair, Jacks and Deuces)
yoj777464: shows [Js As] (two pair, Jacks and Deuces - Ace kicker)
yoj777464 collected 2860 from pot
*** SUMMARY ***
Total pot 2860 | Rake 0 
Board [7h 2c 6h Jd 2d]
Seat 1: Tango Habana (button) folded before Flop (didn't bet)
Seat 2: Chiochetta34 (small blind) folded before Flop
Seat 3: félix2011 (big blind) showed [Jc Qc] and lost with two pair, Jacks and Deuces
Seat 4: PexZz folded on the Turn
Seat 5: yoj777464 showed [Js As] and won (2860) with two pair, Jacks and Deuces
Seat 6: motoboy13sp folded before Flop (didn't bet)
Seat 7: I eat glass folded before Flop (didn't bet)
Seat 8: Kevin12345Mc folded before Flop (didn't bet)



PokerStars Hand #254985724071: Tournament #3860676529, $0.46+$1.50+$0.24 USD Hold'em No Limit - Level IV (40/80) - 2025/02/22 15:08:13 WET [2025/02/22 10:08:13 ET]
Table '3860676529 25' 8-max Seat #2 is the button
Seat 1: Tango Habana (2998 in chips, $1.50 bounty) 
Seat 2: Chiochetta34 (4628 in chips, $1.50 bounty) is sitting out
Seat 3: félix2011 (5062 in chips, $1.50 bounty) 
Seat 4: PexZz (3737 in chips, $1.50 bounty) 
Seat 5: yoj777464 (18182 in chips, $2.25 bounty) 
Seat 6: motoboy13sp (4964 in chips, $1.50 bounty) 
Seat 7: I eat glass (4395 in chips, $2.25 bounty) 
Seat 8: Kevin12345Mc (8305 in chips, $1.50 bounty) 
Tango Habana: posts the ante 12
Chiochetta34: posts the ante 12
félix2011: posts the ante 12
PexZz: posts the ante 12
yoj777464: posts the ante 12
motoboy13sp: posts the ante 12
I eat glass: posts the ante 12
Kevin12345Mc: posts the ante 12
félix2011: posts small blind 40
PexZz: posts big blind 80
*** HOLE CARDS ***
Dealt to Kevin12345Mc [7d Jc]
Chiochetta34 is disconnected 
Chiochetta34 has returned
yoj777464: calls 80
motoboy13sp: folds 
I eat glass: calls 80
Kevin12345Mc: folds 
Tango Habana: folds 
Chiochetta34: folds 
félix2011: calls 40
PexZz: checks 
*** FLOP *** [4h 5h 9d]
félix2011: checks 
PexZz: checks 
yoj777464: bets 160
I eat glass: calls 160
félix2011: folds 
PexZz: calls 160
*** TURN *** [4h 5h 9d] [Qd]
PexZz: checks 
yoj777464: checks 
I eat glass: bets 368
PexZz: calls 368
yoj777464: calls 368
*** RIVER *** [4h 5h 9d Qd] [2d]
PexZz: checks 
yoj777464: checks 
I eat glass: bets 840
PexZz: calls 840
yoj777464: folds 
*** SHOW DOWN ***
I eat glass: shows [4c 4s] (three of a kind, Fours)
PexZz: shows [Jd 4d] (a flush, Queen high)
PexZz collected 3680 from pot
*** SUMMARY ***
Total pot 3680 | Rake 0 
Board [4h 5h 9d Qd 2d]
Seat 1: Tango Habana folded before Flop (didn't bet)
Seat 2: Chiochetta34 (button) folded before Flop (didn't bet)
Seat 3: félix2011 (small blind) folded on the Flop
Seat 4: PexZz (big blind) showed [Jd 4d] and won (3680) with a flush, Queen high
Seat 5: yoj777464 folded on the River
Seat 6: motoboy13sp folded before Flop (didn't bet)
Seat 7: I eat glass showed [4c 4s] and lost with three of a kind, Fours
Seat 8: Kevin12345Mc folded before Flop (didn't bet)



PokerStars Hand #254985742391: Tournament #3860676529, $0.46+$1.50+$0.24 USD Hold'em No Limit - Level IV (40/80) - 2025/02/22 15:09:44 WET [2025/02/22 10:09:44 ET]
Table '3860676529 25' 8-max Seat #3 is the button
Seat 1: Tango Habana (2986 in chips, $1.50 bounty) 
Seat 2: Chiochetta34 (4616 in chips, $1.50 bounty) 
Seat 3: félix2011 (4970 in chips, $1.50 bounty) 
Seat 4: PexZz (5957 in chips, $1.50 bounty) 
Seat 5: yoj777464 (17562 in chips, $2.25 bounty) 
Seat 6: motoboy13sp (4952 in chips, $1.50 bounty) 
Seat 7: I eat glass (2935 in chips, $2.25 bounty) 
Seat 8: Kevin12345Mc (8293 in chips, $1.50 bounty) 
Tango Habana: posts the ante 12
Chiochetta34: posts the ante 12
félix2011: posts the ante 12
PexZz: posts the ante 12
yoj777464: posts the ante 12
motoboy13sp: posts the ante 12
I eat glass: posts the ante 12
Kevin12345Mc: posts the ante 12
PexZz: posts small blind 40
yoj777464: posts big blind 80
*** HOLE CARDS ***
Dealt to Kevin12345Mc [2h 2s]
motoboy13sp: folds 
I eat glass: folds 
Kevin12345Mc: folds 
Tango Habana: raises 80 to 160
Chiochetta34: calls 160
félix2011: folds 
PexZz: raises 480 to 640
yoj777464: calls 560
Tango Habana: folds 
Chiochetta34: calls 480
*** FLOP *** [4d 6d Kc]
PexZz: checks 
yoj777464: checks 
Chiochetta34: bets 1088
PexZz: calls 1088
yoj777464: folds 
*** TURN *** [4d 6d Kc] [3h]
PexZz: checks 
Chiochetta34: bets 2176
PexZz: folds 
Uncalled bet (2176) returned to Chiochetta34
Chiochetta34 collected 4352 from pot
Chiochetta34: doesn't show hand 
*** SUMMARY ***
Total pot 4352 | Rake 0 
Board [4d 6d Kc 3h]
Seat 1: Tango Habana folded before Flop
Seat 2: Chiochetta34 collected (4352)
Seat 3: félix2011 (button) folded before Flop (didn't bet)
Seat 4: PexZz (small blind) folded on the Turn
Seat 5: yoj777464 (big blind) folded on the Flop
Seat 6: motoboy13sp folded before Flop (didn't bet)
Seat 7: I eat glass folded before Flop (didn't bet)
Seat 8: Kevin12345Mc folded before Flop (didn't bet)



PokerStars Hand #254985765027: Tournament #3860676529, $0.46+$1.50+$0.24 USD Hold'em No Limit - Level V (45/90) - 2025/02/22 15:11:36 WET [2025/02/22 10:11:36 ET]
Table '3860676529 25' 8-max Seat #4 is the button
Seat 1: Tango Habana (2814 in chips, $1.50 bounty) 
Seat 2: Chiochetta34 (7228 in chips, $1.50 bounty) 
Seat 3: félix2011 (4958 in chips, $1.50 bounty) 
Seat 4: PexZz (4217 in chips, $1.50 bounty) 
Seat 5: yoj777464 (16910 in chips, $2.25 bounty) 
Seat 6: motoboy13sp (4940 in chips, $1.50 bounty) 
Seat 7: I eat glass (2923 in chips, $2.25 bounty) 
Seat 8: Kevin12345Mc (8281 in chips, $1.50 bounty) 
Tango Habana: posts the ante 14
Chiochetta34: posts the ante 14
félix2011: posts the ante 14
PexZz: posts the ante 14
yoj777464: posts the ante 14
motoboy13sp: posts the ante 14
I eat glass: posts the ante 14
Kevin12345Mc: posts the ante 14
yoj777464: posts small blind 45
motoboy13sp: posts big blind 90
*** HOLE CARDS ***
Dealt to Kevin12345Mc [4d 5h]
I eat glass: folds 
Kevin12345Mc: folds 
Tango Habana: folds 
Chiochetta34: calls 90
félix2011: raises 360 to 450
PexZz: folds 
yoj777464: folds 
motoboy13sp: folds 
Chiochetta34: calls 360
*** FLOP *** [Ks 7s 6s]
Chiochetta34: bets 574
félix2011: calls 574
*** TURN *** [Ks 7s 6s] [6c]
Chiochetta34: bets 1148
félix2011: calls 1148
*** RIVER *** [Ks 7s 6s 6c] [Qs]
Chiochetta34: bets 22964d5h
félix2011: raises 476 to 2772 and is all-in
Chiochetta34: folds 
Uncalled bet (476) returned to félix2011
félix2011 collected 9183 from pot
félix2011: doesn't show hand 
*** SUMMARY ***
Total pot 9183 | Rake 0 
Board [Ks 7s 6s 6c Qs]
Seat 1: Tango Habana folded before Flop (didn't bet)
Seat 2: Chiochetta34 folded on the River
Seat 3: félix2011 collected (9183)
Seat 4: PexZz (button) folded before Flop (didn't bet)
Seat 5: yoj777464 (small blind) folded before Flop
Seat 6: motoboy13sp (big blind) folded before Flop
Seat 7: I eat glass folded before Flop (didn't bet)
Seat 8: Kevin12345Mc folded before Flop (didn't bet)



PokerStars Hand #254985778939: Tournament #3860676529, $0.46+$1.50+$0.24 USD Hold'em No Limit - Level V (45/90) - 2025/02/22 15:12:45 WET [2025/02/22 10:12:45 ET]
Table '3860676529 25' 8-max Seat #5 is the button
Seat 1: Tango Habana (2800 in chips, $1.50 bounty) 
Seat 2: Chiochetta34 (2746 in chips, $1.50 bounty) 
Seat 3: félix2011 (9659 in chips, $1.50 bounty) 
Seat 4: PexZz (4203 in chips, $1.50 bounty) 
Seat 5: yoj777464 (16851 in chips, $2.25 bounty) 
Seat 6: motoboy13sp (4836 in chips, $1.50 bounty) 
Seat 7: I eat glass (2909 in chips, $2.25 bounty) 
Seat 8: Kevin12345Mc (8267 in chips, $1.50 bounty) 
Tango Habana: posts the ante 14
Chiochetta34: posts the ante 14
félix2011: posts the ante 14
PexZz: posts the ante 14
yoj777464: posts the ante 14
motoboy13sp: posts the ante 14
I eat glass: posts the ante 14
Kevin12345Mc: posts the ante 14
motoboy13sp: posts small blind 45
I eat glass: posts big blind 90
*** HOLE CARDS ***
Dealt to Kevin12345Mc [6h 8c]
Kevin12345Mc: folds 
Tango Habana: folds 
Chiochetta34: folds 
félix2011: folds 
PexZz: raises 90 to 180
yoj777464: folds 
motoboy13sp: folds 
I eat glass: calls 90
*** FLOP *** [Qc 8s 3c]
I eat glass: bets 259
PexZz: folds 
Uncalled bet (259) returned to I eat glass
I eat glass collected 517 from pot
*** SUMMARY ***
Total pot 517 | Rake 0 
Board [Qc 8s 3c]
Seat 1: Tango Habana folded before Flop (didn't bet)
Seat 2: Chiochetta34 folded before Flop (didn't bet)
Seat 3: félix2011 folded before Flop (didn't bet)
Seat 4: PexZz folded on the Flop
Seat 5: yoj777464 (button) folded before Flop (didn't bet)
Seat 6: motoboy13sp (small blind) folded before Flop
Seat 7: I eat glass (big blind) collected (517)
Seat 8: Kevin12345Mc folded before Flop (didn't bet)



PokerStars Hand #254985789240: Tournament #3860676529, $0.46+$1.50+$0.24 USD Hold'em No Limit - Level V (45/90) - 2025/02/22 15:13:35 WET [2025/02/22 10:13:35 ET]
Table '3860676529 25' 8-max Seat #6 is the button
Seat 1: Tango Habana (2786 in chips, $1.50 bounty) 
Seat 2: Chiochetta34 (2732 in chips, $1.50 bounty) 
Seat 3: félix2011 (9645 in chips, $1.50 bounty) 
Seat 4: PexZz (4009 in chips, $1.50 bounty) 
Seat 5: yoj777464 (16837 in chips, $2.25 bounty) 
Seat 6: motoboy13sp (4777 in chips, $1.50 bounty) 
Seat 7: I eat glass (3232 in chips, $2.25 bounty) 
Seat 8: Kevin12345Mc (8253 in chips, $1.50 bounty) 
Tango Habana: posts the ante 14
Chiochetta34: posts the ante 14
félix2011: posts the ante 14
PexZz: posts the ante 14
yoj777464: posts the ante 14
motoboy13sp: posts the ante 14
I eat glass: posts the ante 14
Kevin12345Mc: posts the ante 14
I eat glass: posts small blind 45
Kevin12345Mc: posts big blind 90
*** HOLE CARDS ***
Dealt to Kevin12345Mc [Td 8h]
Tango Habana: folds 
Chiochetta34: calls 90
félix2011: folds 
PexZz: raises 270 to 360
yoj777464: folds 
motoboy13sp: folds 
I eat glass: folds 
Kevin12345Mc: folds 
Chiochetta34: calls 270
*** FLOP *** [7s 7c Th]
Chiochetta34: checks 
PexZz: bets 242
Chiochetta34: folds 
Uncalled bet (242) returned to PexZz
PexZz collected 967 from pot
*** SUMMARY ***
Total pot 967 | Rake 0 
Board [7s 7c Th]
Seat 1: Tango Habana folded before Flop (didn't bet)
Seat 2: Chiochetta34 folded on the Flop
Seat 3: félix2011 folded before Flop (didn't bet)
Seat 4: PexZz collected (967)
Seat 5: yoj777464 folded before Flop (didn't bet)
Seat 6: motoboy13sp (button) folded before Flop (didn't bet)
Seat 7: I eat glass (small blind) folded before Flop
Seat 8: Kevin12345Mc (big blind) folded before Flop



PokerStars Hand #254985797634: Tournament #3860676529, $0.46+$1.50+$0.24 USD Hold'em No Limit - Level V (45/90) - 2025/02/22 15:14:17 WET [2025/02/22 10:14:17 ET]
Table '3860676529 25' 8-max Seat #7 is the button
Seat 1: Tango Habana (2772 in chips, $1.50 bounty) 
Seat 2: Chiochetta34 (2358 in chips, $1.50 bounty) 
Seat 3: félix2011 (9631 in chips, $1.50 bounty) 
Seat 4: PexZz (4602 in chips, $1.50 bounty) 
Seat 5: yoj777464 (16823 in chips, $2.25 bounty) 
Seat 6: motoboy13sp (4763 in chips, $1.50 bounty) 
Seat 7: I eat glass (3173 in chips, $2.25 bounty) 
Seat 8: Kevin12345Mc (8149 in chips, $1.50 bounty) 
Tango Habana: posts the ante 14
Chiochetta34: posts the ante 14
félix2011: posts the ante 14
PexZz: posts the ante 14
yoj777464: posts the ante 14
motoboy13sp: posts the ante 14
I eat glass: posts the ante 14
Kevin12345Mc: posts the ante 14
Kevin12345Mc: posts small blind 45
Tango Habana: posts big blind 90
*** HOLE CARDS ***
Dealt to Kevin12345Mc [Th Td]
Chiochetta34: raises 180 to 270
félix2011: folds 
PexZz: folds 
yoj777464: calls 270
motoboy13sp: folds 
I eat glass: folds 
Kevin12345Mc: raises 720 to 990
Tango Habana: folds 
Chiochetta34: calls 720
yoj777464: calls 720
*** FLOP *** [5d Tc 3d]
Kevin12345Mc: bets 1586
Chiochetta34: calls 1354 and is all-in
yoj777464: calls 1586
*** TURN *** [5d Tc 3d] [9s]
Kevin12345Mc: bets 5559 and is all-in
yoj777464: calls 5559
*** RIVER *** [5d Tc 3d 9s] [4s]
*** SHOW DOWN ***
Kevin12345Mc: shows [Th Td] (three of a kind, Tens)
yoj777464: shows [6d 8d] (high card Ten)
Kevin12345Mc collected 11582 from side pot
Chiochetta34: shows [9d Ks] (a pair of Nines)
Kevin12345Mc collected 7234 from main pot
Kevin12345Mc wins $0.75 for eliminating Chiochetta34 and their own bounty increases by $0.75 to $2.25
Chiochetta34 finished the tournament
*** SUMMARY ***
Total pot 18816 Main pot 7234. Side pot 11582. | Rake 0 
Board [5d Tc 3d 9s 4s]
Seat 1: Tango Habana (big blind) folded before Flop
Seat 2: Chiochetta34 showed [9d Ks] and lost with a pair of Nines
Seat 3: félix2011 folded before Flop (didn't bet)
Seat 4: PexZz folded before Flop (didn't bet)
Seat 5: yoj777464 showed [6d 8d] and lost with high card Ten
Seat 6: motoboy13sp folded before Flop (didn't bet)
Seat 7: I eat glass (button) folded before Flop (didn't bet)
Seat 8: Kevin12345Mc (small blind) showed [Th Td] and won (18816) with three of a kind, Tens



PokerStars Hand #254985814846: Tournament #3860676529, $0.46+$1.50+$0.24 USD Hold'em No Limit - Level V (45/90) - 2025/02/22 15:15:39 WET [2025/02/22 10:15:39 ET]
Table '3860676529 25' 8-max Seat #8 is the button
Seat 1: Tango Habana (2668 in chips, $1.50 bounty) 
Seat 3: félix2011 (9617 in chips, $1.50 bounty) 
Seat 4: PexZz (4588 in chips, $1.50 bounty) 
Seat 5: yoj777464 (8674 in chips, $2.25 bounty) 
Seat 6: motoboy13sp (4749 in chips, $1.50 bounty) 
Seat 7: I eat glass (3159 in chips, $2.25 bounty) 
Seat 8: Kevin12345Mc (18816 in chips, $2.25 bounty) 
Tango Habana: posts the ante 14
félix2011: posts the ante 14
PexZz: posts the ante 14
yoj777464: posts the ante 14
motoboy13sp: posts the ante 14
I eat glass: posts the ante 14
Kevin12345Mc: posts the ante 14
Tango Habana: posts small blind 45
félix2011: posts big blind 90
*** HOLE CARDS ***
Dealt to Kevin12345Mc [Jh 8c]
PexZz: folds 
yoj777464: calls 90
motoboy13sp: folds 
I eat glass: folds 
Kevin12345Mc: folds 
Tango Habana: folds 
Telum2 is disconnected 
félix2011: checks 
*** FLOP *** [7h 5h Qs]
félix2011: checks 
yoj777464: checks 
*** TURN *** [7h 5h Qs] [5s]
félix2011: bets 213
yoj777464: folds 
Uncalled bet (213) returned to félix2011
félix2011 collected 323 from pot
félix2011: doesn't show hand 
*** SUMMARY ***
Total pot 323 | Rake 0 
Board [7h 5h Qs 5s]
Seat 1: Tango Habana (small blind) folded before Flop
Seat 3: félix2011 (big blind) collected (323)
Seat 4: PexZz folded before Flop (didn't bet)
Seat 5: yoj777464 folded on the Turn
Seat 6: motoboy13sp folded before Flop (didn't bet)
Seat 7: I eat glass folded before Flop (didn't bet)
Seat 8: Kevin12345Mc (button) folded before Flop (didn't bet)



PokerStars Hand #254985825703: Tournament #3860676529, $0.46+$1.50+$0.24 USD Hold'em No Limit - Level V (45/90) - 2025/02/22 15:16:31 WET [2025/02/22 10:16:31 ET]
Table '3860676529 25' 8-max Seat #1 is the button
Seat 1: Tango Habana (2609 in chips, $1.50 bounty) 
Seat 2: Telum2 (5000 in chips) out of hand (moved from another table into small blind)
Seat 3: félix2011 (9836 in chips, $1.50 bounty) 
Seat 4: PexZz (4574 in chips, $1.50 bounty) 
Seat 5: yoj777464 (8570 in chips, $2.25 bounty) 
Seat 6: motoboy13sp (4735 in chips, $1.50 bounty) 
Seat 7: I eat glass (3145 in chips, $2.25 bounty) 
Seat 8: Kevin12345Mc (18802 in chips, $2.25 bounty) 
Telum2 will be allowed to play after the button
Tango Habana: posts the ante 14
félix2011: posts the ante 14
PexZz: posts the ante 14
yoj777464: posts the ante 14
motoboy13sp: posts the ante 14
I eat glass: posts the ante 14
Kevin12345Mc: posts the ante 14
félix2011: posts small blind 45
PexZz: posts big blind 90
*** HOLE CARDS ***
Dealt to Kevin12345Mc [Ts 8h]
yoj777464: calls 90
motoboy13sp: folds 
I eat glass: folds 
Kevin12345Mc: folds 
Tango Habana: folds 
félix2011: calls 45
PexZz: checks 
*** FLOP *** [Ah 4s Ac]
félix2011: checks 
PexZz: checks 
yoj777464: bets 90
félix2011: calls 90
PexZz: folds 
*** TURN *** [Ah 4s Ac] [9c]
félix2011: checks 
yoj777464: bets 274
félix2011: calls 274
*** RIVER *** [Ah 4s Ac 9c] [6d]
félix2011: checks 
yoj777464: bets 1096
félix2011: folds 
Uncalled bet (1096) returned to yoj777464
yoj777464 collected 1096 from pot
*** SUMMARY ***
Total pot 1096 | Rake 0 
Board [Ah 4s Ac 9c 6d]
Seat 1: Tango Habana (button) folded before Flop (didn't bet)
Seat 3: félix2011 (small blind) folded on the River
Seat 4: PexZz (big blind) folded on the Flop
Seat 5: yoj777464 collected (1096)
Seat 6: motoboy13sp folded before Flop (didn't bet)
Seat 7: I eat glass folded before Flop (didn't bet)
Seat 8: Kevin12345Mc folded before Flop (didn't bet)



PokerStars Hand #254985849506: Tournament #3860676529, $0.46+$1.50+$0.24 USD Hold'em No Limit - Level VI (50/100) - 2025/02/22 15:18:25 WET [2025/02/22 10:18:25 ET]
Table '3860676529 25' 8-max Seat #3 is the button
Seat 1: Tango Habana (2595 in chips, $1.50 bounty) 
Seat 2: Telum2 (5000 in chips, $1.50 bounty) 
Seat 3: félix2011 (9368 in chips, $1.50 bounty) 
Seat 4: PexZz (4470 in chips, $1.50 bounty) 
Seat 5: yoj777464 (9198 in chips, $2.25 bounty) 
Seat 6: motoboy13sp (4721 in chips, $1.50 bounty) 
Seat 7: I eat glass (3131 in chips, $2.25 bounty) 
Seat 8: Kevin12345Mc (18788 in chips, $2.25 bounty) 
Tango Habana: posts the ante 15
Telum2: posts the ante 15
félix2011: posts the ante 15
PexZz: posts the ante 15
yoj777464: posts the ante 15
motoboy13sp: posts the ante 15
I eat glass: posts the ante 15
Kevin12345Mc: posts the ante 15
PexZz: posts small blind 50
yoj777464: posts big blind 100
*** HOLE CARDS ***
Dealt to Kevin12345Mc [Kc 9h]
motoboy13sp: folds 
I eat glass: folds 
Kevin12345Mc: folds 
Tango Habana: folds 
Telum2: raises 100 to 200
félix2011: folds 
PexZz: folds 
yoj777464: raises 300 to 500
Telum2: calls 300
*** FLOP *** [8d 5s Kh]
yoj777464: bets 970
Telum2: raises 970 to 1940
yoj777464: calls 970
*** TURN *** [8d 5s Kh] [3c]
yoj777464: checks 
Telum2: bets 1700
yoj777464: raises 1700 to 3400
Telum2: calls 845 and is all-in
Uncalled bet (855) returned to yoj777464
*** RIVER *** [8d 5s Kh 3c] [Jc]
*** SHOW DOWN ***
yoj777464: shows [Th Tc] (a pair of Tens)
Telum2: shows [Jd Kd] (two pair, Kings and Jacks)
Telum2 collected 10140 from pot
*** SUMMARY ***
Total pot 10140 | Rake 0 
Board [8d 5s Kh 3c Jc]
Seat 1: Tango Habana folded before Flop (didn't bet)
Seat 2: Telum2 showed [Jd Kd] and won (10140) with two pair, Kings and Jacks
Seat 3: félix2011 (button) folded before Flop (didn't bet)
Seat 4: PexZz (small blind) folded before Flop
Seat 5: yoj777464 (big blind) showed [Th Tc] and lost with a pair of Tens
Seat 6: motoboy13sp folded before Flop (didn't bet)
Seat 7: I eat glass folded before Flop (didn't bet)
Seat 8: Kevin12345Mc folded before Flop (didn't bet)



PokerStars Hand #254985874060: Tournament #3860676529, $0.46+$1.50+$0.24 USD Hold'em No Limit - Level VI (50/100) - 2025/02/22 15:20:22 WET [2025/02/22 10:20:22 ET]
Table '3860676529 25' 8-max Seat #4 is the button
Seat 1: Tango Habana (2580 in chips, $1.50 bounty) 
Seat 2: Telum2 (10140 in chips, $1.50 bounty) 
Seat 3: félix2011 (9353 in chips, $1.50 bounty) 
Seat 4: PexZz (4405 in chips, $1.50 bounty) 
Seat 5: yoj777464 (4198 in chips, $2.25 bounty) 
Seat 6: motoboy13sp (4706 in chips, $1.50 bounty) 
Seat 7: I eat glass (3116 in chips, $2.25 bounty) 
Seat 8: Kevin12345Mc (18773 in chips, $2.25 bounty) 
Tango Habana: posts the ante 15
Telum2: posts the ante 15
félix2011: posts the ante 15
PexZz: posts the ante 15
yoj777464: posts the ante 15
motoboy13sp: posts the ante 15
I eat glass: posts the ante 15
Kevin12345Mc: posts the ante 15
yoj777464: posts small blind 50
motoboy13sp: posts big blind 100
*** HOLE CARDS ***
Dealt to Kevin12345Mc [6c 4s]
I eat glass: calls 100
Kevin12345Mc: folds 
Tango Habana: folds 
Telum2: calls 100
félix2011: folds 
PexZz: folds 
yoj777464: calls 50
motoboy13sp: raises 4591 to 4691 and is all-in
I eat glass: folds 
Telum2: calls 4591
yoj777464: folds 
*** FLOP *** [9s Tc 5c]
*** TURN *** [9s Tc 5c] [Qd]
*** RIVER *** [9s Tc 5c Qd] [4h]
*** SHOW DOWN ***
motoboy13sp: shows [Kh Ah] (high card Ace)
Telum2: shows [As Kc] (high card Ace)
motoboy13sp collected 4851 from pot
Telum2 collected 4851 from pot
*** SUMMARY ***
Total pot 9702 | Rake 0 
Board [9s Tc 5c Qd 4h]
Seat 1: Tango Habana folded before Flop (didn't bet)
Seat 2: Telum2 showed [As Kc] and won (4851) with high card Ace
Seat 3: félix2011 folded before Flop (didn't bet)
Seat 4: PexZz (button) folded before Flop (didn't bet)
Seat 5: yoj777464 (small blind) folded before Flop
Seat 6: motoboy13sp (big blind) showed [Kh Ah] and won (4851) with high card Ace
Seat 7: I eat glass folded before Flop
Seat 8: Kevin12345Mc folded before Flop (didn't bet)



PokerStars Hand #254985886164: Tournament #3860676529, $0.46+$1.50+$0.24 USD Hold'em No Limit - Level VI (50/100) - 2025/02/22 15:21:19 WET [2025/02/22 10:21:19 ET]
Table '3860676529 25' 8-max Seat #5 is the button
Seat 1: Tango Habana (2565 in chips, $1.50 bounty) 
Seat 2: Telum2 (10285 in chips, $1.50 bounty) 
Seat 3: félix2011 (9338 in chips, $1.50 bounty) 
Seat 4: PexZz (4390 in chips, $1.50 bounty) 
Seat 5: yoj777464 (4083 in chips, $2.25 bounty) 
Seat 6: motoboy13sp (4851 in chips, $1.50 bounty) 
Seat 7: I eat glass (3001 in chips, $2.25 bounty) 
Seat 8: Kevin12345Mc (18758 in chips, $2.25 bounty) 
Tango Habana: posts the ante 15
Telum2: posts the ante 15
félix2011: posts the ante 15
PexZz: posts the ante 15
yoj777464: posts the ante 15
motoboy13sp: posts the ante 15
I eat glass: posts the ante 15
Kevin12345Mc: posts the ante 15
motoboy13sp: posts small blind 50
I eat glass: posts big blind 100
*** HOLE CARDS ***
Dealt to Kevin12345Mc [Qs 8c]
Kevin12345Mc: folds 
Tango Habana: folds 
Telum2: folds 
félix2011: folds 
PexZz: folds 
yoj777464: folds 
motoboy13sp: calls 50
I eat glass: checks 
*** FLOP *** [As 4s 3c]
motoboy13sp: bets 160
I eat glass: folds 
Uncalled bet (160) returned to motoboy13sp
motoboy13sp collected 320 from pot
motoboy13sp: doesn't show hand 
*** SUMMARY ***
Total pot 320 | Rake 0 
Board [As 4s 3c]
Seat 1: Tango Habana folded before Flop (didn't bet)
Seat 2: Telum2 folded before Flop (didn't bet)
Seat 3: félix2011 folded before Flop (didn't bet)
Seat 4: PexZz folded before Flop (didn't bet)
Seat 5: yoj777464 (button) folded before Flop (didn't bet)
Seat 6: motoboy13sp (small blind) collected (320)
Seat 7: I eat glass (big blind) folded on the Flop
Seat 8: Kevin12345Mc folded before Flop (didn't bet)



PokerStars Hand #254985896782: Tournament #3860676529, $0.46+$1.50+$0.24 USD Hold'em No Limit - Level VI (50/100) - 2025/02/22 15:22:10 WET [2025/02/22 10:22:10 ET]
Table '3860676529 25' 8-max Seat #6 is the button
Seat 1: Tango Habana (2550 in chips, $1.50 bounty) 
Seat 2: Telum2 (10270 in chips, $1.50 bounty) 
Seat 3: félix2011 (9323 in chips, $1.50 bounty) 
Seat 4: PexZz (4375 in chips, $1.50 bounty) 
Seat 5: yoj777464 (4068 in chips, $2.25 bounty) 
Seat 6: motoboy13sp (5056 in chips, $1.50 bounty) 
Seat 7: I eat glass (2886 in chips, $2.25 bounty) 
Seat 8: Kevin12345Mc (18743 in chips, $2.25 bounty) 
Tango Habana: posts the ante 15
Telum2: posts the ante 15
félix2011: posts the ante 15
PexZz: posts the ante 15
yoj777464: posts the ante 15
motoboy13sp: posts the ante 15
I eat glass: posts the ante 15
Kevin12345Mc: posts the ante 15
I eat glass: posts small blind 50
Kevin12345Mc: posts big blind 100
*** HOLE CARDS ***
Dealt to Kevin12345Mc [7c 6c]
Tango Habana: folds 
Telum2: folds 
félix2011 has timed out
félix2011: folds 
félix2011 is sitting out
PexZz: folds 
félix2011 has returned
yoj777464: calls 100
motoboy13sp: raises 500 to 600
I eat glass: folds 
Kevin12345Mc: folds 
yoj777464: calls 500
*** FLOP *** [3s 6h 2s]
yoj777464: checks 
motoboy13sp: bets 630
yoj777464: calls 630
*** TURN *** [3s 6h 2s] [4d]
yoj777464: checks 
motoboy13sp: bets 3811 and is all-in
yoj777464: calls 2823 and is all-in
Uncalled bet (988) returned to motoboy13sp
*** RIVER *** [3s 6h 2s 4d] [Ac]
*** SHOW DOWN ***
yoj777464: shows [9s 5s] (a straight, Deuce to Six)
motoboy13sp: shows [As Kh] (a pair of Aces)
yoj777464 collected 8376 from pot
*** SUMMARY ***
Total pot 8376 | Rake 0 
Board [3s 6h 2s 4d Ac]
Seat 1: Tango Habana folded before Flop (didn't bet)
Seat 2: Telum2 folded before Flop (didn't bet)
Seat 3: félix2011 folded before Flop (didn't bet)
Seat 4: PexZz folded before Flop (didn't bet)
Seat 5: yoj777464 showed [9s 5s] and won (8376) with a straight, Deuce to Six
Seat 6: motoboy13sp (button) showed [As Kh] and lost with a pair of Aces
Seat 7: I eat glass (small blind) folded before Flop
Seat 8: Kevin12345Mc (big blind) folded before Flop



PokerStars Hand #254985917772: Tournament #3860676529, $0.46+$1.50+$0.24 USD Hold'em No Limit - Level VI (50/100) - 2025/02/22 15:23:49 WET [2025/02/22 10:23:49 ET]
Table '3860676529 25' 8-max Seat #7 is the button
Seat 1: Tango Habana (2535 in chips, $1.50 bounty) 
Seat 2: Telum2 (10255 in chips, $1.50 bounty) 
Seat 3: félix2011 (9308 in chips, $1.50 bounty) 
Seat 4: PexZz (4360 in chips, $1.50 bounty) 
Seat 5: yoj777464 (8376 in chips, $2.25 bounty) 
Seat 6: motoboy13sp (988 in chips, $1.50 bounty) 
Seat 7: I eat glass (2821 in chips, $2.25 bounty) 
Seat 8: Kevin12345Mc (18628 in chips, $2.25 bounty) 
Tango Habana: posts the ante 15
Telum2: posts the ante 15
félix2011: posts the ante 15
PexZz: posts the ante 15
yoj777464: posts the ante 15
motoboy13sp: posts the ante 15
I eat glass: posts the ante 15
Kevin12345Mc: posts the ante 15
Kevin12345Mc: posts small blind 50
Tango Habana: posts big blind 100
*** HOLE CARDS ***
Dealt to Kevin12345Mc [Td 7h]
Telum2: folds 
félix2011: folds 
PexZz: raises 100 to 200
yoj777464: folds 
motoboy13sp: raises 773 to 973 and is all-in
I eat glass: folds 
Kevin12345Mc: folds 
Tango Habana: folds 
PexZz: calls 773
*** FLOP *** [8d 5s Jc]
*** TURN *** [8d 5s Jc] [2d]
*** RIVER *** [8d 5s Jc 2d] [Jd]
*** SHOW DOWN ***
PexZz: shows [As 4s] (a pair of Jacks)
motoboy13sp: shows [Js Ks] (three of a kind, Jacks)
motoboy13sp collected 2216 from pot
*** SUMMARY ***
Total pot 2216 | Rake 0 
Board [8d 5s Jc 2d Jd]
Seat 1: Tango Habana (big blind) folded before Flop
Seat 2: Telum2 folded before Flop (didn't bet)
Seat 3: félix2011 folded before Flop (didn't bet)
Seat 4: PexZz showed [As 4s] and lost with a pair of Jacks
Seat 5: yoj777464 folded before Flop (didn't bet)
Seat 6: motoboy13sp showed [Js Ks] and won (2216) with three of a kind, Jacks
Seat 7: I eat glass (button) folded before Flop (didn't bet)
Seat 8: Kevin12345Mc (small blind) folded before Flop



PokerStars Hand #254985928905: Tournament #3860676529, $0.46+$1.50+$0.24 USD Hold'em No Limit - Level VI (50/100) - 2025/02/22 15:24:42 WET [2025/02/22 10:24:42 ET]
Table '3860676529 25' 8-max Seat #8 is the button
Seat 1: Tango Habana (2420 in chips, $1.50 bounty) 
Seat 2: Telum2 (10240 in chips, $1.50 bounty) 
Seat 3: félix2011 (9293 in chips, $1.50 bounty) 
Seat 4: PexZz (3372 in chips, $1.50 bounty) 
Seat 5: yoj777464 (8361 in chips, $2.25 bounty) 
Seat 6: motoboy13sp (2216 in chips, $1.50 bounty) 
Seat 7: I eat glass (2806 in chips, $2.25 bounty) 
Seat 8: Kevin12345Mc (18563 in chips, $2.25 bounty) 
Tango Habana: posts the ante 15
Telum2: posts the ante 15
félix2011: posts the ante 15
PexZz: posts the ante 15
yoj777464: posts the ante 15
motoboy13sp: posts the ante 15
I eat glass: posts the ante 15
Kevin12345Mc: posts the ante 15
Tango Habana: posts small blind 50
Telum2: posts big blind 100
*** HOLE CARDS ***
Dealt to Kevin12345Mc [Js 3c]
félix2011 has timed out
félix2011: folds 
félix2011 is sitting out
PexZz: folds 
yoj777464: folds 
motoboy13sp: folds 
I eat glass: raises 200 to 300
Kevin12345Mc: folds 
Tango Habana: folds 
félix2011 has returned
félix2011 is disconnected 
Telum2: folds 
Uncalled bet (200) returned to I eat glass
I eat glass collected 370 from pot
*** SUMMARY ***
Total pot 370 | Rake 0 
Seat 1: Tango Habana (small blind) folded before Flop
Seat 2: Telum2 (big blind) folded before Flop
Seat 3: félix2011 folded before Flop (didn't bet)
Seat 4: PexZz folded before Flop (didn't bet)
Seat 5: yoj777464 folded before Flop (didn't bet)
Seat 6: motoboy13sp folded before Flop (didn't bet)
Seat 7: I eat glass collected (370)
Seat 8: Kevin12345Mc (button) folded before Flop (didn't bet)



PokerStars Hand #254985938054: Tournament #3860676529, $0.46+$1.50+$0.24 USD Hold'em No Limit - Level VI (50/100) - 2025/02/22 15:25:25 WET [2025/02/22 10:25:25 ET]
Table '3860676529 25' 8-max Seat #1 is the button
Seat 1: Tango Habana (2355 in chips, $1.50 bounty) 
Seat 2: Telum2 (10125 in chips, $1.50 bounty) 
Seat 3: félix2011 (9278 in chips, $1.50 bounty) 
Seat 4: PexZz (3357 in chips, $1.50 bounty) 
Seat 5: yoj777464 (8346 in chips, $2.25 bounty) 
Seat 6: motoboy13sp (2201 in chips, $1.50 bounty) 
Seat 7: I eat glass (3061 in chips, $2.25 bounty) 
Seat 8: Kevin12345Mc (18548 in chips, $2.25 bounty) 
Tango Habana: posts the ante 15
Telum2: posts the ante 15
félix2011: posts the ante 15
PexZz: posts the ante 15
yoj777464: posts the ante 15
motoboy13sp: posts the ante 15
I eat glass: posts the ante 15
Kevin12345Mc: posts the ante 15
Telum2: posts small blind 50
félix2011: posts big blind 100
*** HOLE CARDS ***
Dealt to Kevin12345Mc [9d 4h]
félix2011 is disconnected 
PexZz: folds 
yoj777464: raises 200 to 300
motoboy13sp: folds 
I eat glass: folds 
Kevin12345Mc: folds 
Tango Habana: raises 2040 to 2340 and is all-in
Telum2: folds 
félix2011: folds 
yoj777464: calls 2040
*** FLOP *** [9h 8h 6c]
*** TURN *** [9h 8h 6c] [2h]
*** RIVER *** [9h 8h 6c 2h] [2s]
*** SHOW DOWN ***
yoj777464: shows [Kc Qc] (a pair of Deuces)
Tango Habana: shows [As Kh] (a pair of Deuces - Ace kicker)
Tango Habana collected 4950 from pot
*** SUMMARY ***
Total pot 4950 | Rake 0 
Board [9h 8h 6c 2h 2s]
Seat 1: Tango Habana (button) showed [As Kh] and won (4950) with a pair of Deuces
Seat 2: Telum2 (small blind) folded before Flop
Seat 3: félix2011 (big blind) folded before Flop
Seat 4: PexZz folded before Flop (didn't bet)
Seat 5: yoj777464 showed [Kc Qc] and lost with a pair of Deuces
Seat 6: motoboy13sp folded before Flop (didn't bet)
Seat 7: I eat glass folded before Flop (didn't bet)
Seat 8: Kevin12345Mc folded before Flop (didn't bet)



PokerStars Hand #254985950102: Tournament #3860676529, $0.46+$1.50+$0.24 USD Hold'em No Limit - Level VII (60/120) - 2025/02/22 15:26:21 WET [2025/02/22 10:26:21 ET]
Table '3860676529 25' 8-max Seat #2 is the button
Seat 1: Tango Habana (4950 in chips, $1.50 bounty) 
Seat 2: Telum2 (10060 in chips, $1.50 bounty) 
Seat 3: félix2011 (9163 in chips, $1.50 bounty) 
Seat 4: PexZz (3342 in chips, $1.50 bounty) 
Seat 5: yoj777464 (5991 in chips, $2.25 bounty) 
Seat 6: motoboy13sp (2186 in chips, $1.50 bounty) 
Seat 7: I eat glass (3046 in chips, $2.25 bounty) 
Seat 8: Kevin12345Mc (18533 in chips, $2.25 bounty) 
Tango Habana: posts the ante 18
Telum2: posts the ante 18
félix2011: posts the ante 18
PexZz: posts the ante 18
yoj777464: posts the ante 18
motoboy13sp: posts the ante 18
I eat glass: posts the ante 18
Kevin12345Mc: posts the ante 18
félix2011: posts small blind 60
PexZz: posts big blind 120
*** HOLE CARDS ***
Dealt to Kevin12345Mc [7c Jd]
félix2011 is disconnected 
yoj777464: folds 
motoboy13sp: folds 
I eat glass: folds 
Kevin12345Mc: folds 
Tango Habana: folds 
félix2011 is disconnected 
Telum2: raises 120 to 240
félix2011: raises 720 to 960
PexZz: folds 
Telum2: calls 720
*** FLOP *** [2s 3c 8d]
félix2011: bets 721
Telum2: folds 
Uncalled bet (721) returned to félix2011
félix2011 collected 2184 from pot
félix2011: doesn't show hand 
*** SUMMARY ***
Total pot 2184 | Rake 0 
Board [2s 3c 8d]
Seat 1: Tango Habana folded before Flop (didn't bet)
Seat 2: Telum2 (button) folded on the Flop
Seat 3: félix2011 (small blind) collected (2184)
Seat 4: PexZz (big blind) folded before Flop
Seat 5: yoj777464 folded before Flop (didn't bet)
Seat 6: motoboy13sp folded before Flop (didn't bet)
Seat 7: I eat glass folded before Flop (didn't bet)
Seat 8: Kevin12345Mc folded before Flop (didn't bet)



PokerStars Hand #254985964373: Tournament #3860676529, $0.46+$1.50+$0.24 USD Hold'em No Limit - Level VII (60/120) - 2025/02/22 15:27:28 WET [2025/02/22 10:27:28 ET]
Table '3860676529 25' 8-max Seat #3 is the button
Seat 1: Tango Habana (4932 in chips, $1.50 bounty) 
Seat 2: Telum2 (9082 in chips, $1.50 bounty) 
Seat 3: félix2011 (10369 in chips, $1.50 bounty) 
Seat 4: PexZz (3204 in chips, $1.50 bounty) 
Seat 5: yoj777464 (5973 in chips, $2.25 bounty) 
Seat 6: motoboy13sp (2168 in chips, $1.50 bounty) 
Seat 7: I eat glass (3028 in chips, $2.25 bounty) 
Seat 8: Kevin12345Mc (18515 in chips, $2.25 bounty) 
Tango Habana: posts the ante 18
Telum2: posts the ante 18
félix2011: posts the ante 18
PexZz: posts the ante 18
yoj777464: posts the ante 18
motoboy13sp: posts the ante 18
I eat glass: posts the ante 18
Kevin12345Mc: posts the ante 18
PexZz: posts small blind 60
yoj777464: posts big blind 120
*** HOLE CARDS ***
Dealt to Kevin12345Mc [Qd Qs]
motoboy13sp: folds 
I eat glass: folds 
Kevin12345Mc: raises 156 to 276
Tango Habana: folds 
Telum2: folds 
félix2011: folds 
PexZz: folds 
yoj777464: raises 5679 to 5955 and is all-in
Kevin12345Mc: calls 5679
*** FLOP *** [8h 9s 9d]
*** TURN *** [8h 9s 9d] [Ac]
*** RIVER *** [8h 9s 9d Ac] [Ah]
*** SHOW DOWN ***
yoj777464: shows [Jh Js] (two pair, Aces and Jacks)
Kevin12345Mc: shows [Qd Qs] (two pair, Aces and Queens)
Kevin12345Mc collected 12114 from pot
Kevin12345Mc wins $1.13 for eliminating yoj777464 and their own bounty increases by $1.12 to $3.37
yoj777464 finished the tournament
*** SUMMARY ***
Total pot 12114 | Rake 0 
Board [8h 9s 9d Ac Ah]
Seat 1: Tango Habana folded before Flop (didn't bet)
Seat 2: Telum2 folded before Flop (didn't bet)
Seat 3: félix2011 (button) folded before Flop (didn't bet)
Seat 4: PexZz (small blind) folded before Flop
Seat 5: yoj777464 (big blind) showed [Jh Js] and lost with two pair, Aces and Jacks
Seat 6: motoboy13sp folded before Flop (didn't bet)
Seat 7: I eat glass folded before Flop (didn't bet)
Seat 8: Kevin12345Mc showed [Qd Qs] and won (12114) with two pair, Aces and Queens



PokerStars Hand #254985975507: Tournament #3860676529, $0.46+$1.50+$0.24 USD Hold'em No Limit - Level VII (60/120) - 2025/02/22 15:28:20 WET [2025/02/22 10:28:20 ET]
Table '3860676529 25' 8-max Seat #4 is the button
Seat 1: Tango Habana (4914 in chips, $1.50 bounty) 
Seat 2: Telum2 (9064 in chips, $1.50 bounty) 
Seat 3: félix2011 (10351 in chips, $1.50 bounty) 
Seat 4: PexZz (3126 in chips, $1.50 bounty) 
Seat 6: motoboy13sp (2150 in chips, $1.50 bounty) 
Seat 7: I eat glass (3010 in chips, $2.25 bounty) 
Seat 8: Kevin12345Mc (24656 in chips, $3.37 bounty) 
Tango Habana: posts the ante 18
Telum2: posts the ante 18
félix2011: posts the ante 18
PexZz: posts the ante 18
motoboy13sp: posts the ante 18
I eat glass: posts the ante 18
Kevin12345Mc: posts the ante 18
motoboy13sp: posts small blind 60
I eat glass: posts big blind 120
*** HOLE CARDS ***
Dealt to Kevin12345Mc [4h 2d]
Hill9595 is disconnected 
Kevin12345Mc: folds 
Tango Habana: folds 
Telum2: folds 
félix2011: folds 
PexZz: raises 120 to 240
motoboy13sp: folds 
I eat glass: raises 2752 to 2992 and is all-in
PexZz: calls 2752
*** FLOP *** [2s Js Tc]
*** TURN *** [2s Js Tc] [5d]
*** RIVER *** [2s Js Tc 5d] [Jc]
*** SHOW DOWN ***
I eat glass: shows [Qh Ah] (a pair of Jacks)
PexZz: shows [Ac 5c] (two pair, Jacks and Fives)
PexZz collected 6170 from pot
PexZz wins $1.13 for eliminating I eat glass and their own bounty increases by $1.12 to $2.62
I eat glass finished the tournament
*** SUMMARY ***
Total pot 6170 | Rake 0 
Board [2s Js Tc 5d Jc]
Seat 1: Tango Habana folded before Flop (didn't bet)
Seat 2: Telum2 folded before Flop (didn't bet)
Seat 3: félix2011 folded before Flop (didn't bet)
Seat 4: PexZz (button) showed [Ac 5c] and won (6170) with two pair, Jacks and Fives
Seat 6: motoboy13sp (small blind) folded before Flop
Seat 7: I eat glass (big blind) showed [Qh Ah] and lost with a pair of Jacks
Seat 8: Kevin12345Mc folded before Flop (didn't bet)



PokerStars Hand #254985986108: Tournament #3860676529, $0.46+$1.50+$0.24 USD Hold'em No Limit - Level VII (60/120) - 2025/02/22 15:29:09 WET [2025/02/22 10:29:09 ET]
Table '3860676529 25' 8-max Seat #6 is the button
Seat 1: Tango Habana (4896 in chips, $1.50 bounty) 
Seat 2: Telum2 (9046 in chips, $1.50 bounty) 
Seat 3: félix2011 (10333 in chips, $1.50 bounty) 
Seat 4: PexZz (6286 in chips, $2.62 bounty) 
Seat 5: Hill9595 (5000 in chips, $1.50 bounty) 
Seat 6: motoboy13sp (2072 in chips, $1.50 bounty) 
Seat 8: Kevin12345Mc (24638 in chips, $3.37 bounty) 
Tango Habana: posts the ante 18
Telum2: posts the ante 18
félix2011: posts the ante 18
PexZz: posts the ante 18
Hill9595: posts the ante 18
motoboy13sp: posts the ante 18
Kevin12345Mc: posts the ante 18
Kevin12345Mc: posts small blind 60
Tango Habana: posts big blind 120
*** HOLE CARDS ***
Dealt to Kevin12345Mc [9s As]
Telum2: folds 
félix2011: folds 
PexZz: folds 
Hill9595: raises 156 to 276
motoboy13sp: folds 
Kevin12345Mc: calls 216
Tango Habana: folds 
*** FLOP *** [9c 2d 4d]
Kevin12345Mc: checks 
Hill9595: bets 263
Kevin12345Mc: raises 557 to 820
Hill9595: folds 
Uncalled bet (557) returned to Kevin12345Mc
Kevin12345Mc collected 1324 from pot
Kevin12345Mc: doesn't show hand 
*** SUMMARY ***
Total pot 1324 | Rake 0 
Board [9c 2d 4d]
Seat 1: Tango Habana (big blind) folded before Flop
Seat 2: Telum2 folded before Flop (didn't bet)
Seat 3: félix2011 folded before Flop (didn't bet)
Seat 4: PexZz folded before Flop (didn't bet)
Seat 5: Hill9595 folded on the Flop
Seat 6: motoboy13sp (button) folded before Flop (didn't bet)
Seat 8: Kevin12345Mc (small blind) collected (1324)



PokerStars Hand #254986001216: Tournament #3860676529, $0.46+$1.50+$0.24 USD Hold'em No Limit - Level VII (60/120) - 2025/02/22 15:30:19 WET [2025/02/22 10:30:19 ET]
Table '3860676529 25' 8-max Seat #8 is the button
Seat 1: Tango Habana (4758 in chips, $1.50 bounty) 
Seat 3: félix2011 (10315 in chips, $1.50 bounty) 
Seat 4: PexZz (6268 in chips, $2.62 bounty) 
Seat 5: Hill9595 (4443 in chips, $1.50 bounty) 
Seat 6: motoboy13sp (2054 in chips, $1.50 bounty) 
Seat 7: magnum8340 (5000 in chips, $1.50 bounty) 
Seat 8: Kevin12345Mc (25405 in chips, $3.37 bounty) 
Tango Habana: posts the ante 18
félix2011: posts the ante 18
PexZz: posts the ante 18
Hill9595: posts the ante 18
motoboy13sp: posts the ante 18
magnum8340: posts the ante 18
Kevin12345Mc: posts the ante 18
Tango Habana: posts small blind 60
félix2011: posts big blind 120
*** HOLE CARDS ***
Dealt to Kevin12345Mc [8d 6s]
jokes88 is disconnected 
PexZz: folds 
Hill9595: folds 
motoboy13sp: folds 
magnum8340: folds 
Kevin12345Mc: folds 
Tango Habana: folds 
Uncalled bet (60) returned to félix2011
félix2011 collected 246 from pot
félix2011: doesn't show hand 
*** SUMMARY ***
Total pot 246 | Rake 0 
Seat 1: Tango Habana (small blind) folded before Flop
Seat 3: félix2011 (big blind) collected (246)
Seat 4: PexZz folded before Flop (didn't bet)
Seat 5: Hill9595 folded before Flop (didn't bet)
Seat 6: motoboy13sp folded before Flop (didn't bet)
Seat 7: magnum8340 folded before Flop (didn't bet)
Seat 8: Kevin12345Mc (button) folded before Flop (didn't bet)



PokerStars Hand #254986006485: Tournament #3860676529, $0.46+$1.50+$0.24 USD Hold'em No Limit - Level VII (60/120) - 2025/02/22 15:30:43 WET [2025/02/22 10:30:43 ET]
Table '3860676529 25' 8-max Seat #1 is the button
Seat 1: Tango Habana (4680 in chips, $1.50 bounty) 
Seat 2: jokes88 (5000 in chips) out of hand (moved from another table into small blind)
Seat 3: félix2011 (10483 in chips, $1.50 bounty) 
Seat 4: PexZz (6250 in chips, $2.62 bounty) 
Seat 5: Hill9595 (4425 in chips, $1.50 bounty) 
Seat 6: motoboy13sp (2036 in chips, $1.50 bounty) 
Seat 7: magnum8340 (4982 in chips, $1.50 bounty) 
Seat 8: Kevin12345Mc (25387 in chips, $3.37 bounty) 
jokes88 will be allowed to play after the button
Tango Habana: posts the ante 18
félix2011: posts the ante 18
PexZz: posts the ante 18
Hill9595: posts the ante 18
motoboy13sp: posts the ante 18
magnum8340: posts the ante 18
Kevin12345Mc: posts the ante 18
félix2011: posts small blind 60
PexZz: posts big blind 120
*** HOLE CARDS ***
Dealt to Kevin12345Mc [Ac Qs]
Hill9595: folds 
motoboy13sp: folds 
magnum8340: folds 
Kevin12345Mc: raises 156 to 276
Tango Habana: raises 515 to 791
félix2011: folds 
PexZz: folds 
Kevin12345Mc: raises 24578 to 25369 and is all-in
Tango Habana: calls 3871 and is all-in
Uncalled bet (20707) returned to Kevin12345Mc
*** FLOP *** [7d 4d 6s]
*** TURN *** [7d 4d 6s] [Ad]
*** RIVER *** [7d 4d 6s Ad] [Th]
*** SHOW DOWN ***
Kevin12345Mc: shows [Ac Qs] (a pair of Aces)
Tango Habana: shows [Kh As] (a pair of Aces - King kicker)
Tango Habana collected 9630 from pot
*** SUMMARY ***
Total pot 9630 | Rake 0 
Board [7d 4d 6s Ad Th]
Seat 1: Tango Habana (button) showed [Kh As] and won (9630) with a pair of Aces
Seat 3: félix2011 (small blind) folded before Flop
Seat 4: PexZz (big blind) folded before Flop
Seat 5: Hill9595 folded before Flop (didn't bet)
Seat 6: motoboy13sp folded before Flop (didn't bet)
Seat 7: magnum8340 folded before Flop (didn't bet)
Seat 8: Kevin12345Mc showed [Ac Qs] and lost with a pair of Aces



PokerStars Hand #254986021236: Tournament #3860676529, $0.46+$1.50+$0.24 USD Hold'em No Limit - Level VII (60/120) - 2025/02/22 15:31:50 WET [2025/02/22 10:31:50 ET]
Table '3860676529 25' 8-max Seat #3 is the button
Seat 1: Tango Habana (9630 in chips, $1.50 bounty) 
Seat 2: jokes88 (5000 in chips, $1.50 bounty) 
Seat 3: félix2011 (10405 in chips, $1.50 bounty) 
Seat 4: PexZz (6112 in chips, $2.62 bounty) 
Seat 5: Hill9595 (4407 in chips, $1.50 bounty) 
Seat 6: motoboy13sp (2018 in chips, $1.50 bounty) 
Seat 7: magnum8340 (4964 in chips, $1.50 bounty) 
Seat 8: Kevin12345Mc (20707 in chips, $3.37 bounty) 
Tango Habana: posts the ante 18
jokes88: posts the ante 18
félix2011: posts the ante 18
PexZz: posts the ante 18
Hill9595: posts the ante 18
motoboy13sp: posts the ante 18
magnum8340: posts the ante 18
Kevin12345Mc: posts the ante 18
PexZz: posts small blind 60
Hill9595: posts big blind 120
*** HOLE CARDS ***
Dealt to Kevin12345Mc [2d Ah]
motoboy13sp: folds 
magnum8340: raises 165 to 285
Kevin12345Mc: folds 
Tango Habana: raises 536 to 821
jokes88: folds 
félix2011: folds 
PexZz: folds 
Hill9595: folds 
magnum8340: raises 4125 to 4946 and is all-in
Tango Habana: calls 4125
*** FLOP *** [Jc 9h 6h]
*** TURN *** [Jc 9h 6h] [3h]
*** RIVER *** [Jc 9h 6h 3h] [8h]
*** SHOW DOWN ***
magnum8340: shows [Qs As] (high card Ace)
Tango Habana: shows [Js Jh] (a flush, Jack high)
Tango Habana collected 10216 from pot
Tango Habana wins $0.75 for eliminating magnum8340 and their own bounty increases by $0.75 to $2.25
magnum8340 finished the tournament
*** SUMMARY ***
Total pot 10216 | Rake 0 
Board [Jc 9h 6h 3h 8h]
Seat 1: Tango Habana showed [Js Jh] and won (10216) with a flush, Jack high
Seat 2: jokes88 folded before Flop (didn't bet)
Seat 3: félix2011 (button) folded before Flop (didn't bet)
Seat 4: PexZz (small blind) folded before Flop
Seat 5: Hill9595 (big blind) folded before Flop
Seat 6: motoboy13sp folded before Flop (didn't bet)
Seat 7: magnum8340 showed [Qs As] and lost with high card Ace
Seat 8: Kevin12345Mc folded before Flop (didn't bet)



PokerStars Hand #254986033817: Tournament #3860676529, $0.46+$1.50+$0.24 USD Hold'em No Limit - Level VII (60/120) - 2025/02/22 15:32:47 WET [2025/02/22 10:32:47 ET]
Table '3860676529 25' 8-max Seat #4 is the button
Seat 1: Tango Habana (14882 in chips, $2.25 bounty) 
Seat 2: jokes88 (4982 in chips, $1.50 bounty) 
Seat 3: félix2011 (10387 in chips, $1.50 bounty) 
Seat 4: PexZz (6034 in chips, $2.62 bounty) 
Seat 5: Hill9595 (4269 in chips, $1.50 bounty) 
Seat 6: motoboy13sp (2000 in chips, $1.50 bounty) 
Seat 8: Kevin12345Mc (20689 in chips, $3.37 bounty) 
Tango Habana: posts the ante 18
jokes88: posts the ante 18
félix2011: posts the ante 18
PexZz: posts the ante 18
Hill9595: posts the ante 18
motoboy13sp: posts the ante 18
Kevin12345Mc: posts the ante 18
Hill9595: posts small blind 60
motoboy13sp: posts big blind 120
*** HOLE CARDS ***
Dealt to Kevin12345Mc [2s 7c]
Kevin12345Mc: folds 
Tango Habana: folds 
jokes88: folds 
félix2011: raises 132 to 252
PexZz: folds 
Hill9595: calls 192
Raonics3 is disconnected 
motoboy13sp: raises 1730 to 1982 and is all-in
félix2011: calls 1730
Hill9595: folds 
*** FLOP *** [4c 9c 8d]
*** TURN *** [4c 9c 8d] [Kh]
*** RIVER *** [4c 9c 8d Kh] [Qd]
*** SHOW DOWN ***
motoboy13sp: shows [Qs Qc] (three of a kind, Queens)
félix2011: shows [3d Ad] (high card Ace)
motoboy13sp collected 4342 from pot
*** SUMMARY ***
Total pot 4342 | Rake 0 
Board [4c 9c 8d Kh Qd]
Seat 1: Tango Habana folded before Flop (didn't bet)
Seat 2: jokes88 folded before Flop (didn't bet)
Seat 3: félix2011 showed [3d Ad] and lost with high card Ace
Seat 4: PexZz (button) folded before Flop (didn't bet)
Seat 5: Hill9595 (small blind) folded before Flop
Seat 6: motoboy13sp (big blind) showed [Qs Qc] and won (4342) with three of a kind, Queens
Seat 8: Kevin12345Mc folded before Flop (didn't bet)



PokerStars Hand #254986045185: Tournament #3860676529, $0.46+$1.50+$0.24 USD Hold'em No Limit - Level VII (60/120) - 2025/02/22 15:33:39 WET [2025/02/22 10:33:39 ET]
Table '3860676529 25' 8-max Seat #5 is the button
Seat 1: Tango Habana (14864 in chips, $2.25 bounty) 
Seat 2: jokes88 (4964 in chips, $1.50 bounty) 
Seat 3: félix2011 (8387 in chips, $1.50 bounty) 
Seat 4: PexZz (6016 in chips, $2.62 bounty) 
Seat 5: Hill9595 (3999 in chips, $1.50 bounty) 
Seat 6: motoboy13sp (4342 in chips, $1.50 bounty) 
Seat 7: Raonics3 (5000 in chips, $1.50 bounty) 
Seat 8: Kevin12345Mc (20671 in chips, $3.37 bounty) 
Tango Habana: posts the ante 18
jokes88: posts the ante 18
félix2011: posts the ante 18
PexZz: posts the ante 18
Hill9595: posts the ante 18
motoboy13sp: posts the ante 18
Raonics3: posts the ante 18
Kevin12345Mc: posts the ante 18
motoboy13sp: posts small blind 60
Raonics3: posts big blind 120
*** HOLE CARDS ***
Dealt to Kevin12345Mc [3h Qs]
Kevin12345Mc: folds 
Tango Habana: folds 
jokes88: folds 
félix2011: raises 132 to 252
PexZz: folds 
Hill9595: folds 
motoboy13sp: folds 
Raonics3: folds 
Uncalled bet (132) returned to félix2011
félix2011 collected 444 from pot
félix2011: doesn't show hand 
*** SUMMARY ***
Total pot 444 | Rake 0 
Seat 1: Tango Habana folded before Flop (didn't bet)
Seat 2: jokes88 folded before Flop (didn't bet)
Seat 3: félix2011 collected (444)
Seat 4: PexZz folded before Flop (didn't bet)
Seat 5: Hill9595 (button) folded before Flop (didn't bet)
Seat 6: motoboy13sp (small blind) folded before Flop
Seat 7: Raonics3 (big blind) folded before Flop
Seat 8: Kevin12345Mc folded before Flop (didn't bet)



PokerStars Hand #254986052137: Tournament #3860676529, $0.46+$1.50+$0.24 USD Hold'em No Limit - Level VIII (70/140) - 2025/02/22 15:34:10 WET [2025/02/22 10:34:10 ET]
Table '3860676529 25' 8-max Seat #6 is the button
Seat 1: Tango Habana (14846 in chips, $2.25 bounty) 
Seat 2: jokes88 (4946 in chips, $1.50 bounty) 
Seat 3: félix2011 (8693 in chips, $1.50 bounty) 
Seat 4: PexZz (5998 in chips, $2.62 bounty) 
Seat 5: Hill9595 (3981 in chips, $1.50 bounty) 
Seat 6: motoboy13sp (4264 in chips, $1.50 bounty) 
Seat 7: Raonics3 (4862 in chips, $1.50 bounty) 
Seat 8: Kevin12345Mc (20653 in chips, $3.37 bounty) 
Tango Habana: posts the ante 21
jokes88: posts the ante 21
félix2011: posts the ante 21
PexZz: posts the ante 21
Hill9595: posts the ante 21
motoboy13sp: posts the ante 21
Raonics3: posts the ante 21
Kevin12345Mc: posts the ante 21
Raonics3: posts small blind 70
Kevin12345Mc: posts big blind 140
*** HOLE CARDS ***
Dealt to Kevin12345Mc [Qs 9s]
Tango Habana: folds 
jokes88: folds 
félix2011: folds 
PexZz: folds 
Hill9595: folds 
motoboy13sp: folds 
Raonics3: folds 
Uncalled bet (70) returned to Kevin12345Mc
Kevin12345Mc collected 308 from pot
Kevin12345Mc: doesn't show hand 
*** SUMMARY ***
Total pot 308 | Rake 0 
Seat 1: Tango Habana folded before Flop (didn't bet)
Seat 2: jokes88 folded before Flop (didn't bet)
Seat 3: félix2011 folded before Flop (didn't bet)
Seat 4: PexZz folded before Flop (didn't bet)
Seat 5: Hill9595 folded before Flop (didn't bet)
Seat 6: motoboy13sp (button) folded before Flop (didn't bet)
Seat 7: Raonics3 (small blind) folded before Flop
Seat 8: Kevin12345Mc (big blind) collected (308)



PokerStars Hand #254986055184: Tournament #3860676529, $0.46+$1.50+$0.24 USD Hold'em No Limit - Level VIII (70/140) - 2025/02/22 15:34:24 WET [2025/02/22 10:34:24 ET]
Table '3860676529 25' 8-max Seat #7 is the button
Seat 1: Tango Habana (14825 in chips, $2.25 bounty) 
Seat 2: jokes88 (4925 in chips, $1.50 bounty) 
Seat 3: félix2011 (8672 in chips, $1.50 bounty) 
Seat 4: PexZz (5977 in chips, $2.62 bounty) 
Seat 5: Hill9595 (3960 in chips, $1.50 bounty) 
Seat 6: motoboy13sp (4243 in chips, $1.50 bounty) 
Seat 7: Raonics3 (4771 in chips, $1.50 bounty) 
Seat 8: Kevin12345Mc (20870 in chips, $3.37 bounty) 
Tango Habana: posts the ante 21
jokes88: posts the ante 21
félix2011: posts the ante 21
PexZz: posts the ante 21
Hill9595: posts the ante 21
motoboy13sp: posts the ante 21
Raonics3: posts the ante 21
Kevin12345Mc: posts the ante 21
Kevin12345Mc: posts small blind 70
Tango Habana: posts big blind 140
*** HOLE CARDS ***
Dealt to Kevin12345Mc [2h Jh]
jokes88: folds 
félix2011: folds 
PexZz: folds 
Hill9595: folds 
motoboy13sp: raises 140 to 280
Raonics3: folds 
Kevin12345Mc: folds 
Tango Habana: folds 
Uncalled bet (140) returned to motoboy13sp
motoboy13sp collected 518 from pot
motoboy13sp: doesn't show hand 
*** SUMMARY ***
Total pot 518 | Rake 0 
Seat 1: Tango Habana (big blind) folded before Flop
Seat 2: jokes88 folded before Flop (didn't bet)
Seat 3: félix2011 folded before Flop (didn't bet)
Seat 4: PexZz folded before Flop (didn't bet)
Seat 5: Hill9595 folded before Flop (didn't bet)
Seat 6: motoboy13sp collected (518)
Seat 7: Raonics3 (button) folded before Flop (didn't bet)
Seat 8: Kevin12345Mc (small blind) folded before Flop



PokerStars Hand #254986060751: Tournament #3860676529, $0.46+$1.50+$0.24 USD Hold'em No Limit - Level VIII (70/140) - 2025/02/22 15:34:49 WET [2025/02/22 10:34:49 ET]
Table '3860676529 25' 8-max Seat #8 is the button
Seat 1: Tango Habana (14664 in chips, $2.25 bounty) 
Seat 2: jokes88 (4904 in chips, $1.50 bounty) 
Seat 3: félix2011 (8651 in chips, $1.50 bounty) 
Seat 4: PexZz (5956 in chips, $2.62 bounty) 
Seat 5: Hill9595 (3939 in chips, $1.50 bounty) 
Seat 6: motoboy13sp (4600 in chips, $1.50 bounty) 
Seat 7: Raonics3 (4750 in chips, $1.50 bounty) 
Seat 8: Kevin12345Mc (20779 in chips, $3.37 bounty) 
Tango Habana: posts the ante 21
jokes88: posts the ante 21
félix2011: posts the ante 21
PexZz: posts the ante 21
Hill9595: posts the ante 21
motoboy13sp: posts the ante 21
Raonics3: posts the ante 21
Kevin12345Mc: posts the ante 21
Tango Habana: posts small blind 70
jokes88: posts big blind 140
*** HOLE CARDS ***
Dealt to Kevin12345Mc [3h 5d]
félix2011: folds 
PexZz: folds 
Hill9595: folds 
motoboy13sp: folds 
Raonics3: folds 
Kevin12345Mc: folds 
Tango Habana: folds 
Uncalled bet (70) returned to jokes88
jokes88 collected 308 from pot
jokes88: doesn't show hand 
*** SUMMARY ***
Total pot 308 | Rake 0 
Seat 1: Tango Habana (small blind) folded before Flop
Seat 2: jokes88 (big blind) collected (308)
Seat 3: félix2011 folded before Flop (didn't bet)
Seat 4: PexZz folded before Flop (didn't bet)
Seat 5: Hill9595 folded before Flop (didn't bet)
Seat 6: motoboy13sp folded before Flop (didn't bet)
Seat 7: Raonics3 folded before Flop (didn't bet)
Seat 8: Kevin12345Mc (button) folded before Flop (didn't bet)



PokerStars Hand #254986065546: Tournament #3860676529, $0.46+$1.50+$0.24 USD Hold'em No Limit - Level VIII (70/140) - 2025/02/22 15:35:11 WET [2025/02/22 10:35:11 ET]
Table '3860676529 25' 8-max Seat #1 is the button
Seat 1: Tango Habana (14573 in chips, $2.25 bounty) 
Seat 2: jokes88 (5121 in chips, $1.50 bounty) 
Seat 3: félix2011 (8630 in chips, $1.50 bounty) 
Seat 4: PexZz (5935 in chips, $2.62 bounty) 
Seat 5: Hill9595 (3918 in chips, $1.50 bounty) 
Seat 6: motoboy13sp (4579 in chips, $1.50 bounty) 
Seat 7: Raonics3 (4729 in chips, $1.50 bounty) 
Seat 8: Kevin12345Mc (20758 in chips, $3.37 bounty) 
Tango Habana: posts the ante 21
jokes88: posts the ante 21
félix2011: posts the ante 21
PexZz: posts the ante 21
Hill9595: posts the ante 21
motoboy13sp: posts the ante 21
Raonics3: posts the ante 21
Kevin12345Mc: posts the ante 21
jokes88: posts small blind 70
félix2011: posts big blind 140
*** HOLE CARDS ***
Dealt to Kevin12345Mc [7d 2h]
PexZz: folds 
Hill9595: folds 
motoboy13sp: folds 
Raonics3: folds 
Kevin12345Mc: folds 
Tango Habana: folds 
jokes88: raises 140 to 280
félix2011: calls 140
*** FLOP *** [Js 5s 3d]
jokes88: bets 420
félix2011: folds 
Uncalled bet (420) returned to jokes88
jokes88 collected 728 from pot
jokes88: doesn't show hand 
*** SUMMARY ***
Total pot 728 | Rake 0 
Board [Js 5s 3d]
Seat 1: Tango Habana (button) folded before Flop (didn't bet)
Seat 2: jokes88 (small blind) collected (728)
Seat 3: félix2011 (big blind) folded on the Flop
Seat 4: PexZz folded before Flop (didn't bet)
Seat 5: Hill9595 folded before Flop (didn't bet)
Seat 6: motoboy13sp folded before Flop (didn't bet)
Seat 7: Raonics3 folded before Flop (didn't bet)
Seat 8: Kevin12345Mc folded before Flop (didn't bet)



PokerStars Hand #254986075450: Tournament #3860676529, $0.46+$1.50+$0.24 USD Hold'em No Limit - Level VIII (70/140) - 2025/02/22 15:35:55 WET [2025/02/22 10:35:55 ET]
Table '3860676529 25' 8-max Seat #2 is the button
Seat 1: Tango Habana (14552 in chips, $2.25 bounty) 
Seat 2: jokes88 (5548 in chips, $1.50 bounty) 
Seat 3: félix2011 (8329 in chips, $1.50 bounty) 
Seat 4: PexZz (5914 in chips, $2.62 bounty) 
Seat 5: Hill9595 (3897 in chips, $1.50 bounty) 
Seat 6: motoboy13sp (4558 in chips, $1.50 bounty) 
Seat 7: Raonics3 (4708 in chips, $1.50 bounty) 
Seat 8: Kevin12345Mc (20737 in chips, $3.37 bounty) 
Tango Habana: posts the ante 21
jokes88: posts the ante 21
félix2011: posts the ante 21
PexZz: posts the ante 21
Hill9595: posts the ante 21
motoboy13sp: posts the ante 21
Raonics3: posts the ante 21
Kevin12345Mc: posts the ante 21
félix2011: posts small blind 70
PexZz: posts big blind 140
*** HOLE CARDS ***
Dealt to Kevin12345Mc [7h 6d]
Hill9595: folds 
motoboy13sp: folds 
Raonics3: folds 
Kevin12345Mc: folds 
Tango Habana: folds 
jokes88: folds 
félix2011: raises 280 to 420
PexZz: folds 
Uncalled bet (280) returned to félix2011
félix2011 collected 448 from pot
félix2011: doesn't show hand 
*** SUMMARY ***
Total pot 448 | Rake 0 
Seat 1: Tango Habana folded before Flop (didn't bet)
Seat 2: jokes88 (button) folded before Flop (didn't bet)
Seat 3: félix2011 (small blind) collected (448)
Seat 4: PexZz (big blind) folded before Flop
Seat 5: Hill9595 folded before Flop (didn't bet)
Seat 6: motoboy13sp folded before Flop (didn't bet)
Seat 7: Raonics3 folded before Flop (didn't bet)
Seat 8: Kevin12345Mc folded before Flop (didn't bet)



PokerStars Hand #254986082431: Tournament #3860676529, $0.46+$1.50+$0.24 USD Hold'em No Limit - Level VIII (70/140) - 2025/02/22 15:36:28 WET [2025/02/22 10:36:28 ET]
Table '3860676529 25' 8-max Seat #3 is the button
Seat 1: Tango Habana (14531 in chips, $2.25 bounty) 
Seat 2: jokes88 (5527 in chips, $1.50 bounty) 
Seat 3: félix2011 (8616 in chips, $1.50 bounty) 
Seat 4: PexZz (5753 in chips, $2.62 bounty) 
Seat 5: Hill9595 (3876 in chips, $1.50 bounty) 
Seat 6: motoboy13sp (4537 in chips, $1.50 bounty) 
Seat 7: Raonics3 (4687 in chips, $1.50 bounty) 
Seat 8: Kevin12345Mc (20716 in chips, $3.37 bounty) 
Tango Habana: posts the ante 21
jokes88: posts the ante 21
félix2011: posts the ante 21
PexZz: posts the ante 21
Hill9595: posts the ante 21
motoboy13sp: posts the ante 21
Raonics3: posts the ante 21
Kevin12345Mc: posts the ante 21
PexZz: posts small blind 70
Hill9595: posts big blind 140
*** HOLE CARDS ***
Dealt to Kevin12345Mc [Kc 5h]
motoboy13sp: folds 
Raonics3: raises 182 to 322
Kevin12345Mc: folds 
Tango Habana: folds 
jokes88: folds 
félix2011: folds 
PexZz: folds 
Hill9595: folds 
Uncalled bet (182) returned to Raonics3
Raonics3 collected 518 from pot
Raonics3: doesn't show hand 
*** SUMMARY ***
Total pot 518 | Rake 0 
Seat 1: Tango Habana folded before Flop (didn't bet)
Seat 2: jokes88 folded before Flop (didn't bet)
Seat 3: félix2011 (button) folded before Flop (didn't bet)
Seat 4: PexZz (small blind) folded before Flop
Seat 5: Hill9595 (big blind) folded before Flop
Seat 6: motoboy13sp folded before Flop (didn't bet)
Seat 7: Raonics3 collected (518)
Seat 8: Kevin12345Mc folded before Flop (didn't bet)



PokerStars Hand #254986087652: Tournament #3860676529, $0.46+$1.50+$0.24 USD Hold'em No Limit - Level VIII (70/140) - 2025/02/22 15:36:51 WET [2025/02/22 10:36:51 ET]
Table '3860676529 25' 8-max Seat #4 is the button
Seat 1: Tango Habana (14510 in chips, $2.25 bounty) 
Seat 2: jokes88 (5506 in chips, $1.50 bounty) 
Seat 3: félix2011 (8595 in chips, $1.50 bounty) 
Seat 4: PexZz (5662 in chips, $2.62 bounty) 
Seat 5: Hill9595 (3715 in chips, $1.50 bounty) 
Seat 6: motoboy13sp (4516 in chips, $1.50 bounty) 
Seat 7: Raonics3 (5044 in chips, $1.50 bounty) 
Seat 8: Kevin12345Mc (20695 in chips, $3.37 bounty) 
Tango Habana: posts the ante 21
jokes88: posts the ante 21
félix2011: posts the ante 21
PexZz: posts the ante 21
Hill9595: posts the ante 21
motoboy13sp: posts the ante 21
Raonics3: posts the ante 21
Kevin12345Mc: posts the ante 21
Hill9595: posts small blind 70
motoboy13sp: posts big blind 140
*** HOLE CARDS ***
Dealt to Kevin12345Mc [7s 2c]
Raonics3: folds 
Kevin12345Mc: folds 
Tango Habana: folds 
jokes88: folds 
félix2011: raises 154 to 294
PexZz: folds 
Hill9595: folds 
motoboy13sp: calls 154
*** FLOP *** [2d 6s 5d]
motoboy13sp: checks 
félix2011: bets 413
motoboy13sp: folds 
Uncalled bet (413) returned to félix2011
félix2011 collected 826 from pot
félix2011: doesn't show hand 
*** SUMMARY ***
Total pot 826 | Rake 0 
Board [2d 6s 5d]
Seat 1: Tango Habana folded before Flop (didn't bet)
Seat 2: jokes88 folded before Flop (didn't bet)
Seat 3: félix2011 collected (826)
Seat 4: PexZz (button) folded before Flop (didn't bet)
Seat 5: Hill9595 (small blind) folded before Flop
Seat 6: motoboy13sp (big blind) folded on the Flop
Seat 7: Raonics3 folded before Flop (didn't bet)
Seat 8: Kevin12345Mc folded before Flop (didn't bet)



PokerStars Hand #254986096167: Tournament #3860676529, $0.46+$1.50+$0.24 USD Hold'em No Limit - Level VIII (70/140) - 2025/02/22 15:37:30 WET [2025/02/22 10:37:30 ET]
Table '3860676529 25' 8-max Seat #5 is the button
Seat 1: Tango Habana (14489 in chips, $2.25 bounty) 
Seat 2: jokes88 (5485 in chips, $1.50 bounty) 
Seat 3: félix2011 (9106 in chips, $1.50 bounty) 
Seat 4: PexZz (5641 in chips, $2.62 bounty) 
Seat 5: Hill9595 (3624 in chips, $1.50 bounty) 
Seat 6: motoboy13sp (4201 in chips, $1.50 bounty) 
Seat 7: Raonics3 (5023 in chips, $1.50 bounty) 
Seat 8: Kevin12345Mc (20674 in chips, $3.37 bounty) 
Tango Habana: posts the ante 21
jokes88: posts the ante 21
félix2011: posts the ante 21
PexZz: posts the ante 21
Hill9595: posts the ante 21
motoboy13sp: posts the ante 21
Raonics3: posts the ante 21
Kevin12345Mc: posts the ante 21
motoboy13sp: posts small blind 70
Raonics3: posts big blind 140
*** HOLE CARDS ***
Dealt to Kevin12345Mc [7c 3h]
Kevin12345Mc: folds 
Tango Habana: folds 
jokes88: raises 140 to 280
félix2011: folds 
PexZz: folds 
Hill9595: folds 
motoboy13sp: folds 
Raonics3: calls 140
*** FLOP *** [6d 3c Qd]
Raonics3: checks 
jokes88: bets 287
Raonics3: folds 
Uncalled bet (287) returned to jokes88
jokes88 collected 798 from pot
jokes88: doesn't show hand 
*** SUMMARY ***
Total pot 798 | Rake 0 
Board [6d 3c Qd]
Seat 1: Tango Habana folded before Flop (didn't bet)
Seat 2: jokes88 collected (798)
Seat 3: félix2011 folded before Flop (didn't bet)
Seat 4: PexZz folded before Flop (didn't bet)
Seat 5: Hill9595 (button) folded before Flop (didn't bet)
Seat 6: motoboy13sp (small blind) folded before Flop
Seat 7: Raonics3 (big blind) folded on the Flop
Seat 8: Kevin12345Mc folded before Flop (didn't bet)



PokerStars Hand #254986107139: Tournament #3860676529, $0.46+$1.50+$0.24 USD Hold'em No Limit - Level VIII (70/140) - 2025/02/22 15:38:20 WET [2025/02/22 10:38:20 ET]
Table '3860676529 25' 8-max Seat #6 is the button
Seat 1: Tango Habana (14468 in chips, $2.25 bounty) 
Seat 2: jokes88 (5982 in chips, $1.50 bounty) 
Seat 3: félix2011 (9085 in chips, $1.50 bounty) 
Seat 4: PexZz (5620 in chips, $2.62 bounty) 
Seat 5: Hill9595 (3603 in chips, $1.50 bounty) 
Seat 6: motoboy13sp (4110 in chips, $1.50 bounty) 
Seat 7: Raonics3 (4722 in chips, $1.50 bounty) 
Seat 8: Kevin12345Mc (20653 in chips, $3.37 bounty) 
Tango Habana: posts the ante 21
jokes88: posts the ante 21
félix2011: posts the ante 21
PexZz: posts the ante 21
Hill9595: posts the ante 21
motoboy13sp: posts the ante 21
Raonics3: posts the ante 21
Kevin12345Mc: posts the ante 21
Raonics3: posts small blind 70
Kevin12345Mc: posts big blind 140
*** HOLE CARDS ***
Dealt to Kevin12345Mc [7d Ah]
Tango Habana: raises 210 to 350
jokes88: folds 
félix2011: folds 
PexZz: folds 
Hill9595: folds 
motoboy13sp: folds 
Raonics3: folds 
Kevin12345Mc: calls 210
*** FLOP *** [9d 9c Qs]
Kevin12345Mc: checks 
Tango Habana: bets 704
Kevin12345Mc: folds 
Uncalled bet (704) returned to Tango Habana
Tango Habana collected 938 from pot
Tango Habana: doesn't show hand 
*** SUMMARY ***
Total pot 938 | Rake 0 
Board [9d 9c Qs]
Seat 1: Tango Habana collected (938)
Seat 2: jokes88 folded before Flop (didn't bet)
Seat 3: félix2011 folded before Flop (didn't bet)
Seat 4: PexZz folded before Flop (didn't bet)
Seat 5: Hill9595 folded before Flop (didn't bet)
Seat 6: motoboy13sp (button) folded before Flop (didn't bet)
Seat 7: Raonics3 (small blind) folded before Flop
Seat 8: Kevin12345Mc (big blind) folded on the Flop



PokerStars Hand #254986114715: Tournament #3860676529, $0.46+$1.50+$0.24 USD Hold'em No Limit - Level VIII (70/140) - 2025/02/22 15:38:54 WET [2025/02/22 10:38:54 ET]
Table '3860676529 25' 8-max Seat #7 is the button
Seat 1: Tango Habana (15035 in chips, $2.25 bounty) 
Seat 2: jokes88 (5961 in chips, $1.50 bounty) 
Seat 3: félix2011 (9064 in chips, $1.50 bounty) 
Seat 4: PexZz (5599 in chips, $2.62 bounty) 
Seat 5: Hill9595 (3582 in chips, $1.50 bounty) 
Seat 6: motoboy13sp (4089 in chips, $1.50 bounty) 
Seat 7: Raonics3 (4631 in chips, $1.50 bounty) 
Seat 8: Kevin12345Mc (20282 in chips, $3.37 bounty) 
Tango Habana: posts the ante 21
jokes88: posts the ante 21
félix2011: posts the ante 21
PexZz: posts the ante 21
Hill9595: posts the ante 21
motoboy13sp: posts the ante 21
Raonics3: posts the ante 21
Kevin12345Mc: posts the ante 21
Kevin12345Mc: posts small blind 70
Tango Habana: posts big blind 140
*** HOLE CARDS ***
Dealt to Kevin12345Mc [9d 8d]
jokes88: folds 
félix2011: folds 
PexZz: raises 140 to 280
Hill9595: folds 
motoboy13sp: folds 
Raonics3: folds 
Kevin12345Mc: calls 210
Tango Habana: calls 140
*** FLOP *** [2c 4c Jh]
Kevin12345Mc: checks 
Tango Habana: checks 
PexZz: bets 252
Kevin12345Mc: folds 
Tango Habana: raises 605 to 857
PexZz: calls 605
*** TURN *** [2c 4c Jh] [Js]
Tango Habana: bets 13877 and is all-in
PexZz: folds 
Uncalled bet (13877) returned to Tango Habana
Tango Habana collected 2722 from pot
Tango Habana: doesn't show hand 
*** SUMMARY ***
Total pot 2722 | Rake 0 
Board [2c 4c Jh Js]
Seat 1: Tango Habana (big blind) collected (2722)
Seat 2: jokes88 folded before Flop (didn't bet)
Seat 3: félix2011 folded before Flop (didn't bet)
Seat 4: PexZz folded on the Turn
Seat 5: Hill9595 folded before Flop (didn't bet)
Seat 6: motoboy13sp folded before Flop (didn't bet)
Seat 7: Raonics3 (button) folded before Flop (didn't bet)
Seat 8: Kevin12345Mc (small blind) folded on the Flop



PokerStars Hand #254986141644: Tournament #3860676529, $0.46+$1.50+$0.24 USD Hold'em No Limit - Level VIII (70/140) - 2025/02/22 15:40:56 WET [2025/02/22 10:40:56 ET]
Table '3860676529 25' 8-max Seat #8 is the button
Seat 1: Tango Habana (16599 in chips, $2.25 bounty) 
Seat 2: jokes88 (5940 in chips, $1.50 bounty) 
Seat 3: félix2011 (9043 in chips, $1.50 bounty) 
Seat 4: PexZz (4441 in chips, $2.62 bounty) 
Seat 5: Hill9595 (3561 in chips, $1.50 bounty) 
Seat 6: motoboy13sp (4068 in chips, $1.50 bounty) 
Seat 7: Raonics3 (4610 in chips, $1.50 bounty) 
Seat 8: Kevin12345Mc (19981 in chips, $3.37 bounty) 
Tango Habana: posts the ante 21
jokes88: posts the ante 21
félix2011: posts the ante 21
PexZz: posts the ante 21
Hill9595: posts the ante 21
motoboy13sp: posts the ante 21
Raonics3: posts the ante 21
Kevin12345Mc: posts the ante 21
Tango Habana: posts small blind 70
jokes88: posts big blind 140
*** HOLE CARDS ***
Dealt to Kevin12345Mc [4s 5h]
félix2011 has timed out
félix2011: folds 
félix2011 is sitting out
PexZz: folds 
Hill9595: raises 140 to 280
félix2011 has returned
motoboy13sp: folds 
Raonics3: folds 
Kevin12345Mc: folds 
Tango Habana: calls 210
jokes88: calls 140
*** FLOP *** [6h Jh 9s]
Tango Habana: checks 
jokes88: checks 
Hill9595: bets 333
Tango Habana: calls 333
jokes88: folds 
*** TURN *** [6h Jh 9s] [4d]
Tango Habana: checks 
Hill9595: bets 910
Tango Habana: folds 
Uncalled bet (910) returned to Hill9595
Hill9595 collected 1674 from pot
Hill9595: doesn't show hand 
*** SUMMARY ***
Total pot 1674 | Rake 0 
Board [6h Jh 9s 4d]
Seat 1: Tango Habana (small blind) folded on the Turn
Seat 2: jokes88 (big blind) folded on the Flop
Seat 3: félix2011 folded before Flop (didn't bet)
Seat 4: PexZz folded before Flop (didn't bet)
Seat 5: Hill9595 collected (1674)
Seat 6: motoboy13sp folded before Flop (didn't bet)
Seat 7: Raonics3 folded before Flop (didn't bet)
Seat 8: Kevin12345Mc (button) folded before Flop (didn't bet)



PokerStars Hand #254986160485: Tournament #3860676529, $0.46+$1.50+$0.24 USD Hold'em No Limit - Level IX (80/160) - 2025/02/22 15:42:21 WET [2025/02/22 10:42:21 ET]
Table '3860676529 25' 8-max Seat #1 is the button
Seat 1: Tango Habana (15965 in chips, $2.25 bounty) 
Seat 2: jokes88 (5639 in chips, $1.50 bounty) 
Seat 3: félix2011 (9022 in chips, $1.50 bounty) 
Seat 4: PexZz (4420 in chips, $2.62 bounty) 
Seat 5: Hill9595 (4601 in chips, $1.50 bounty) 
Seat 6: motoboy13sp (4047 in chips, $1.50 bounty) 
Seat 7: Raonics3 (4589 in chips, $1.50 bounty) 
Seat 8: Kevin12345Mc (19960 in chips, $3.37 bounty) 
Tango Habana: posts the ante 24
jokes88: posts the ante 24
félix2011: posts the ante 24
PexZz: posts the ante 24
Hill9595: posts the ante 24
motoboy13sp: posts the ante 24
Raonics3: posts the ante 24
Kevin12345Mc: posts the ante 24
jokes88: posts small blind 80
félix2011: posts big blind 160
*** HOLE CARDS ***
Dealt to Kevin12345Mc [Kc 3h]
PexZz: folds 
Hill9595: folds 
motoboy13sp: folds 
Raonics3: folds 
Kevin12345Mc: folds 
Tango Habana: raises 240 to 400
jokes88: raises 720 to 1120
félix2011: folds 
Tango Habana: raises 14821 to 15941 and is all-in
jokes88: calls 4495 and is all-in
Uncalled bet (10326) returned to Tango Habana
*** FLOP *** [5h 7d Jh]
*** TURN *** [5h 7d Jh] [6c]
*** RIVER *** [5h 7d Jh 6c] [6s]
*** SHOW DOWN ***
jokes88: shows [Kd Td] (a pair of Sixes)
Tango Habana: shows [Ah Qh] (a pair of Sixes - Ace kicker)
Tango Habana collected 11582 from pot
Tango Habana wins $0.75 for eliminating jokes88 and their own bounty increases by $0.75 to $3
jokes88 finished the tournament
Dzibiy is disconnected 
*** SUMMARY ***
Total pot 11582 | Rake 0 
Board [5h 7d Jh 6c 6s]
Seat 1: Tango Habana (button) showed [Ah Qh] and won (11582) with a pair of Sixes
Seat 2: jokes88 (small blind) showed [Kd Td] and lost with a pair of Sixes
Seat 3: félix2011 (big blind) folded before Flop
Seat 4: PexZz folded before Flop (didn't bet)
Seat 5: Hill9595 folded before Flop (didn't bet)
Seat 6: motoboy13sp folded before Flop (didn't bet)
Seat 7: Raonics3 folded before Flop (didn't bet)
Seat 8: Kevin12345Mc folded before Flop (didn't bet)



PokerStars Hand #254986172182: Tournament #3860676529, $0.46+$1.50+$0.24 USD Hold'em No Limit - Level IX (80/160) - 2025/02/22 15:43:14 WET [2025/02/22 10:43:14 ET]
Table '3860676529 25' 8-max Seat #3 is the button
Seat 1: Tango Habana (21908 in chips, $3 bounty) 
Seat 2: Dzibiy (14532 in chips, $2.25 bounty) 
Seat 3: félix2011 (8838 in chips, $1.50 bounty) 
Seat 4: PexZz (4396 in chips, $2.62 bounty) 
Seat 5: Hill9595 (4577 in chips, $1.50 bounty) 
Seat 6: motoboy13sp (4023 in chips, $1.50 bounty) 
Seat 7: Raonics3 (4565 in chips, $1.50 bounty) 
Seat 8: Kevin12345Mc (19936 in chips, $3.37 bounty) 
Tango Habana: posts the ante 24
Dzibiy: posts the ante 24
félix2011: posts the ante 24
PexZz: posts the ante 24
Hill9595: posts the ante 24
motoboy13sp: posts the ante 24
Raonics3: posts the ante 24
Kevin12345Mc: posts the ante 24
PexZz: posts small blind 80
Hill9595: posts big blind 160
*** HOLE CARDS ***
Dealt to Kevin12345Mc [6h 5d]
motoboy13sp: folds 
Raonics3: folds 
Kevin12345Mc: folds 
Tango Habana: folds 
Dzibiy: raises 160 to 320
félix2011: raises 640 to 960
PexZz: folds 
Hill9595: folds 
Dzibiy: raises 2240 to 3200
félix2011: folds 
Uncalled bet (2240) returned to Dzibiy
Dzibiy collected 2352 from pot
Dzibiy: doesn't show hand 
*** SUMMARY ***
Total pot 2352 | Rake 0 
Seat 1: Tango Habana folded before Flop (didn't bet)
Seat 2: Dzibiy collected (2352)
Seat 3: félix2011 (button) folded before Flop
Seat 4: PexZz (small blind) folded before Flop
Seat 5: Hill9595 (big blind) folded before Flop
Seat 6: motoboy13sp folded before Flop (didn't bet)
Seat 7: Raonics3 folded before Flop (didn't bet)
Seat 8: Kevin12345Mc folded before Flop (didn't bet)



PokerStars Hand #254986185811: Tournament #3860676529, $0.46+$1.50+$0.24 USD Hold'em No Limit - Level IX (80/160) - 2025/02/22 15:44:16 WET [2025/02/22 10:44:16 ET]
Table '3860676529 25' 8-max Seat #4 is the button
Seat 1: Tango Habana (21884 in chips, $3 bounty) 
Seat 2: Dzibiy (15900 in chips, $2.25 bounty) 
Seat 3: félix2011 (7854 in chips, $1.50 bounty) 
Seat 4: PexZz (4292 in chips, $2.62 bounty) 
Seat 5: Hill9595 (4393 in chips, $1.50 bounty) 
Seat 6: motoboy13sp (3999 in chips, $1.50 bounty) 
Seat 7: Raonics3 (4541 in chips, $1.50 bounty) 
Seat 8: Kevin12345Mc (19912 in chips, $3.37 bounty) 
Tango Habana: posts the ante 24
Dzibiy: posts the ante 24
félix2011: posts the ante 24
PexZz: posts the ante 24
Hill9595: posts the ante 24
motoboy13sp: posts the ante 24
Raonics3: posts the ante 24
Kevin12345Mc: posts the ante 24
Hill9595: posts small blind 80
motoboy13sp: posts big blind 160
*** HOLE CARDS ***
Dealt to Kevin12345Mc [4s 7s]
Raonics3: folds 
Kevin12345Mc: folds 
Tango Habana: raises 160 to 320
Dzibiy: folds 
félix2011: raises 640 to 960
PexZz: folds 
Hill9595: folds 
motoboy13sp: folds 
Tango Habana: folds 
Uncalled bet (640) returned to félix2011
félix2011 collected 1072 from pot
félix2011: doesn't show hand 
*** SUMMARY ***
Total pot 1072 | Rake 0 
Seat 1: Tango Habana folded before Flop
Seat 2: Dzibiy folded before Flop (didn't bet)
Seat 3: félix2011 collected (1072)
Seat 4: PexZz (button) folded before Flop (didn't bet)
Seat 5: Hill9595 (small blind) folded before Flop
Seat 6: motoboy13sp (big blind) folded before Flop
Seat 7: Raonics3 folded before Flop (didn't bet)
Seat 8: Kevin12345Mc folded before Flop (didn't bet)



PokerStars Hand #254986195393: Tournament #3860676529, $0.46+$1.50+$0.24 USD Hold'em No Limit - Level IX (80/160) - 2025/02/22 15:44:59 WET [2025/02/22 10:44:59 ET]
Table '3860676529 25' 8-max Seat #5 is the button
Seat 1: Tango Habana (21540 in chips, $3 bounty) 
Seat 2: Dzibiy (15876 in chips, $2.25 bounty) 
Seat 3: félix2011 (8582 in chips, $1.50 bounty) 
Seat 4: PexZz (4268 in chips, $2.62 bounty) 
Seat 5: Hill9595 (4289 in chips, $1.50 bounty) 
Seat 6: motoboy13sp (3815 in chips, $1.50 bounty) 
Seat 7: Raonics3 (4517 in chips, $1.50 bounty) 
Seat 8: Kevin12345Mc (19888 in chips, $3.37 bounty) 
Tango Habana: posts the ante 24
Dzibiy: posts the ante 24
félix2011: posts the ante 24
PexZz: posts the ante 24
Hill9595: posts the ante 24
motoboy13sp: posts the ante 24
Raonics3: posts the ante 24
Kevin12345Mc: posts the ante 24
motoboy13sp: posts small blind 80
Raonics3: posts big blind 160
*** HOLE CARDS ***
Dealt to Kevin12345Mc [Kc Tc]
Kevin12345Mc: raises 208 to 368
Tango Habana: folds 
Dzibiy has timed out
Dzibiy: folds 
Dzibiy is sitting out
Dzibiy has returned
félix2011: calls 368
PexZz: folds 
Hill9595: folds 
motoboy13sp: folds 
Raonics3: calls 208
*** FLOP *** [Ks 2h 6c]
Raonics3: checks 
Kevin12345Mc: bets 454
félix2011: calls 454
Raonics3: folds 
*** TURN *** [Ks 2h 6c] [7d]
Kevin12345Mc: bets 754
félix2011: folds 
Uncalled bet (754) returned to Kevin12345Mc
Kevin12345Mc collected 2284 from pot
Kevin12345Mc: doesn't show hand 
*** SUMMARY ***
Total pot 2284 | Rake 0 
Board [Ks 2h 6c 7d]
Seat 1: Tango Habana folded before Flop (didn't bet)
Seat 2: Dzibiy folded before Flop (didn't bet)
Seat 3: félix2011 folded on the Turn
Seat 4: PexZz folded before Flop (didn't bet)
Seat 5: Hill9595 (button) folded before Flop (didn't bet)
Seat 6: motoboy13sp (small blind) folded before Flop
Seat 7: Raonics3 (big blind) folded on the Flop
Seat 8: Kevin12345Mc collected (2284)



PokerStars Hand #254986215748: Tournament #3860676529, $0.46+$1.50+$0.24 USD Hold'em No Limit - Level IX (80/160) - 2025/02/22 15:46:31 WET [2025/02/22 10:46:31 ET]
Table '3860676529 25' 8-max Seat #6 is the button
Seat 1: Tango Habana (21516 in chips, $3 bounty) 
Seat 2: Dzibiy (15852 in chips, $2.25 bounty) 
Seat 3: félix2011 (7736 in chips, $1.50 bounty) 
Seat 4: PexZz (4244 in chips, $2.62 bounty) 
Seat 5: Hill9595 (4265 in chips, $1.50 bounty) 
Seat 6: motoboy13sp (3711 in chips, $1.50 bounty) 
Seat 7: Raonics3 (4125 in chips, $1.50 bounty) 
Seat 8: Kevin12345Mc (21326 in chips, $3.37 bounty) 
Tango Habana: posts the ante 24
Dzibiy: posts the ante 24
félix2011: posts the ante 24
PexZz: posts the ante 24
Hill9595: posts the ante 24
motoboy13sp: posts the ante 24
Raonics3: posts the ante 24
Kevin12345Mc: posts the ante 24
Raonics3: posts small blind 80
Kevin12345Mc: posts big blind 160
*** HOLE CARDS ***
Dealt to Kevin12345Mc [2h Jc]
Tango Habana: folds 
Dzibiy: folds 
félix2011: folds 
PexZz: folds 
Hill9595: folds 
motoboy13sp: raises 160 to 320
Raonics3: folds 
Kevin12345Mc: folds 
Uncalled bet (160) returned to motoboy13sp
motoboy13sp collected 592 from pot
motoboy13sp: doesn't show hand 
*** SUMMARY ***
Total pot 592 | Rake 0 
Seat 1: Tango Habana folded before Flop (didn't bet)
Seat 2: Dzibiy folded before Flop (didn't bet)
Seat 3: félix2011 folded before Flop (didn't bet)
Seat 4: PexZz folded before Flop (didn't bet)
Seat 5: Hill9595 folded before Flop (didn't bet)
Seat 6: motoboy13sp (button) collected (592)
Seat 7: Raonics3 (small blind) folded before Flop
Seat 8: Kevin12345Mc (big blind) folded before Flop



PokerStars Hand #254986220783: Tournament #3860676529, $0.46+$1.50+$0.24 USD Hold'em No Limit - Level IX (80/160) - 2025/02/22 15:46:53 WET [2025/02/22 10:46:53 ET]
Table '3860676529 25' 8-max Seat #7 is the button
Seat 1: Tango Habana (21492 in chips, $3 bounty) 
Seat 2: Dzibiy (15828 in chips, $2.25 bounty) 
Seat 3: félix2011 (7712 in chips, $1.50 bounty) 
Seat 4: PexZz (4220 in chips, $2.62 bounty) 
Seat 5: Hill9595 (4241 in chips, $1.50 bounty) 
Seat 6: motoboy13sp (4119 in chips, $1.50 bounty) 
Seat 7: Raonics3 (4021 in chips, $1.50 bounty) 
Seat 8: Kevin12345Mc (21142 in chips, $3.37 bounty) 
Tango Habana: posts the ante 24
Dzibiy: posts the ante 24
félix2011: posts the ante 24
PexZz: posts the ante 24
Hill9595: posts the ante 24
motoboy13sp: posts the ante 24
Raonics3: posts the ante 24
Kevin12345Mc: posts the ante 24
Kevin12345Mc: posts small blind 80
Tango Habana: posts big blind 160
*** HOLE CARDS ***
Dealt to Kevin12345Mc [6h Qd]
Dzibiy: folds 
félix2011: folds 
PexZz: raises 160 to 320
Hill9595: folds 
motoboy13sp: folds 
Raonics3: folds 
Kevin12345Mc: folds 
Tango Habana: folds 
Uncalled bet (160) returned to PexZz
PexZz collected 592 from pot
*** SUMMARY ***
Total pot 592 | Rake 0 
Seat 1: Tango Habana (big blind) folded before Flop
Seat 2: Dzibiy folded before Flop (didn't bet)
Seat 3: félix2011 folded before Flop (didn't bet)
Seat 4: PexZz collected (592)
Seat 5: Hill9595 folded before Flop (didn't bet)
Seat 6: motoboy13sp folded before Flop (didn't bet)
Seat 7: Raonics3 (button) folded before Flop (didn't bet)
Seat 8: Kevin12345Mc (small blind) folded before Flop



PokerStars Hand #254986224952: Tournament #3860676529, $0.46+$1.50+$0.24 USD Hold'em No Limit - Level IX (80/160) - 2025/02/22 15:47:12 WET [2025/02/22 10:47:12 ET]
Table '3860676529 25' 8-max Seat #8 is the button
Seat 1: Tango Habana (21308 in chips, $3 bounty) 
Seat 2: Dzibiy (15804 in chips, $2.25 bounty) 
Seat 3: félix2011 (7688 in chips, $1.50 bounty) 
Seat 4: PexZz (4628 in chips, $2.62 bounty) 
Seat 5: Hill9595 (4217 in chips, $1.50 bounty) 
Seat 6: motoboy13sp (4095 in chips, $1.50 bounty) 
Seat 7: Raonics3 (3997 in chips, $1.50 bounty) 
Seat 8: Kevin12345Mc (21038 in chips, $3.37 bounty) 
Tango Habana: posts the ante 24
Dzibiy: posts the ante 24
félix2011: posts the ante 24
PexZz: posts the ante 24
Hill9595: posts the ante 24
motoboy13sp: posts the ante 24
Raonics3: posts the ante 24
Kevin12345Mc: posts the ante 24
Tango Habana: posts small blind 80
Dzibiy: posts big blind 160
*** HOLE CARDS ***
Dealt to Kevin12345Mc [3h 4c]
félix2011: raises 176 to 336
PexZz: folds 
Hill9595: folds 
motoboy13sp: folds 
Raonics3: folds 
Kevin12345Mc: folds 
Tango Habana: folds 
Dzibiy: calls 176
*** FLOP *** [5s 6d 8s]
Dzibiy: bets 320
félix2011: calls 320
*** TURN *** [5s 6d 8s] [5h]
Dzibiy: bets 1040
félix2011: folds 
Uncalled bet (1040) returned to Dzibiy
Dzibiy collected 1584 from pot
Dzibiy: doesn't show hand 
*** SUMMARY ***
Total pot 1584 | Rake 0 
Board [5s 6d 8s 5h]
Seat 1: Tango Habana (small blind) folded before Flop
Seat 2: Dzibiy (big blind) collected (1584)
Seat 3: félix2011 folded on the Turn
Seat 4: PexZz folded before Flop (didn't bet)
Seat 5: Hill9595 folded before Flop (didn't bet)
Seat 6: motoboy13sp folded before Flop (didn't bet)
Seat 7: Raonics3 folded before Flop (didn't bet)
Seat 8: Kevin12345Mc (button) folded before Flop (didn't bet)



PokerStars Hand #254986239001: Tournament #3860676529, $0.46+$1.50+$0.24 USD Hold'em No Limit - Level IX (80/160) - 2025/02/22 15:48:15 WET [2025/02/22 10:48:15 ET]
Table '3860676529 25' 8-max Seat #1 is the button
Seat 1: Tango Habana (21204 in chips, $3 bounty) 
Seat 2: Dzibiy (16708 in chips, $2.25 bounty) 
Seat 3: félix2011 (7008 in chips, $1.50 bounty) 
Seat 4: PexZz (4604 in chips, $2.62 bounty) 
Seat 5: Hill9595 (4193 in chips, $1.50 bounty) 
Seat 6: motoboy13sp (4071 in chips, $1.50 bounty) 
Seat 7: Raonics3 (3973 in chips, $1.50 bounty) 
Seat 8: Kevin12345Mc (21014 in chips, $3.37 bounty) 
Tango Habana: posts the ante 24
Dzibiy: posts the ante 24
félix2011: posts the ante 24
PexZz: posts the ante 24
Hill9595: posts the ante 24
motoboy13sp: posts the ante 24
Raonics3: posts the ante 24
Kevin12345Mc: posts the ante 24
Dzibiy: posts small blind 80
félix2011: posts big blind 160
*** HOLE CARDS ***
Dealt to Kevin12345Mc [Jd 2s]
PexZz: folds 
Hill9595: folds 
motoboy13sp: folds 
Raonics3: folds 
Kevin12345Mc: folds 
Tango Habana: folds 
Dzibiy: raises 400 to 560
félix2011: raises 1040 to 1600
Dzibiy: folds 
Uncalled bet (1040) returned to félix2011
félix2011 collected 1312 from pot
félix2011: doesn't show hand 
*** SUMMARY ***
Total pot 1312 | Rake 0 
Seat 1: Tango Habana (button) folded before Flop (didn't bet)
Seat 2: Dzibiy (small blind) folded before Flop
Seat 3: félix2011 (big blind) collected (1312)
Seat 4: PexZz folded before Flop (didn't bet)
Seat 5: Hill9595 folded before Flop (didn't bet)
Seat 6: motoboy13sp folded before Flop (didn't bet)
Seat 7: Raonics3 folded before Flop (didn't bet)
Seat 8: Kevin12345Mc folded before Flop (didn't bet)



PokerStars Hand #254986245357: Tournament #3860676529, $0.46+$1.50+$0.24 USD Hold'em No Limit - Level IX (80/160) - 2025/02/22 15:48:43 WET [2025/02/22 10:48:43 ET]
Table '3860676529 25' 8-max Seat #2 is the button
Seat 1: Tango Habana (21180 in chips, $3 bounty) 
Seat 2: Dzibiy (16124 in chips, $2.25 bounty) 
Seat 3: félix2011 (7736 in chips, $1.50 bounty) 
Seat 4: PexZz (4580 in chips, $2.62 bounty) 
Seat 5: Hill9595 (4169 in chips, $1.50 bounty) 
Seat 6: motoboy13sp (4047 in chips, $1.50 bounty) 
Seat 7: Raonics3 (3949 in chips, $1.50 bounty) 
Seat 8: Kevin12345Mc (20990 in chips, $3.37 bounty) 
Tango Habana: posts the ante 24
Dzibiy: posts the ante 24
félix2011: posts the ante 24
PexZz: posts the ante 24
Hill9595: posts the ante 24
motoboy13sp: posts the ante 24
Raonics3: posts the ante 24
Kevin12345Mc: posts the ante 24
félix2011: posts small blind 80
PexZz: posts big blind 160
*** HOLE CARDS ***
Dealt to Kevin12345Mc [8s 9d]
Hill9595: folds 
motoboy13sp: raises 160 to 320
Raonics3: calls 320
Kevin12345Mc: folds 
Tango Habana: folds 
Dzibiy: calls 320
félix2011: folds 
PexZz: calls 160
*** FLOP *** [3c Ac Tc]
PexZz: checks 
motoboy13sp: bets 368
Raonics3: folds 
Dzibiy: folds 
PexZz: calls 368
*** TURN *** [3c Ac Tc] [3s]
PexZz: bets 572
motoboy13sp: calls 572
*** RIVER *** [3c Ac Tc 3s] [3h]
PexZz: bets 3296 and is all-in
motoboy13sp: folds 
Uncalled bet (3296) returned to PexZz
PexZz collected 3432 from pot
*** SUMMARY ***
Total pot 3432 | Rake 0 
Board [3c Ac Tc 3s 3h]
Seat 1: Tango Habana folded before Flop (didn't bet)
Seat 2: Dzibiy (button) folded on the Flop
Seat 3: félix2011 (small blind) folded before Flop
Seat 4: PexZz (big blind) collected (3432)
Seat 5: Hill9595 folded before Flop (didn't bet)
Seat 6: motoboy13sp folded on the River
Seat 7: Raonics3 folded on the Flop
Seat 8: Kevin12345Mc folded before Flop (didn't bet)



PokerStars Hand #254986272439: Tournament #3860676529, $0.46+$1.50+$0.24 USD Hold'em No Limit - Level X (90/180) - 2025/02/22 15:50:44 WET [2025/02/22 10:50:44 ET]
Table '3860676529 25' 8-max Seat #3 is the button
Seat 1: Tango Habana (21156 in chips, $3 bounty) 
Seat 2: Dzibiy (15780 in chips, $2.25 bounty) 
Seat 3: félix2011 (7632 in chips, $1.50 bounty) 
Seat 4: PexZz (6728 in chips, $2.62 bounty) 
Seat 5: Hill9595 (4145 in chips, $1.50 bounty) 
Seat 6: motoboy13sp (2763 in chips, $1.50 bounty) 
Seat 7: Raonics3 (3605 in chips, $1.50 bounty) 
Seat 8: Kevin12345Mc (20966 in chips, $3.37 bounty) 
Tango Habana: posts the ante 27
Dzibiy: posts the ante 27
félix2011: posts the ante 27
PexZz: posts the ante 27
Hill9595: posts the ante 27
motoboy13sp: posts the ante 27
Raonics3: posts the ante 27
Kevin12345Mc: posts the ante 27
PexZz: posts small blind 90
Hill9595: posts big blind 180
*** HOLE CARDS ***
Dealt to Kevin12345Mc [3d Th]
motoboy13sp: folds 
Raonics3: folds 
Kevin12345Mc: folds 
Tango Habana: folds 
Dzibiy: raises 180 to 360
félix2011: folds 
PexZz: calls 270
Hill9595: folds 
*** FLOP *** [4c 6c 8d]
PexZz: checks 
Dzibiy: bets 279
PexZz: calls 279
*** TURN *** [4c 6c 8d] [9c]
PexZz: checks 
Dzibiy: bets 1116
PexZz: folds 
Uncalled bet (1116) returned to Dzibiy
Dzibiy collected 1674 from pot
Dzibiy: doesn't show hand 
*** SUMMARY ***
Total pot 1674 | Rake 0 
Board [4c 6c 8d 9c]
Seat 1: Tango Habana folded before Flop (didn't bet)
Seat 2: Dzibiy collected (1674)
Seat 3: félix2011 (button) folded before Flop (didn't bet)
Seat 4: PexZz (small blind) folded on the Turn
Seat 5: Hill9595 (big blind) folded before Flop
Seat 6: motoboy13sp folded before Flop (didn't bet)
Seat 7: Raonics3 folded before Flop (didn't bet)
Seat 8: Kevin12345Mc folded before Flop (didn't bet)



PokerStars Hand #254986284277: Tournament #3860676529, $0.46+$1.50+$0.24 USD Hold'em No Limit - Level X (90/180) - 2025/02/22 15:51:37 WET [2025/02/22 10:51:37 ET]
Table '3860676529 25' 8-max Seat #4 is the button
Seat 1: Tango Habana (21129 in chips, $3 bounty) 
Seat 2: Dzibiy (16788 in chips, $2.25 bounty) 
Seat 3: félix2011 (7605 in chips, $1.50 bounty) 
Seat 4: PexZz (6062 in chips, $2.62 bounty) 
Seat 5: Hill9595 (3938 in chips, $1.50 bounty) 
Seat 6: motoboy13sp (2736 in chips, $1.50 bounty) 
Seat 7: Raonics3 (3578 in chips, $1.50 bounty) 
Seat 8: Kevin12345Mc (20939 in chips, $3.37 bounty) 
Tango Habana: posts the ante 27
Dzibiy: posts the ante 27
félix2011: posts the ante 27
PexZz: posts the ante 27
Hill9595: posts the ante 27
motoboy13sp: posts the ante 27
Raonics3: posts the ante 27
Kevin12345Mc: posts the ante 27
Hill9595: posts small blind 90
motoboy13sp: posts big blind 180
*** HOLE CARDS ***
Dealt to Kevin12345Mc [Kd 7s]
Raonics3: folds 
Kevin12345Mc: folds 
Tango Habana: folds 
Dzibiy: raises 180 to 360
félix2011: folds 
PexZz: raises 5675 to 6035 and is all-in
Hill9595: folds 
motoboy13sp: folds 
Dzibiy: folds 
Uncalled bet (5675) returned to PexZz
PexZz collected 1206 from pot
*** SUMMARY ***
Total pot 1206 | Rake 0 
Seat 1: Tango Habana folded before Flop (didn't bet)
Seat 2: Dzibiy folded before Flop
Seat 3: félix2011 folded before Flop (didn't bet)
Seat 4: PexZz (button) collected (1206)
Seat 5: Hill9595 (small blind) folded before Flop
Seat 6: motoboy13sp (big blind) folded before Flop
Seat 7: Raonics3 folded before Flop (didn't bet)
Seat 8: Kevin12345Mc folded before Flop (didn't bet)



PokerStars Hand #254986291727: Tournament #3860676529, $0.46+$1.50+$0.24 USD Hold'em No Limit - Level X (90/180) - 2025/02/22 15:52:10 WET [2025/02/22 10:52:10 ET]
Table '3860676529 25' 8-max Seat #5 is the button
Seat 1: Tango Habana (21102 in chips, $3 bounty) 
Seat 2: Dzibiy (16401 in chips, $2.25 bounty) 
Seat 3: félix2011 (7578 in chips, $1.50 bounty) 
Seat 4: PexZz (6881 in chips, $2.62 bounty) 
Seat 5: Hill9595 (3821 in chips, $1.50 bounty) 
Seat 6: motoboy13sp (2529 in chips, $1.50 bounty) 
Seat 7: Raonics3 (3551 in chips, $1.50 bounty) 
Seat 8: Kevin12345Mc (20912 in chips, $3.37 bounty) 
Tango Habana: posts the ante 27
Dzibiy: posts the ante 27
félix2011: posts the ante 27
PexZz: posts the ante 27
Hill9595: posts the ante 27
motoboy13sp: posts the ante 27
Raonics3: posts the ante 27
Kevin12345Mc: posts the ante 27
motoboy13sp: posts small blind 90
Raonics3: posts big blind 180
*** HOLE CARDS ***
Dealt to Kevin12345Mc [4c Kc]
Kevin12345Mc: folds 
Tango Habana: folds 
Dzibiy has timed out
Dzibiy: folds 
Dzibiy is sitting out
Dzibiy has returned
félix2011: raises 198 to 378
PexZz: folds 
Hill9595: folds 
motoboy13sp: folds 
Raonics3: folds 
Uncalled bet (198) returned to félix2011
félix2011 collected 666 from pot
félix2011: doesn't show hand 
*** SUMMARY ***
Total pot 666 | Rake 0 
Seat 1: Tango Habana folded before Flop (didn't bet)
Seat 2: Dzibiy folded before Flop (didn't bet)
Seat 3: félix2011 collected (666)
Seat 4: PexZz folded before Flop (didn't bet)
Seat 5: Hill9595 (button) folded before Flop (didn't bet)
Seat 6: motoboy13sp (small blind) folded before Flop
Seat 7: Raonics3 (big blind) folded before Flop
Seat 8: Kevin12345Mc folded before Flop (didn't bet)



PokerStars Hand #254986301016: Tournament #3860676529, $0.46+$1.50+$0.24 USD Hold'em No Limit - Level X (90/180) - 2025/02/22 15:52:52 WET [2025/02/22 10:52:52 ET]
Table '3860676529 25' 8-max Seat #6 is the button
Seat 1: Tango Habana (21075 in chips, $3 bounty) 
Seat 2: Dzibiy (16374 in chips, $2.25 bounty) 
Seat 3: félix2011 (8037 in chips, $1.50 bounty) 
Seat 4: PexZz (6854 in chips, $2.62 bounty) 
Seat 5: Hill9595 (3794 in chips, $1.50 bounty) 
Seat 6: motoboy13sp (2412 in chips, $1.50 bounty) 
Seat 7: Raonics3 (3344 in chips, $1.50 bounty) 
Seat 8: Kevin12345Mc (20885 in chips, $3.37 bounty) 
Tango Habana: posts the ante 27
Dzibiy: posts the ante 27
félix2011: posts the ante 27
PexZz: posts the ante 27
Hill9595: posts the ante 27
motoboy13sp: posts the ante 27
Raonics3: posts the ante 27
Kevin12345Mc: posts the ante 27
Raonics3: posts small blind 90
Kevin12345Mc: posts big blind 180
*** HOLE CARDS ***
Dealt to Kevin12345Mc [Kd Jh]
Tango Habana: folds 
Dzibiy: raises 180 to 360
félix2011: folds 
PexZz: folds 
Hill9595: folds 
motoboy13sp: folds 
Raonics3: folds 
Kevin12345Mc: calls 180
*** FLOP *** [5c 5d 8h]
Kevin12345Mc: checks 
Dzibiy has timed out
Dzibiy: checks 
*** TURN *** [5c 5d 8h] [Ah]
Kevin12345Mc: checks 
Dzibiy: checks 
*** RIVER *** [5c 5d 8h Ah] [7h]
Kevin12345Mc: checks 
Dzibiy: bets 1440
Kevin12345Mc: folds 
Uncalled bet (1440) returned to Dzibiy
Dzibiy collected 1026 from pot
Dzibiy: doesn't show hand 
*** SUMMARY ***
Total pot 1026 | Rake 0 
Board [5c 5d 8h Ah 7h]
Seat 1: Tango Habana folded before Flop (didn't bet)
Seat 2: Dzibiy collected (1026)
Seat 3: félix2011 folded before Flop (didn't bet)
Seat 4: PexZz folded before Flop (didn't bet)
Seat 5: Hill9595 folded before Flop (didn't bet)
Seat 6: motoboy13sp (button) folded before Flop (didn't bet)
Seat 7: Raonics3 (small blind) folded before Flop
Seat 8: Kevin12345Mc (big blind) folded on the River



PokerStars Hand #254986317119: Tournament #3860676529, $0.46+$1.50+$0.24 USD Hold'em No Limit - Level X (90/180) - 2025/02/22 15:54:04 WET [2025/02/22 10:54:04 ET]
Table '3860676529 25' 8-max Seat #7 is the button
Seat 1: Tango Habana (21048 in chips, $3 bounty) 
Seat 2: Dzibiy (17013 in chips, $2.25 bounty) 
Seat 3: félix2011 (8010 in chips, $1.50 bounty) 
Seat 4: PexZz (6827 in chips, $2.62 bounty) 
Seat 5: Hill9595 (3767 in chips, $1.50 bounty) 
Seat 6: motoboy13sp (2385 in chips, $1.50 bounty) 
Seat 7: Raonics3 (3227 in chips, $1.50 bounty) 
Seat 8: Kevin12345Mc (20498 in chips, $3.37 bounty) 
Tango Habana: posts the ante 27
Dzibiy: posts the ante 27
félix2011: posts the ante 27
PexZz: posts the ante 27
Hill9595: posts the ante 27
motoboy13sp: posts the ante 27
Raonics3: posts the ante 27
Kevin12345Mc: posts the ante 27
Kevin12345Mc: posts small blind 90
Tango Habana: posts big blind 180
*** HOLE CARDS ***
Dealt to Kevin12345Mc [Qc 2c]
Dzibiy: folds 
félix2011: raises 198 to 378
PexZz: folds 
Hill9595: folds 
motoboy13sp: folds 
Raonics3: folds 
Kevin12345Mc: folds 
Tango Habana: folds 
Uncalled bet (198) returned to félix2011
félix2011 collected 666 from pot
félix2011: doesn't show hand 
*** SUMMARY ***
Total pot 666 | Rake 0 
Seat 1: Tango Habana (big blind) folded before Flop
Seat 2: Dzibiy folded before Flop (didn't bet)
Seat 3: félix2011 collected (666)
Seat 4: PexZz folded before Flop (didn't bet)
Seat 5: Hill9595 folded before Flop (didn't bet)
Seat 6: motoboy13sp folded before Flop (didn't bet)
Seat 7: Raonics3 (button) folded before Flop (didn't bet)
Seat 8: Kevin12345Mc (small blind) folded before Flop



PokerStars Hand #254986323839: Tournament #3860676529, $0.46+$1.50+$0.24 USD Hold'em No Limit - Level X (90/180) - 2025/02/22 15:54:34 WET [2025/02/22 10:54:34 ET]
Table '3860676529 25' 8-max Seat #8 is the button
Seat 1: Tango Habana (20841 in chips, $3 bounty) 
Seat 2: Dzibiy (16986 in chips, $2.25 bounty) 
Seat 3: félix2011 (8469 in chips, $1.50 bounty) 
Seat 4: PexZz (6800 in chips, $2.62 bounty) 
Seat 5: Hill9595 (3740 in chips, $1.50 bounty) 
Seat 6: motoboy13sp (2358 in chips, $1.50 bounty) 
Seat 7: Raonics3 (3200 in chips, $1.50 bounty) 
Seat 8: Kevin12345Mc (20381 in chips, $3.37 bounty) 
Tango Habana: posts the ante 27
Dzibiy: posts the ante 27
félix2011: posts the ante 27
PexZz: posts the ante 27
Hill9595: posts the ante 27
motoboy13sp: posts the ante 27
Raonics3: posts the ante 27
Kevin12345Mc: posts the ante 27
Tango Habana: posts small blind 90
Dzibiy: posts big blind 180
*** HOLE CARDS ***
Dealt to Kevin12345Mc [Jd 5h]
félix2011: folds 
PexZz: folds 
Hill9595: folds 
motoboy13sp: folds 
Raonics3: folds 
Kevin12345Mc: folds 
Tango Habana: raises 198 to 378
Dzibiy: calls 198
*** FLOP *** [9s Tc Kd]
Tango Habana: bets 292
Dzibiy: calls 292
*** TURN *** [9s Tc Kd] [6c]
Tango Habana: checks 
Dzibiy: bets 856
Tango Habana: folds 
Uncalled bet (856) returned to Dzibiy
Dzibiy collected 1556 from pot
Dzibiy: doesn't show hand 
*** SUMMARY ***
Total pot 1556 | Rake 0 
Board [9s Tc Kd 6c]
Seat 1: Tango Habana (small blind) folded on the Turn
Seat 2: Dzibiy (big blind) collected (1556)
Seat 3: félix2011 folded before Flop (didn't bet)
Seat 4: PexZz folded before Flop (didn't bet)
Seat 5: Hill9595 folded before Flop (didn't bet)
Seat 6: motoboy13sp folded before Flop (didn't bet)
Seat 7: Raonics3 folded before Flop (didn't bet)
Seat 8: Kevin12345Mc (button) folded before Flop (didn't bet)



PokerStars Hand #254986405160: Tournament #3860676529, $0.46+$1.50+$0.24 USD Hold'em No Limit - Level X (90/180) - 2025/02/22 16:02:10 WET [2025/02/22 11:02:10 ET]
Table '3860676529 25' 8-max Seat #1 is the button
Seat 1: Tango Habana (20144 in chips, $3 bounty) 
Seat 2: Dzibiy (17845 in chips, $2.25 bounty) 
Seat 3: félix2011 (8442 in chips, $1.50 bounty) 
Seat 4: PexZz (6773 in chips, $2.62 bounty) 
Seat 5: Hill9595 (3713 in chips, $1.50 bounty) 
Seat 6: motoboy13sp (2331 in chips, $1.50 bounty) 
Seat 7: Raonics3 (3173 in chips, $1.50 bounty) 
Seat 8: Kevin12345Mc (20354 in chips, $3.37 bounty) 
Tango Habana: posts the ante 27
Dzibiy: posts the ante 27
félix2011: posts the ante 27
PexZz: posts the ante 27
Hill9595: posts the ante 27
motoboy13sp: posts the ante 27
Raonics3: posts the ante 27
Kevin12345Mc: posts the ante 27
Dzibiy: posts small blind 90
félix2011: posts big blind 180
*** HOLE CARDS ***
Dealt to Kevin12345Mc [3d 6s]
PexZz: folds 
Hill9595: folds 
motoboy13sp: folds 
Raonics3: folds 
Kevin12345Mc: folds 
Tango Habana: raises 198 to 378
Dzibiy: folds 
félix2011: calls 198
*** FLOP *** [Qd 8s 5s]
félix2011: checks 
Tango Habana: checks 
*** TURN *** [Qd 8s 5s] [9c]
félix2011: bets 701
Tango Habana: calls 701
*** RIVER *** [Qd 8s 5s 9c] [Kh]
félix2011: checks 
Tango Habana: checks 
*** SHOW DOWN ***
félix2011: shows [8h 7d] (a pair of Eights)
Tango Habana: mucks hand 
félix2011 collected 2464 from pot
*** SUMMARY ***
Total pot 2464 | Rake 0 
Board [Qd 8s 5s 9c Kh]
Seat 1: Tango Habana (button) mucked [Jh Ah]
Seat 2: Dzibiy (small blind) folded before Flop
Seat 3: félix2011 (big blind) showed [8h 7d] and won (2464) with a pair of Eights
Seat 4: PexZz folded before Flop (didn't bet)
Seat 5: Hill9595 folded before Flop (didn't bet)
Seat 6: motoboy13sp folded before Flop (didn't bet)
Seat 7: Raonics3 folded before Flop (didn't bet)
Seat 8: Kevin12345Mc folded before Flop (didn't bet)



PokerStars Hand #254986418418: Tournament #3860676529, $0.46+$1.50+$0.24 USD Hold'em No Limit - Level X (90/180) - 2025/02/22 16:03:11 WET [2025/02/22 11:03:11 ET]
Table '3860676529 25' 8-max Seat #2 is the button
Seat 1: Tango Habana (19038 in chips, $3 bounty) 
Seat 2: Dzibiy (17728 in chips, $2.25 bounty) 
Seat 3: félix2011 (9800 in chips, $1.50 bounty) 
Seat 4: PexZz (6746 in chips, $2.62 bounty) 
Seat 5: Hill9595 (3686 in chips, $1.50 bounty) 
Seat 6: motoboy13sp (2304 in chips, $1.50 bounty) 
Seat 7: Raonics3 (3146 in chips, $1.50 bounty) 
Seat 8: Kevin12345Mc (20327 in chips, $3.37 bounty) 
Tango Habana: posts the ante 27
Dzibiy: posts the ante 27
félix2011: posts the ante 27
PexZz: posts the ante 27
Hill9595: posts the ante 27
motoboy13sp: posts the ante 27
Raonics3: posts the ante 27
Kevin12345Mc: posts the ante 27
félix2011: posts small blind 90
PexZz: posts big blind 180
*** HOLE CARDS ***
Dealt to Kevin12345Mc [4s Qc]
Hill9595: folds 
motoboy13sp: folds 
Raonics3: folds 
Kevin12345Mc: folds 
Tango Habana: folds 
Dzibiy has timed out
Dzibiy: folds 
Dzibiy is sitting out
Dzibiy has returned
félix2011: raises 360 to 540
PexZz: calls 360
*** FLOP *** [Ts Th 3s]
félix2011: bets 360
PexZz: calls 360
*** TURN *** [Ts Th 3s] [9c]
félix2011: bets 1260
PexZz: calls 1260
*** RIVER *** [Ts Th 3s 9c] [Ad]
félix2011: checks 
PexZz: bets 4559 and is all-in
félix2011: calls 4559
*** SHOW DOWN ***
PexZz: shows [Qd Js] (a pair of Tens)
félix2011: shows [5h As] (two pair, Aces and Tens)
félix2011 collected 13654 from pot
félix2011 wins $1.31 for eliminating PexZz and their own bounty increases by $1.31 to $2.81
PexZz finished the tournament
*** SUMMARY ***
Total pot 13654 | Rake 0 
Board [Ts Th 3s 9c Ad]
Seat 1: Tango Habana folded before Flop (didn't bet)
Seat 2: Dzibiy (button) folded before Flop (didn't bet)
Seat 3: félix2011 (small blind) showed [5h As] and won (13654) with two pair, Aces and Tens
Seat 4: PexZz (big blind) showed [Qd Js] and lost with a pair of Tens
Seat 5: Hill9595 folded before Flop (didn't bet)
Seat 6: motoboy13sp folded before Flop (didn't bet)
Seat 7: Raonics3 folded before Flop (didn't bet)
Seat 8: Kevin12345Mc folded before Flop (didn't bet)



PokerStars Hand #254986437119: Tournament #3860676529, $0.46+$1.50+$0.24 USD Hold'em No Limit - Level X (90/180) - 2025/02/22 16:04:35 WET [2025/02/22 11:04:35 ET]
Table '3860676529 25' 8-max Seat #3 is the button
Seat 1: Tango Habana (19011 in chips, $3 bounty) 
Seat 2: Dzibiy (17701 in chips, $2.25 bounty) 
Seat 3: félix2011 (16708 in chips, $2.81 bounty) 
Seat 5: Hill9595 (3659 in chips, $1.50 bounty) 
Seat 6: motoboy13sp (2277 in chips, $1.50 bounty) 
Seat 7: Raonics3 (3119 in chips, $1.50 bounty) 
Seat 8: Kevin12345Mc (20300 in chips, $3.37 bounty) 
Tango Habana: posts the ante 27
Dzibiy: posts the ante 27
félix2011: posts the ante 27
Hill9595: posts the ante 27
motoboy13sp: posts the ante 27
Raonics3: posts the ante 27
Kevin12345Mc: posts the ante 27
Hill9595: posts small blind 90
motoboy13sp: posts big blind 180
*** HOLE CARDS ***
Dealt to Kevin12345Mc [Ts 3h]
Raonics3: folds 
Kevin12345Mc: folds 
Tango Habana: folds 
Dzibiy: raises 180 to 360
félix2011: folds 
Hill9595: folds 
gabriel.riv is disconnected 
motoboy13sp: calls 180
*** FLOP *** [3s 9h Td]
motoboy13sp: checks 
Dzibiy: bets 999
motoboy13sp: folds 
Uncalled bet (999) returned to Dzibiy
Dzibiy collected 999 from pot
Dzibiy: doesn't show hand 
*** SUMMARY ***
Total pot 999 | Rake 0 
Board [3s 9h Td]
Seat 1: Tango Habana folded before Flop (didn't bet)
Seat 2: Dzibiy collected (999)
Seat 3: félix2011 (button) folded before Flop (didn't bet)
Seat 5: Hill9595 (small blind) folded before Flop
Seat 6: motoboy13sp (big blind) folded on the Flop
Seat 7: Raonics3 folded before Flop (didn't bet)
Seat 8: Kevin12345Mc folded before Flop (didn't bet)



PokerStars Hand #254986447238: Tournament #3860676529, $0.46+$1.50+$0.24 USD Hold'em No Limit - Level XI (100/200) - 2025/02/22 16:05:19 WET [2025/02/22 11:05:19 ET]
Table '3860676529 25' 8-max Seat #5 is the button
Seat 1: Tango Habana (18984 in chips, $3 bounty) 
Seat 2: Dzibiy (18313 in chips, $2.25 bounty) 
Seat 3: félix2011 (16681 in chips, $2.81 bounty) 
Seat 4: gabriel.riv (3870 in chips, $2.62 bounty) 
Seat 5: Hill9595 (3542 in chips, $1.50 bounty) 
Seat 6: motoboy13sp (1890 in chips, $1.50 bounty) 
Seat 7: Raonics3 (3092 in chips, $1.50 bounty) 
Seat 8: Kevin12345Mc (20273 in chips, $3.37 bounty) 
Tango Habana: posts the ante 30
Dzibiy: posts the ante 30
félix2011: posts the ante 30
gabriel.riv: posts the ante 30
Hill9595: posts the ante 30
motoboy13sp: posts the ante 30
Raonics3: posts the ante 30
Kevin12345Mc: posts the ante 30
motoboy13sp: posts small blind 100
Raonics3: posts big blind 200
*** HOLE CARDS ***
Dealt to Kevin12345Mc [5s 8h]
Kevin12345Mc: folds 
Tango Habana: folds 
Dzibiy: raises 200 to 400
félix2011: folds 
gabriel.riv: folds 
Hill9595: folds 
motoboy13sp: folds 
Raonics3: calls 200
*** FLOP *** [8s 8c Ad]
Raonics3: checks 
Dzibiy has timed out
Dzibiy: checks 
*** TURN *** [8s 8c Ad] [2s]
Raonics3: bets 570
Dzibiy: folds 
Uncalled bet (570) returned to Raonics3
Raonics3 collected 1140 from pot
Raonics3: doesn't show hand 
*** SUMMARY ***
Total pot 1140 | Rake 0 
Board [8s 8c Ad 2s]
Seat 1: Tango Habana folded before Flop (didn't bet)
Seat 2: Dzibiy folded on the Turn
Seat 3: félix2011 folded before Flop (didn't bet)
Seat 4: gabriel.riv folded before Flop (didn't bet)
Seat 5: Hill9595 (button) folded before Flop (didn't bet)
Seat 6: motoboy13sp (small blind) folded before Flop
Seat 7: Raonics3 (big blind) collected (1140)
Seat 8: Kevin12345Mc folded before Flop (didn't bet)



PokerStars Hand #254986458465: Tournament #3860676529, $0.46+$1.50+$0.24 USD Hold'em No Limit - Level XI (100/200) - 2025/02/22 16:06:08 WET [2025/02/22 11:06:08 ET]
Table '3860676529 25' 8-max Seat #6 is the button
Seat 1: Tango Habana (18954 in chips, $3 bounty) 
Seat 2: Dzibiy (17883 in chips, $2.25 bounty) 
Seat 3: félix2011 (16651 in chips, $2.81 bounty) 
Seat 4: gabriel.riv (3840 in chips, $2.62 bounty) 
Seat 5: Hill9595 (3512 in chips, $1.50 bounty) 
Seat 6: motoboy13sp (1760 in chips, $1.50 bounty) 
Seat 7: Raonics3 (3802 in chips, $1.50 bounty) 
Seat 8: Kevin12345Mc (20243 in chips, $3.37 bounty) 
Tango Habana: posts the ante 30
Dzibiy: posts the ante 30
félix2011: posts the ante 30
gabriel.riv: posts the ante 30
Hill9595: posts the ante 30
motoboy13sp: posts the ante 30
Raonics3: posts the ante 30
Kevin12345Mc: posts the ante 30
Raonics3: posts small blind 100
Kevin12345Mc: posts big blind 200
*** HOLE CARDS ***
Dealt to Kevin12345Mc [Ac 2s]
Tango Habana: folds 
Dzibiy: folds 
félix2011: folds 
gabriel.riv: folds 
Hill9595: folds 
motoboy13sp: folds 
Raonics3: raises 3572 to 3772 and is all-in
Kevin12345Mc: calls 3572
*** FLOP *** [Kd Ad 6h]
*** TURN *** [Kd Ad 6h] [Kc]
*** RIVER *** [Kd Ad 6h Kc] [4h]
*** SHOW DOWN ***
Raonics3: shows [Kh Qc] (three of a kind, Kings)
Kevin12345Mc: shows [Ac 2s] (two pair, Aces and Kings)
Raonics3 collected 7784 from pot
*** SUMMARY ***
Total pot 7784 | Rake 0 
Board [Kd Ad 6h Kc 4h]
Seat 1: Tango Habana folded before Flop (didn't bet)
Seat 2: Dzibiy folded before Flop (didn't bet)
Seat 3: félix2011 folded before Flop (didn't bet)
Seat 4: gabriel.riv folded before Flop (didn't bet)
Seat 5: Hill9595 folded before Flop (didn't bet)
Seat 6: motoboy13sp (button) folded before Flop (didn't bet)
Seat 7: Raonics3 (small blind) showed [Kh Qc] and won (7784) with three of a kind, Kings
Seat 8: Kevin12345Mc (big blind) showed [Ac 2s] and lost with two pair, Aces and Kings



PokerStars Hand #254986467684: Tournament #3860676529, $0.46+$1.50+$0.24 USD Hold'em No Limit - Level XI (100/200) - 2025/02/22 16:06:49 WET [2025/02/22 11:06:49 ET]
Table '3860676529 25' 8-max Seat #7 is the button
Seat 1: Tango Habana (18924 in chips, $3 bounty) 
Seat 2: Dzibiy (17853 in chips, $2.25 bounty) 
Seat 3: félix2011 (16621 in chips, $2.81 bounty) 
Seat 4: gabriel.riv (3810 in chips, $2.62 bounty) 
Seat 5: Hill9595 (3482 in chips, $1.50 bounty) 
Seat 6: motoboy13sp (1730 in chips, $1.50 bounty) 
Seat 7: Raonics3 (7784 in chips, $1.50 bounty) 
Seat 8: Kevin12345Mc (16441 in chips, $3.37 bounty) 
Tango Habana: posts the ante 30
Dzibiy: posts the ante 30
félix2011: posts the ante 30
gabriel.riv: posts the ante 30
Hill9595: posts the ante 30
motoboy13sp: posts the ante 30
Raonics3: posts the ante 30
Kevin12345Mc: posts the ante 30
Kevin12345Mc: posts small blind 100
Tango Habana: posts big blind 200
*** HOLE CARDS ***
Dealt to Kevin12345Mc [5c Ac]
Dzibiy has timed out
Dzibiy: folds 
Dzibiy is sitting out
Dzibiy has returned
félix2011: folds 
gabriel.riv: folds 
Hill9595: folds 
motoboy13sp: folds 
Raonics3: raises 200 to 400
Kevin12345Mc: calls 300
Tango Habana: folds 
*** FLOP *** [7s Ah Jc]
Kevin12345Mc: checks 
Raonics3: bets 360
Kevin12345Mc: calls 360
*** TURN *** [7s Ah Jc] [Qd]
Kevin12345Mc: checks 
Raonics3: checks 
*** RIVER *** [7s Ah Jc Qd] [5d]
Kevin12345Mc: bets 1294
Raonics3: folds 
Uncalled bet (1294) returned to Kevin12345Mc
Kevin12345Mc collected 1960 from pot
Kevin12345Mc: doesn't show hand 
*** SUMMARY ***
Total pot 1960 | Rake 0 
Board [7s Ah Jc Qd 5d]
Seat 1: Tango Habana (big blind) folded before Flop
Seat 2: Dzibiy folded before Flop (didn't bet)
Seat 3: félix2011 folded before Flop (didn't bet)
Seat 4: gabriel.riv folded before Flop (didn't bet)
Seat 5: Hill9595 folded before Flop (didn't bet)
Seat 6: motoboy13sp folded before Flop (didn't bet)
Seat 7: Raonics3 (button) folded on the River
Seat 8: Kevin12345Mc (small blind) collected (1960)



PokerStars Hand #254986480142: Tournament #3860676529, $0.46+$1.50+$0.24 USD Hold'em No Limit - Level XI (100/200) - 2025/02/22 16:07:44 WET [2025/02/22 11:07:44 ET]
Table '3860676529 25' 8-max Seat #8 is the button
Seat 1: Tango Habana (18694 in chips, $3 bounty) 
Seat 2: Dzibiy (17823 in chips, $2.25 bounty) 
Seat 3: félix2011 (16591 in chips, $2.81 bounty) 
Seat 4: gabriel.riv (3780 in chips, $2.62 bounty) 
Seat 5: Hill9595 (3452 in chips, $1.50 bounty) 
Seat 6: motoboy13sp (1700 in chips, $1.50 bounty) 
Seat 7: Raonics3 (6994 in chips, $1.50 bounty) 
Seat 8: Kevin12345Mc (17611 in chips, $3.37 bounty) 
Tango Habana: posts the ante 30
Dzibiy: posts the ante 30
félix2011: posts the ante 30
gabriel.riv: posts the ante 30
Hill9595: posts the ante 30
motoboy13sp: posts the ante 30
Raonics3: posts the ante 30
Kevin12345Mc: posts the ante 30
Tango Habana: posts small blind 100
Dzibiy: posts big blind 200
*** HOLE CARDS ***
Dealt to Kevin12345Mc [9h 7s]
félix2011: folds 
gabriel.riv: folds 
Hill9595: folds 
motoboy13sp: folds 
Raonics3: folds 
Kevin12345Mc: folds 
Tango Habana: folds 
Uncalled bet (100) returned to Dzibiy
Dzibiy collected 440 from pot
Dzibiy: doesn't show hand 
*** SUMMARY ***
Total pot 440 | Rake 0 
Seat 1: Tango Habana (small blind) folded before Flop
Seat 2: Dzibiy (big blind) collected (440)
Seat 3: félix2011 folded before Flop (didn't bet)
Seat 4: gabriel.riv folded before Flop (didn't bet)
Seat 5: Hill9595 folded before Flop (didn't bet)
Seat 6: motoboy13sp folded before Flop (didn't bet)
Seat 7: Raonics3 folded before Flop (didn't bet)
Seat 8: Kevin12345Mc (button) folded before Flop (didn't bet)



PokerStars Hand #254986484587: Tournament #3860676529, $0.46+$1.50+$0.24 USD Hold'em No Limit - Level XI (100/200) - 2025/02/22 16:08:04 WET [2025/02/22 11:08:04 ET]
Table '3860676529 25' 8-max Seat #1 is the button
Seat 1: Tango Habana (18564 in chips, $3 bounty) 
Seat 2: Dzibiy (18133 in chips, $2.25 bounty) 
Seat 3: félix2011 (16561 in chips, $2.81 bounty) 
Seat 4: gabriel.riv (3750 in chips, $2.62 bounty) 
Seat 5: Hill9595 (3422 in chips, $1.50 bounty) 
Seat 6: motoboy13sp (1670 in chips, $1.50 bounty) 
Seat 7: Raonics3 (6964 in chips, $1.50 bounty) 
Seat 8: Kevin12345Mc (17581 in chips, $3.37 bounty) 
Tango Habana: posts the ante 30
Dzibiy: posts the ante 30
félix2011: posts the ante 30
gabriel.riv: posts the ante 30
Hill9595: posts the ante 30
motoboy13sp: posts the ante 30
Raonics3: posts the ante 30
Kevin12345Mc: posts the ante 30
Dzibiy: posts small blind 100
félix2011: posts big blind 200
*** HOLE CARDS ***
Dealt to Kevin12345Mc [4c 5d]
gabriel.riv: folds 
Hill9595: folds 
motoboy13sp: folds 
Raonics3: folds 
Kevin12345Mc: folds 
Tango Habana: folds 
Dzibiy: raises 500 to 700
félix2011: calls 500
*** FLOP *** [2d Jh 9d]
Dzibiy: bets 600
félix2011: raises 1000 to 1600
Dzibiy: folds 
Uncalled bet (1000) returned to félix2011
félix2011 collected 2840 from pot
félix2011: doesn't show hand 
*** SUMMARY ***
Total pot 2840 | Rake 0 
Board [2d Jh 9d]
Seat 1: Tango Habana (button) folded before Flop (didn't bet)
Seat 2: Dzibiy (small blind) folded on the Flop
Seat 3: félix2011 (big blind) collected (2840)
Seat 4: gabriel.riv folded before Flop (didn't bet)
Seat 5: Hill9595 folded before Flop (didn't bet)
Seat 6: motoboy13sp folded before Flop (didn't bet)
Seat 7: Raonics3 folded before Flop (didn't bet)
Seat 8: Kevin12345Mc folded before Flop (didn't bet)



PokerStars Hand #254986494134: Tournament #3860676529, $0.46+$1.50+$0.24 USD Hold'em No Limit - Level XI (100/200) - 2025/02/22 16:08:46 WET [2025/02/22 11:08:46 ET]
Table '3860676529 25' 8-max Seat #2 is the button
Seat 1: Tango Habana (18534 in chips, $3 bounty) 
Seat 2: Dzibiy (16803 in chips, $2.25 bounty) 
Seat 3: félix2011 (18071 in chips, $2.81 bounty) 
Seat 4: gabriel.riv (3720 in chips, $2.62 bounty) 
Seat 5: Hill9595 (3392 in chips, $1.50 bounty) 
Seat 6: motoboy13sp (1640 in chips, $1.50 bounty) 
Seat 7: Raonics3 (6934 in chips, $1.50 bounty) 
Seat 8: Kevin12345Mc (17551 in chips, $3.37 bounty) 
Tango Habana: posts the ante 30
Dzibiy: posts the ante 30
félix2011: posts the ante 30
gabriel.riv: posts the ante 30
Hill9595: posts the ante 30
motoboy13sp: posts the ante 30
Raonics3: posts the ante 30
Kevin12345Mc: posts the ante 30
félix2011: posts small blind 100
gabriel.riv: posts big blind 200
*** HOLE CARDS ***
Dealt to Kevin12345Mc [2s 8d]
Hill9595: folds 
motoboy13sp: raises 1410 to 1610 and is all-in
Raonics3: folds 
Kevin12345Mc: folds 
Tango Habana: folds 
Dzibiy: folds 
félix2011: calls 1510
gabriel.riv: folds 
*** FLOP *** [4c 2d 6h]
*** TURN *** [4c 2d 6h] [5s]
*** RIVER *** [4c 2d 6h 5s] [8c]
*** SHOW DOWN ***
félix2011: shows [Td Ad] (high card Ace)
motoboy13sp: shows [Kd As] (high card Ace - King kicker)
motoboy13sp collected 3660 from pot
*** SUMMARY ***
Total pot 3660 | Rake 0 
Board [4c 2d 6h 5s 8c]
Seat 1: Tango Habana folded before Flop (didn't bet)
Seat 2: Dzibiy (button) folded before Flop (didn't bet)
Seat 3: félix2011 (small blind) showed [Td Ad] and lost with high card Ace
Seat 4: gabriel.riv (big blind) folded before Flop
Seat 5: Hill9595 folded before Flop (didn't bet)
Seat 6: motoboy13sp showed [Kd As] and won (3660) with high card Ace
Seat 7: Raonics3 folded before Flop (didn't bet)
Seat 8: Kevin12345Mc folded before Flop (didn't bet)



PokerStars Hand #254986500349: Tournament #3860676529, $0.46+$1.50+$0.24 USD Hold'em No Limit - Level XI (100/200) - 2025/02/22 16:09:13 WET [2025/02/22 11:09:13 ET]
Table '3860676529 25' 8-max Seat #3 is the button
Seat 1: Tango Habana (18504 in chips, $3 bounty) 
Seat 2: Dzibiy (16773 in chips, $2.25 bounty) 
Seat 3: félix2011 (16431 in chips, $2.81 bounty) 
Seat 4: gabriel.riv (3490 in chips, $2.62 bounty) 
Seat 5: Hill9595 (3362 in chips, $1.50 bounty) 
Seat 6: motoboy13sp (3660 in chips, $1.50 bounty) 
Seat 7: Raonics3 (6904 in chips, $1.50 bounty) 
Seat 8: Kevin12345Mc (17521 in chips, $3.37 bounty) 
Tango Habana: posts the ante 30
Dzibiy: posts the ante 30
félix2011: posts the ante 30
gabriel.riv: posts the ante 30
Hill9595: posts the ante 30
motoboy13sp: posts the ante 30
Raonics3: posts the ante 30
Kevin12345Mc: posts the ante 30
gabriel.riv: posts small blind 100
Hill9595: posts big blind 200
*** HOLE CARDS ***
Dealt to Kevin12345Mc [As 7d]
motoboy13sp: folds 
Raonics3: folds 
Kevin12345Mc: folds 
Tango Habana: folds 
Dzibiy: folds 
félix2011: folds 
gabriel.riv: raises 3260 to 3460 and is all-in
Hill9595: folds 
Uncalled bet (3260) returned to gabriel.riv
gabriel.riv collected 640 from pot
gabriel.riv: doesn't show hand 
*** SUMMARY ***
Total pot 640 | Rake 0 
Seat 1: Tango Habana folded before Flop (didn't bet)
Seat 2: Dzibiy folded before Flop (didn't bet)
Seat 3: félix2011 (button) folded before Flop (didn't bet)
Seat 4: gabriel.riv (small blind) collected (640)
Seat 5: Hill9595 (big blind) folded before Flop
Seat 6: motoboy13sp folded before Flop (didn't bet)
Seat 7: Raonics3 folded before Flop (didn't bet)
Seat 8: Kevin12345Mc folded before Flop (didn't bet)



PokerStars Hand #254986507507: Tournament #3860676529, $0.46+$1.50+$0.24 USD Hold'em No Limit - Level XI (100/200) - 2025/02/22 16:09:45 WET [2025/02/22 11:09:45 ET]
Table '3860676529 25' 8-max Seat #4 is the button
Seat 1: Tango Habana (18474 in chips, $3 bounty) 
Seat 2: Dzibiy (16743 in chips, $2.25 bounty) 
Seat 3: félix2011 (16401 in chips, $2.81 bounty) 
Seat 4: gabriel.riv (3900 in chips, $2.62 bounty) 
Seat 5: Hill9595 (3132 in chips, $1.50 bounty) 
Seat 6: motoboy13sp (3630 in chips, $1.50 bounty) 
Seat 7: Raonics3 (6874 in chips, $1.50 bounty) 
Seat 8: Kevin12345Mc (17491 in chips, $3.37 bounty) 
Tango Habana: posts the ante 30
Dzibiy: posts the ante 30
félix2011: posts the ante 30
gabriel.riv: posts the ante 30
Hill9595: posts the ante 30
motoboy13sp: posts the ante 30
Raonics3: posts the ante 30
Kevin12345Mc: posts the ante 30
Hill9595: posts small blind 100
motoboy13sp: posts big blind 200
*** HOLE CARDS ***
Dealt to Kevin12345Mc [7s As]
Raonics3: raises 200 to 400
Kevin12345Mc: calls 400
Tango Habana: calls 400
Dzibiy: folds 
félix2011: folds 
gabriel.riv: folds 
Hill9595: folds 
motoboy13sp: calls 200
*** FLOP *** [Qc 3h Jc]
motoboy13sp: checks 
Raonics3: checks 
Kevin12345Mc: checks 
Tango Habana: checks 
*** TURN *** [Qc 3h Jc] [3c]
motoboy13sp: checks 
Raonics3: checks 
Kevin12345Mc: checks 
Tango Habana: checks 
*** RIVER *** [Qc 3h Jc 3c] [4d]
motoboy13sp: checks 
Raonics3: checks 
Kevin12345Mc: checks 
Tango Habana: checks 
*** SHOW DOWN ***
motoboy13sp: shows [Ks Jd] (two pair, Jacks and Threes)
Raonics3: mucks hand 
Kevin12345Mc: mucks hand 
Tango Habana: mucks hand 
motoboy13sp collected 1940 from pot
*** SUMMARY ***
Total pot 1940 | Rake 0 
Board [Qc 3h Jc 3c 4d]
Seat 1: Tango Habana mucked [Kh Th]
Seat 2: Dzibiy folded before Flop (didn't bet)
Seat 3: félix2011 folded before Flop (didn't bet)
Seat 4: gabriel.riv (button) folded before Flop (didn't bet)
Seat 5: Hill9595 (small blind) folded before Flop
Seat 6: motoboy13sp (big blind) showed [Ks Jd] and won (1940) with two pair, Jacks and Threes
Seat 7: Raonics3 mucked [5d 5h]
Seat 8: Kevin12345Mc mucked [7s As]



PokerStars Hand #254986523098: Tournament #3860676529, $0.46+$1.50+$0.24 USD Hold'em No Limit - Level XI (100/200) - 2025/02/22 16:10:54 WET [2025/02/22 11:10:54 ET]
Table '3860676529 25' 8-max Seat #5 is the button
Seat 1: Tango Habana (18044 in chips, $3 bounty) 
Seat 2: Dzibiy (16713 in chips, $2.25 bounty) 
Seat 3: félix2011 (16371 in chips, $2.81 bounty) 
Seat 4: gabriel.riv (3870 in chips, $2.62 bounty) 
Seat 5: Hill9595 (3002 in chips, $1.50 bounty) 
Seat 6: motoboy13sp (5140 in chips, $1.50 bounty) 
Seat 7: Raonics3 (6444 in chips, $1.50 bounty) 
Seat 8: Kevin12345Mc (17061 in chips, $3.37 bounty) 
Tango Habana: posts the ante 30
Dzibiy: posts the ante 30
félix2011: posts the ante 30
gabriel.riv: posts the ante 30
Hill9595: posts the ante 30
motoboy13sp: posts the ante 30
Raonics3: posts the ante 30
Kevin12345Mc: posts the ante 30
motoboy13sp: posts small blind 100
Raonics3: posts big blind 200
*** HOLE CARDS ***
Dealt to Kevin12345Mc [2h 3d]
Kevin12345Mc: folds 
Tango Habana: folds 
Dzibiy: folds 
félix2011: folds 
gabriel.riv: folds 
Hill9595: raises 2772 to 2972 and is all-in
motoboy13sp: folds 
Raonics3: folds 
Uncalled bet (2772) returned to Hill9595
Hill9595 collected 740 from pot
Hill9595: doesn't show hand 
*** SUMMARY ***
Total pot 740 | Rake 0 
Seat 1: Tango Habana folded before Flop (didn't bet)
Seat 2: Dzibiy folded before Flop (didn't bet)
Seat 3: félix2011 folded before Flop (didn't bet)
Seat 4: gabriel.riv folded before Flop (didn't bet)
Seat 5: Hill9595 (button) collected (740)
Seat 6: motoboy13sp (small blind) folded before Flop
Seat 7: Raonics3 (big blind) folded before Flop
Seat 8: Kevin12345Mc folded before Flop (didn't bet)



PokerStars Hand #254986532790: Tournament #3860676529, $0.46+$1.50+$0.24 USD Hold'em No Limit - Level XI (100/200) - 2025/02/22 16:11:37 WET [2025/02/22 11:11:37 ET]
Table '3860676529 25' 8-max Seat #6 is the button
Seat 1: Tango Habana (18014 in chips, $3 bounty) 
Seat 2: Dzibiy (16683 in chips, $2.25 bounty) 
Seat 3: félix2011 (16341 in chips, $2.81 bounty) 
Seat 4: gabriel.riv (3840 in chips, $2.62 bounty) 
Seat 5: Hill9595 (3512 in chips, $1.50 bounty) 
Seat 6: motoboy13sp (5010 in chips, $1.50 bounty) 
Seat 7: Raonics3 (6214 in chips, $1.50 bounty) 
Seat 8: Kevin12345Mc (17031 in chips, $3.37 bounty) 
Tango Habana: posts the ante 30
Dzibiy: posts the ante 30
félix2011: posts the ante 30
gabriel.riv: posts the ante 30
Hill9595: posts the ante 30
motoboy13sp: posts the ante 30
Raonics3: posts the ante 30
Kevin12345Mc: posts the ante 30
Raonics3: posts small blind 100
Kevin12345Mc: posts big blind 200
*** HOLE CARDS ***
Dealt to Kevin12345Mc [Ts 4c]
Tango Habana: folds 
Dzibiy: folds 
félix2011: folds 
gabriel.riv: folds 
Hill9595: folds 
motoboy13sp: raises 200 to 400
Raonics3: folds 
Kevin12345Mc: folds 
Uncalled bet (200) returned to motoboy13sp
motoboy13sp collected 740 from pot
motoboy13sp: doesn't show hand 
*** SUMMARY ***
Total pot 740 | Rake 0 
Seat 1: Tango Habana folded before Flop (didn't bet)
Seat 2: Dzibiy folded before Flop (didn't bet)
Seat 3: félix2011 folded before Flop (didn't bet)
Seat 4: gabriel.riv folded before Flop (didn't bet)
Seat 5: Hill9595 folded before Flop (didn't bet)
Seat 6: motoboy13sp (button) collected (740)
Seat 7: Raonics3 (small blind) folded before Flop
Seat 8: Kevin12345Mc (big blind) folded before Flop



PokerStars Hand #254986540417: Tournament #3860676529, $0.46+$1.50+$0.24 USD Hold'em No Limit - Level XI (100/200) - 2025/02/22 16:12:10 WET [2025/02/22 11:12:10 ET]
Table '3860676529 25' 8-max Seat #7 is the button
Seat 1: Tango Habana (17984 in chips, $3 bounty) 
Seat 2: Dzibiy (16653 in chips, $2.25 bounty) 
Seat 3: félix2011 (16311 in chips, $2.81 bounty) 
Seat 4: gabriel.riv (3810 in chips, $2.62 bounty) 
Seat 5: Hill9595 (3482 in chips, $1.50 bounty) 
Seat 6: motoboy13sp (5520 in chips, $1.50 bounty) 
Seat 7: Raonics3 (6084 in chips, $1.50 bounty) 
Seat 8: Kevin12345Mc (16801 in chips, $3.37 bounty) 
Tango Habana: posts the ante 30
Dzibiy: posts the ante 30
félix2011: posts the ante 30
gabriel.riv: posts the ante 30
Hill9595: posts the ante 30
motoboy13sp: posts the ante 30
Raonics3: posts the ante 30
Kevin12345Mc: posts the ante 30
Kevin12345Mc: posts small blind 100
Tango Habana: posts big blind 200
*** HOLE CARDS ***
Dealt to Kevin12345Mc [8d Jd]
Dzibiy: folds 
félix2011: folds 
gabriel.riv: raises 400 to 600
Hill9595: folds 
motoboy13sp: folds 
Raonics3: folds 
Kevin12345Mc: folds 
Tango Habana: folds 
Uncalled bet (400) returned to gabriel.riv
gabriel.riv collected 740 from pot
gabriel.riv: doesn't show hand 
*** SUMMARY ***
Total pot 740 | Rake 0 
Seat 1: Tango Habana (big blind) folded before Flop
Seat 2: Dzibiy folded before Flop (didn't bet)
Seat 3: félix2011 folded before Flop (didn't bet)
Seat 4: gabriel.riv collected (740)
Seat 5: Hill9595 folded before Flop (didn't bet)
Seat 6: motoboy13sp folded before Flop (didn't bet)
Seat 7: Raonics3 (button) folded before Flop (didn't bet)
Seat 8: Kevin12345Mc (small blind) folded before Flop



PokerStars Hand #254986549825: Tournament #3860676529, $0.46+$1.50+$0.24 USD Hold'em No Limit - Level XI (100/200) - 2025/02/22 16:12:50 WET [2025/02/22 11:12:50 ET]
Table '3860676529 25' 8-max Seat #8 is the button
Seat 1: Tango Habana (17754 in chips, $3 bounty) 
Seat 2: Dzibiy (16623 in chips, $2.25 bounty) 
Seat 3: félix2011 (16281 in chips, $2.81 bounty) 
Seat 4: gabriel.riv (4320 in chips, $2.62 bounty) 
Seat 5: Hill9595 (3452 in chips, $1.50 bounty) 
Seat 6: motoboy13sp (5490 in chips, $1.50 bounty) 
Seat 7: Raonics3 (6054 in chips, $1.50 bounty) 
Seat 8: Kevin12345Mc (16671 in chips, $3.37 bounty) 
Tango Habana: posts the ante 30
Dzibiy: posts the ante 30
félix2011: posts the ante 30
gabriel.riv: posts the ante 30
Hill9595: posts the ante 30
motoboy13sp: posts the ante 30
Raonics3: posts the ante 30
Kevin12345Mc: posts the ante 30
Tango Habana: posts small blind 100
Dzibiy: posts big blind 200
*** HOLE CARDS ***
Dealt to Kevin12345Mc [As Js]
félix2011: raises 220 to 420
gabriel.riv: calls 420
Hill9595: folds 
motoboy13sp: folds 
Raonics3: folds 
Kevin12345Mc: calls 420
Tango Habana: folds 
Dzibiy: calls 220
*** FLOP *** [8d Jd 8s]
Dzibiy: checks 
félix2011: checks 
gabriel.riv: checks 
Kevin12345Mc: bets 1333
Dzibiy: folds 
félix2011: calls 1333
gabriel.riv: calls 1333
*** TURN *** [8d Jd 8s] [Ts]
félix2011: bets 2800
gabriel.riv: calls 2537 and is all-in
Kevin12345Mc: raises 12088 to 14888 and is all-in
félix2011: calls 11698 and is all-in
Uncalled bet (390) returned to Kevin12345Mc
*** RIVER *** [8d Jd 8s Ts] [4c]
*** SHOW DOWN ***
félix2011: shows [Th Td] (a full house, Tens full of Eights)
Kevin12345Mc: shows [As Js] (two pair, Jacks and Eights)
félix2011 collected 23922 from side pot
gabriel.riv: shows [Ac 8h] (three of a kind, Eights)
félix2011 collected 13630 from main pot
félix2011 wins $1.31 for eliminating gabriel.riv and their own bounty increases by $1.31 to $4.12
gabriel.riv finished the tournament
*** SUMMARY ***
Total pot 37552 Main pot 13630. Side pot 23922. | Rake 0 
Board [8d Jd 8s Ts 4c]
Seat 1: Tango Habana (small blind) folded before Flop
Seat 2: Dzibiy (big blind) folded on the Flop
Seat 3: félix2011 showed [Th Td] and won (37552) with a full house, Tens full of Eights
Seat 4: gabriel.riv showed [Ac 8h] and lost with three of a kind, Eights
Seat 5: Hill9595 folded before Flop (didn't bet)
Seat 6: motoboy13sp folded before Flop (didn't bet)
Seat 7: Raonics3 folded before Flop (didn't bet)
Seat 8: Kevin12345Mc (button) showed [As Js] and lost with two pair, Jacks and Eights



PokerStars Hand #254986570484: Tournament #3860676529, $0.46+$1.50+$0.24 USD Hold'em No Limit - Level XII (125/250) - 2025/02/22 16:14:19 WET [2025/02/22 11:14:19 ET]
Table '3860676529 25' 8-max Seat #1 is the button
Seat 1: Tango Habana (17624 in chips, $3 bounty) 
Seat 2: Dzibiy (16173 in chips, $2.25 bounty) 
Seat 3: félix2011 (37552 in chips, $4.12 bounty) 
Seat 5: Hill9595 (3422 in chips, $1.50 bounty) 
Seat 6: motoboy13sp (5460 in chips, $1.50 bounty) 
Seat 7: Raonics3 (6024 in chips, $1.50 bounty) 
Seat 8: Kevin12345Mc (390 in chips, $3.37 bounty) 
Tango Habana: posts the ante 36
Dzibiy: posts the ante 36
félix2011: posts the ante 36
Hill9595: posts the ante 36
motoboy13sp: posts the ante 36
Raonics3: posts the ante 36
Kevin12345Mc: posts the ante 36
Dzibiy: posts small blind 125
félix2011: posts big blind 250
*** HOLE CARDS ***
Dealt to Kevin12345Mc [Qd 9c]
Hill9595: folds 
HeitorKxote is disconnected 
motoboy13sp: folds 
Raonics3: folds 
Kevin12345Mc: raises 104 to 354 and is all-in
Tango Habana: calls 354
Dzibiy: folds 
félix2011: calls 104
*** FLOP *** [5d 8d Qs]
félix2011: checks 
Tango Habana: checks 
*** TURN *** [5d 8d Qs] [5s]
félix2011: checks 
Tango Habana: checks 
*** RIVER *** [5d 8d Qs 5s] [2d]
félix2011: checks 
Tango Habana: checks 
*** SHOW DOWN ***
félix2011: shows [3c 7d] (a pair of Fives)
Kevin12345Mc: shows [Qd 9c] (two pair, Queens and Fives)
Tango Habana: mucks hand 
Kevin12345Mc collected 1439 from pot
*** SUMMARY ***
Total pot 1439 | Rake 0 
Board [5d 8d Qs 5s 2d]
Seat 1: Tango Habana (button) mucked [Tc Jd]
Seat 2: Dzibiy (small blind) folded before Flop
Seat 3: félix2011 (big blind) showed [3c 7d] and lost with a pair of Fives
Seat 5: Hill9595 folded before Flop (didn't bet)
Seat 6: motoboy13sp folded before Flop (didn't bet)
Seat 7: Raonics3 folded before Flop (didn't bet)
Seat 8: Kevin12345Mc showed [Qd 9c] and won (1439) with two pair, Queens and Fives



PokerStars Hand #254986581011: Tournament #3860676529, $0.46+$1.50+$0.24 USD Hold'em No Limit - Level XII (125/250) - 2025/02/22 16:15:05 WET [2025/02/22 11:15:05 ET]
Table '3860676529 25' 8-max Seat #2 is the button
Seat 1: Tango Habana (17234 in chips, $3 bounty) 
Seat 2: Dzibiy (16012 in chips, $2.25 bounty) 
Seat 3: félix2011 (37162 in chips, $4.12 bounty) 
Seat 4: HeitorKxote (5000 in chips, $1.50 bounty) 
Seat 5: Hill9595 (3386 in chips, $1.50 bounty) 
Seat 6: motoboy13sp (5424 in chips, $1.50 bounty) 
Seat 7: Raonics3 (5988 in chips, $1.50 bounty) 
Seat 8: Kevin12345Mc (1439 in chips, $3.37 bounty) 
Tango Habana: posts the ante 36
Dzibiy: posts the ante 36
félix2011: posts the ante 36
HeitorKxote: posts the ante 36
Hill9595: posts the ante 36
motoboy13sp: posts the ante 36
Raonics3: posts the ante 36
Kevin12345Mc: posts the ante 36
félix2011: posts small blind 125
HeitorKxote: posts big blind 250
*** HOLE CARDS ***
Dealt to Kevin12345Mc [3d 6s]
Hill9595: raises 3100 to 3350 and is all-in
motoboy13sp: folds 
Raonics3: folds 
Kevin12345Mc: folds 
Tango Habana: folds 
Dzibiy: folds 
félix2011: folds 
HeitorKxote: folds 
Uncalled bet (3100) returned to Hill9595
Hill9595 collected 913 from pot
Hill9595: doesn't show hand 
*** SUMMARY ***
Total pot 913 | Rake 0 
Seat 1: Tango Habana folded before Flop (didn't bet)
Seat 2: Dzibiy (button) folded before Flop (didn't bet)
Seat 3: félix2011 (small blind) folded before Flop
Seat 4: HeitorKxote (big blind) folded before Flop
Seat 5: Hill9595 collected (913)
Seat 6: motoboy13sp folded before Flop (didn't bet)
Seat 7: Raonics3 folded before Flop (didn't bet)
Seat 8: Kevin12345Mc folded before Flop (didn't bet)



PokerStars Hand #254986587062: Tournament #3860676529, $0.46+$1.50+$0.24 USD Hold'em No Limit - Level XII (125/250) - 2025/02/22 16:15:31 WET [2025/02/22 11:15:31 ET]
Table '3860676529 25' 8-max Seat #3 is the button
Seat 1: Tango Habana (17198 in chips, $3 bounty) 
Seat 2: Dzibiy (15976 in chips, $2.25 bounty) 
Seat 3: félix2011 (37001 in chips, $4.12 bounty) 
Seat 4: HeitorKxote (4714 in chips, $1.50 bounty) 
Seat 5: Hill9595 (4013 in chips, $1.50 bounty) 
Seat 6: motoboy13sp (5388 in chips, $1.50 bounty) 
Seat 7: Raonics3 (5952 in chips, $1.50 bounty) 
Seat 8: Kevin12345Mc (1403 in chips, $3.37 bounty) 
Tango Habana: posts the ante 36
Dzibiy: posts the ante 36
félix2011: posts the ante 36
HeitorKxote: posts the ante 36
Hill9595: posts the ante 36
motoboy13sp: posts the ante 36
Raonics3: posts the ante 36
Kevin12345Mc: posts the ante 36
HeitorKxote: posts small blind 125
Hill9595: posts big blind 250
*** HOLE CARDS ***
Dealt to Kevin12345Mc [Js Kc]
motoboy13sp: raises 250 to 500
Raonics3: folds 
Kevin12345Mc: raises 867 to 1367 and is all-in
Tango Habana: folds 
Dzibiy: folds 
félix2011: folds 
HeitorKxote: raises 3311 to 4678 and is all-in
Hill9595: folds 
motoboy13sp: calls 4178
*** FLOP *** [2s Jd Jc]
*** TURN *** [2s Jd Jc] [9h]
*** RIVER *** [2s Jd Jc 9h] [4h]
*** SHOW DOWN ***
HeitorKxote: shows [5s Ah] (a pair of Jacks)
motoboy13sp: shows [6s As] (a pair of Jacks - Ace+Nine+Six kicker)
motoboy13sp collected 6622 from side pot
Kevin12345Mc: shows [Js Kc] (three of a kind, Jacks)
Kevin12345Mc collected 4639 from main pot
motoboy13sp wins $0.75 for eliminating HeitorKxote and their own bounty increases by $0.75 to $2.25
HeitorKxote finished the tournament
*** SUMMARY ***
Total pot 11261 Main pot 4639. Side pot 6622. | Rake 0 
Board [2s Jd Jc 9h 4h]
Seat 1: Tango Habana folded before Flop (didn't bet)
Seat 2: Dzibiy folded before Flop (didn't bet)
Seat 3: félix2011 (button) folded before Flop (didn't bet)
Seat 4: HeitorKxote (small blind) showed [5s Ah] and lost with a pair of Jacks
Seat 5: Hill9595 (big blind) folded before Flop
Seat 6: motoboy13sp showed [6s As] and won (6622) with a pair of Jacks
Seat 7: Raonics3 folded before Flop (didn't bet)
Seat 8: Kevin12345Mc showed [Js Kc] and won (4639) with three of a kind, Jacks



PokerStars Hand #254986595271: Tournament #3860676529, $0.46+$1.50+$0.24 USD Hold'em No Limit - Level XII (125/250) - 2025/02/22 16:16:05 WET [2025/02/22 11:16:05 ET]
Table '3860676529 25' 8-max Seat #5 is the button
Seat 1: Tango Habana (17162 in chips, $3 bounty) 
Seat 2: Dzibiy (15940 in chips, $2.25 bounty) 
Seat 3: félix2011 (36965 in chips, $4.12 bounty) 
Seat 5: Hill9595 (3727 in chips, $1.50 bounty) 
Seat 6: motoboy13sp (7296 in chips, $2.25 bounty) 
Seat 7: Raonics3 (5916 in chips, $1.50 bounty) 
Seat 8: Kevin12345Mc (4639 in chips, $3.37 bounty) 
Tango Habana: posts the ante 36
Dzibiy: posts the ante 36
félix2011: posts the ante 36
Hill9595: posts the ante 36
motoboy13sp: posts the ante 36
Raonics3: posts the ante 36
Kevin12345Mc: posts the ante 36
motoboy13sp: posts small blind 125
Raonics3: posts big blind 250
*** HOLE CARDS ***
Dealt to Kevin12345Mc [Qh Js]
Kevin12345Mc: folds 
Tango Habana: folds 
Hater RIP is disconnected 
Dzibiy: folds 
félix2011: raises 275 to 525
Hill9595: folds 
motoboy13sp: folds 
Raonics3: calls 275
*** FLOP *** [5s Jc 4d]
Raonics3: checks 
félix2011: bets 471
Raonics3: folds 
Uncalled bet (471) returned to félix2011
félix2011 collected 1427 from pot
félix2011: doesn't show hand 
*** SUMMARY ***
Total pot 1427 | Rake 0 
Board [5s Jc 4d]
Seat 1: Tango Habana folded before Flop (didn't bet)
Seat 2: Dzibiy folded before Flop (didn't bet)
Seat 3: félix2011 collected (1427)
Seat 5: Hill9595 (button) folded before Flop (didn't bet)
Seat 6: motoboy13sp (small blind) folded before Flop
Seat 7: Raonics3 (big blind) folded on the Flop
Seat 8: Kevin12345Mc folded before Flop (didn't bet)



PokerStars Hand #254986605852: Tournament #3860676529, $0.46+$1.50+$0.24 USD Hold'em No Limit - Level XII (125/250) - 2025/02/22 16:16:51 WET [2025/02/22 11:16:51 ET]
Table '3860676529 25' 8-max Seat #6 is the button
Seat 1: Tango Habana (17126 in chips, $3 bounty) 
Seat 2: Dzibiy (15904 in chips, $2.25 bounty) 
Seat 3: félix2011 (37831 in chips, $4.12 bounty) 
Seat 4: Hater RIP (14857 in chips, $4.12 bounty) 
Seat 5: Hill9595 (3691 in chips, $1.50 bounty) 
Seat 6: motoboy13sp (7135 in chips, $2.25 bounty) 
Seat 7: Raonics3 (5355 in chips, $1.50 bounty) 
Seat 8: Kevin12345Mc (4603 in chips, $3.37 bounty) 
Tango Habana: posts the ante 36
Dzibiy: posts the ante 36
félix2011: posts the ante 36
Hater RIP: posts the ante 36
Hill9595: posts the ante 36
motoboy13sp: posts the ante 36
Raonics3: posts the ante 36
Kevin12345Mc: posts the ante 36
Raonics3: posts small blind 125
Kevin12345Mc: posts big blind 250
*** HOLE CARDS ***
Dealt to Kevin12345Mc [5h 2c]
Tango Habana: folds 
Dzibiy has timed out
Dzibiy: folds 
Dzibiy is sitting out
Dzibiy has returned
félix2011: folds 
Hater RIP: folds 
Hill9595: folds 
motoboy13sp: raises 250 to 500
Raonics3: folds 
Kevin12345Mc: folds 
Uncalled bet (250) returned to motoboy13sp
motoboy13sp collected 913 from pot
motoboy13sp: doesn't show hand 
*** SUMMARY ***
Total pot 913 | Rake 0 
Seat 1: Tango Habana folded before Flop (didn't bet)
Seat 2: Dzibiy folded before Flop (didn't bet)
Seat 3: félix2011 folded before Flop (didn't bet)
Seat 4: Hater RIP folded before Flop (didn't bet)
Seat 5: Hill9595 folded before Flop (didn't bet)
Seat 6: motoboy13sp (button) collected (913)
Seat 7: Raonics3 (small blind) folded before Flop
Seat 8: Kevin12345Mc (big blind) folded before Flop



PokerStars Hand #254986613555: Tournament #3860676529, $0.46+$1.50+$0.24 USD Hold'em No Limit - Level XII (125/250) - 2025/02/22 16:17:23 WET [2025/02/22 11:17:23 ET]
Table '3860676529 25' 8-max Seat #7 is the button
Seat 1: Tango Habana (17090 in chips, $3 bounty) 
Seat 2: Dzibiy (15868 in chips, $2.25 bounty) 
Seat 3: félix2011 (37795 in chips, $4.12 bounty) 
Seat 4: Hater RIP (14821 in chips, $4.12 bounty) 
Seat 5: Hill9595 (3655 in chips, $1.50 bounty) 
Seat 6: motoboy13sp (7762 in chips, $2.25 bounty) 
Seat 7: Raonics3 (5194 in chips, $1.50 bounty) 
Seat 8: Kevin12345Mc (4317 in chips, $3.37 bounty) 
Tango Habana: posts the ante 36
Dzibiy: posts the ante 36
félix2011: posts the ante 36
Hater RIP: posts the ante 36
Hill9595: posts the ante 36
motoboy13sp: posts the ante 36
Raonics3: posts the ante 36
Kevin12345Mc: posts the ante 36
Kevin12345Mc: posts small blind 125
Tango Habana: posts big blind 250
*** HOLE CARDS ***
Dealt to Kevin12345Mc [3s Td]
Dzibiy: folds 
félix2011: raises 275 to 525
Hater RIP: folds 
Hill9595: folds 
motoboy13sp: folds 
Raonics3: folds 
Kevin12345Mc: folds 
Tango Habana: folds 
Uncalled bet (275) returned to félix2011
félix2011 collected 913 from pot
félix2011: doesn't show hand 
*** SUMMARY ***
Total pot 913 | Rake 0 
Seat 1: Tango Habana (big blind) folded before Flop
Seat 2: Dzibiy folded before Flop (didn't bet)
Seat 3: félix2011 collected (913)
Seat 4: Hater RIP folded before Flop (didn't bet)
Seat 5: Hill9595 folded before Flop (didn't bet)
Seat 6: motoboy13sp folded before Flop (didn't bet)
Seat 7: Raonics3 (button) folded before Flop (didn't bet)
Seat 8: Kevin12345Mc (small blind) folded before Flop



PokerStars Hand #254986621889: Tournament #3860676529, $0.46+$1.50+$0.24 USD Hold'em No Limit - Level XII (125/250) - 2025/02/22 16:18:00 WET [2025/02/22 11:18:00 ET]
Table '3860676529 25' 8-max Seat #8 is the button
Seat 1: Tango Habana (16804 in chips, $3 bounty) 
Seat 2: Dzibiy (15832 in chips, $2.25 bounty) 
Seat 3: félix2011 (38422 in chips, $4.12 bounty) 
Seat 4: Hater RIP (14785 in chips, $4.12 bounty) 
Seat 5: Hill9595 (3619 in chips, $1.50 bounty) 
Seat 6: motoboy13sp (7726 in chips, $2.25 bounty) 
Seat 7: Raonics3 (5158 in chips, $1.50 bounty) 
Seat 8: Kevin12345Mc (4156 in chips, $3.37 bounty) 
Tango Habana: posts the ante 36
Dzibiy: posts the ante 36
félix2011: posts the ante 36
Hater RIP: posts the ante 36
Hill9595: posts the ante 36
motoboy13sp: posts the ante 36
Raonics3: posts the ante 36
Kevin12345Mc: posts the ante 36
Tango Habana: posts small blind 125
Dzibiy: posts big blind 250
*** HOLE CARDS ***
Dealt to Kevin12345Mc [Kc 2s]
félix2011: folds 
Hater RIP: folds 
Hill9595: raises 3333 to 3583 and is all-in
motoboy13sp: folds 
Raonics3: folds 
Kevin12345Mc: folds 
Tango Habana: folds 
Dzibiy: calls 3333
*** FLOP *** [Tc 8h 3h]
*** TURN *** [Tc 8h 3h] [Qh]
*** RIVER *** [Tc 8h 3h Qh] [Td]
*** SHOW DOWN ***
Dzibiy: shows [Ad As] (two pair, Aces and Tens)
Hill9595: shows [Js Ts] (three of a kind, Tens)
Hill9595 collected 7579 from pot
*** SUMMARY ***
Total pot 7579 | Rake 0 
Board [Tc 8h 3h Qh Td]
Seat 1: Tango Habana (small blind) folded before Flop
Seat 2: Dzibiy (big blind) showed [Ad As] and lost with two pair, Aces and Tens
Seat 3: félix2011 folded before Flop (didn't bet)
Seat 4: Hater RIP folded before Flop (didn't bet)
Seat 5: Hill9595 showed [Js Ts] and won (7579) with three of a kind, Tens
Seat 6: motoboy13sp folded before Flop (didn't bet)
Seat 7: Raonics3 folded before Flop (didn't bet)
Seat 8: Kevin12345Mc (button) folded before Flop (didn't bet)



PokerStars Hand #254986629288: Tournament #3860676529, $0.46+$1.50+$0.24 USD Hold'em No Limit - Level XII (125/250) - 2025/02/22 16:18:32 WET [2025/02/22 11:18:32 ET]
Table '3860676529 25' 8-max Seat #1 is the button
Seat 1: Tango Habana (16643 in chips, $3 bounty) 
Seat 2: Dzibiy (12213 in chips, $2.25 bounty) 
Seat 3: félix2011 (38386 in chips, $4.12 bounty) 
Seat 4: Hater RIP (14749 in chips, $4.12 bounty) 
Seat 5: Hill9595 (7579 in chips, $1.50 bounty) 
Seat 6: motoboy13sp (7690 in chips, $2.25 bounty) 
Seat 7: Raonics3 (5122 in chips, $1.50 bounty) 
Seat 8: Kevin12345Mc (4120 in chips, $3.37 bounty) 
Tango Habana: posts the ante 36
Dzibiy: posts the ante 36
félix2011: posts the ante 36
Hater RIP: posts the ante 36
Hill9595: posts the ante 36
motoboy13sp: posts the ante 36
Raonics3: posts the ante 36
Kevin12345Mc: posts the ante 36
Dzibiy: posts small blind 125
félix2011: posts big blind 250
*** HOLE CARDS ***
Dealt to Kevin12345Mc [Qh As]
Hater RIP: folds 
Hill9595: folds 
motoboy13sp: folds 
Raonics3: folds 
Kevin12345Mc: raises 250 to 500
Tango Habana: calls 500
Dzibiy has timed out
Dzibiy: folds 
Dzibiy is sitting out
Dzibiy has returned
félix2011: raises 1250 to 1750
Kevin12345Mc: raises 2334 to 4084 and is all-in
Tango Habana: folds 
félix2011: calls 2334
*** FLOP *** [Kd Tc 5d]
*** TURN *** [Kd Tc 5d] [7d]
*** RIVER *** [Kd Tc 5d 7d] [4h]
*** SHOW DOWN ***
félix2011: shows [Ah 6s] (high card Ace)
Kevin12345Mc: shows [Qh As] (high card Ace - King+Queen kicker)
Kevin12345Mc collected 9081 from pot
*** SUMMARY ***
Total pot 9081 | Rake 0 
Board [Kd Tc 5d 7d 4h]
Seat 1: Tango Habana (button) folded before Flop
Seat 2: Dzibiy (small blind) folded before Flop
Seat 3: félix2011 (big blind) showed [Ah 6s] and lost with high card Ace
Seat 4: Hater RIP folded before Flop (didn't bet)
Seat 5: Hill9595 folded before Flop (didn't bet)
Seat 6: motoboy13sp folded before Flop (didn't bet)
Seat 7: Raonics3 folded before Flop (didn't bet)
Seat 8: Kevin12345Mc showed [Qh As] and won (9081) with high card Ace



PokerStars Hand #254986645144: Tournament #3860676529, $0.46+$1.50+$0.24 USD Hold'em No Limit - Level XII (125/250) - 2025/02/22 16:19:41 WET [2025/02/22 11:19:41 ET]
Table '3860676529 25' 8-max Seat #2 is the button
Seat 1: Tango Habana (16107 in chips, $3 bounty) 
Seat 2: Dzibiy (12052 in chips, $2.25 bounty) 
Seat 3: félix2011 (34266 in chips, $4.12 bounty) 
Seat 4: Hater RIP (14713 in chips, $4.12 bounty) 
Seat 5: Hill9595 (7543 in chips, $1.50 bounty) 
Seat 6: motoboy13sp (7654 in chips, $2.25 bounty) 
Seat 7: Raonics3 (5086 in chips, $1.50 bounty) 
Seat 8: Kevin12345Mc (9081 in chips, $3.37 bounty) 
Tango Habana: posts the ante 36
Dzibiy: posts the ante 36
félix2011: posts the ante 36
Hater RIP: posts the ante 36
Hill9595: posts the ante 36
motoboy13sp: posts the ante 36
Raonics3: posts the ante 36
Kevin12345Mc: posts the ante 36
félix2011: posts small blind 125
Hater RIP: posts big blind 250
*** HOLE CARDS ***
Dealt to Kevin12345Mc [9c 5d]
Hill9595: folds 
motoboy13sp: raises 250 to 500
Raonics3: folds 
Kevin12345Mc: folds 
Tango Habana: raises 998 to 1498
Dzibiy: folds 
félix2011: folds 
Hater RIP: folds 
motoboy13sp: calls 998
*** FLOP *** [3d 4h Kc]
motoboy13sp: checks 
Tango Habana: bets 1830
motoboy13sp: folds 
Uncalled bet (1830) returned to Tango Habana
Tango Habana collected 3659 from pot
Tango Habana: doesn't show hand 
*** SUMMARY ***
Total pot 3659 | Rake 0 
Board [3d 4h Kc]
Seat 1: Tango Habana collected (3659)
Seat 2: Dzibiy (button) folded before Flop (didn't bet)
Seat 3: félix2011 (small blind) folded before Flop
Seat 4: Hater RIP (big blind) folded before Flop
Seat 5: Hill9595 folded before Flop (didn't bet)
Seat 6: motoboy13sp folded on the Flop
Seat 7: Raonics3 folded before Flop (didn't bet)
Seat 8: Kevin12345Mc folded before Flop (didn't bet)



PokerStars Hand #254986658838: Tournament #3860676529, $0.46+$1.50+$0.24 USD Hold'em No Limit - Level XII (125/250) - 2025/02/22 16:20:40 WET [2025/02/22 11:20:40 ET]
Table '3860676529 25' 8-max Seat #3 is the button
Seat 1: Tango Habana (18232 in chips, $3 bounty) 
Seat 2: Dzibiy (12016 in chips, $2.25 bounty) 
Seat 3: félix2011 (34105 in chips, $4.12 bounty) 
Seat 4: Hater RIP (14427 in chips, $4.12 bounty) 
Seat 5: Hill9595 (7507 in chips, $1.50 bounty) 
Seat 6: motoboy13sp (6120 in chips, $2.25 bounty) 
Seat 7: Raonics3 (5050 in chips, $1.50 bounty) 
Seat 8: Kevin12345Mc (9045 in chips, $3.37 bounty) 
Tango Habana: posts the ante 36
Dzibiy: posts the ante 36
félix2011: posts the ante 36
Hater RIP: posts the ante 36
Hill9595: posts the ante 36
motoboy13sp: posts the ante 36
Raonics3: posts the ante 36
Kevin12345Mc: posts the ante 36
Hater RIP: posts small blind 125
Hill9595: posts big blind 250
*** HOLE CARDS ***
Dealt to Kevin12345Mc [5d 6d]
motoboy13sp: folds 
Raonics3: folds 
Kevin12345Mc: folds 
Tango Habana: raises 275 to 525
Dzibiy: folds 
félix2011: folds 
Hater RIP: folds 
Hill9595: folds 
Uncalled bet (275) returned to Tango Habana
Tango Habana collected 913 from pot
*** SUMMARY ***
Total pot 913 | Rake 0 
Seat 1: Tango Habana collected (913)
Seat 2: Dzibiy folded before Flop (didn't bet)
Seat 3: félix2011 (button) folded before Flop (didn't bet)
Seat 4: Hater RIP (small blind) folded before Flop
Seat 5: Hill9595 (big blind) folded before Flop
Seat 6: motoboy13sp folded before Flop (didn't bet)
Seat 7: Raonics3 folded before Flop (didn't bet)
Seat 8: Kevin12345Mc folded before Flop (didn't bet)



PokerStars Hand #254986668904: Tournament #3860676529, $0.46+$1.50+$0.24 USD Hold'em No Limit - Level XIII (150/300) - 2025/02/22 16:21:23 WET [2025/02/22 11:21:23 ET]
Table '3860676529 25' 8-max Seat #4 is the button
Seat 1: Tango Habana (18859 in chips, $3 bounty) 
Seat 2: Dzibiy (11980 in chips, $2.25 bounty) 
Seat 3: félix2011 (34069 in chips, $4.12 bounty) 
Seat 4: Hater RIP (14266 in chips, $4.12 bounty) 
Seat 5: Hill9595 (7221 in chips, $1.50 bounty) 
Seat 6: motoboy13sp (6084 in chips, $2.25 bounty) 
Seat 7: Raonics3 (5014 in chips, $1.50 bounty) 
Seat 8: Kevin12345Mc (9009 in chips, $3.37 bounty) 
Tango Habana: posts the ante 42
Dzibiy: posts the ante 42
félix2011: posts the ante 42
Hater RIP: posts the ante 42
Hill9595: posts the ante 42
motoboy13sp: posts the ante 42
Raonics3: posts the ante 42
Kevin12345Mc: posts the ante 42
Hill9595: posts small blind 150
motoboy13sp: posts big blind 300
*** HOLE CARDS ***
Dealt to Kevin12345Mc [5h Kh]
Raonics3: folds 
Kevin12345Mc: folds 
Tango Habana: folds 
Dzibiy: raises 300 to 600
félix2011: folds 
Hater RIP: calls 600
Hill9595: folds 
motoboy13sp: calls 300
*** FLOP *** [5h Kh]
motoboy13sp: checks 
Dzibiy: checks 
Hater RIP: checks 
*** TURN *** [5h Kh] [4d]
motoboy13sp: checks 
Dzibiy: bets 1257
Hater RIP: folds 
motoboy13sp: folds 
Uncalled bet (1257) returned to Dzibiy
Dzibiy collected 2286 from pot
Dzibiy: doesn't show hand 
*** SUMMARY ***
Total pot 2286 | Rake 0 
Board [Qs Qh 8d 4d]
Seat 1: Tango Habana folded before Flop (didn't bet)
Seat 2: Dzibiy collected (2286)
Seat 3: félix2011 folded before Flop (didn't bet)
Seat 4: Hater RIP (button) folded on the Turn
Seat 5: Hill9595 (small blind) folded before Flop
Seat 6: motoboy13sp (big blind) folded on the Turn
Seat 7: Raonics3 folded before Flop (didn't bet)
Seat 8: Kevin12345Mc folded before Flop (didn't bet)



PokerStars Hand #254986682335: Tournament #3860676529, $0.46+$1.50+$0.24 USD Hold'em No Limit - Level XIII (150/300) - 2025/02/22 16:22:22 WET [2025/02/22 11:22:22 ET]
Table '3860676529 25' 8-max Seat #5 is the button
Seat 1: Tango Habana (18817 in chips, $3 bounty) 
Seat 2: Dzibiy (13624 in chips, $2.25 bounty) 
Seat 3: félix2011 (34027 in chips, $4.12 bounty) 
Seat 4: Hater RIP (13624 in chips, $4.12 bounty) 
Seat 5: Hill9595 (7029 in chips, $1.50 bounty) 
Seat 6: motoboy13sp (5442 in chips, $2.25 bounty) 
Seat 7: Raonics3 (4972 in chips, $1.50 bounty) 
Seat 8: Kevin12345Mc (8967 in chips, $3.37 bounty) 
Tango Habana: posts the ante 42
Dzibiy: posts the ante 42
félix2011: posts the ante 42
Hater RIP: posts the ante 42
Hill9595: posts the ante 42
motoboy13sp: posts the ante 42
Raonics3: posts the ante 42
Kevin12345Mc: posts the ante 42
motoboy13sp: posts small blind 150
Raonics3: posts big blind 300
*** HOLE CARDS ***
Dealt to Kevin12345Mc [Qs 4c]
Kevin12345Mc: folds 
Tango Habana: folds 
Dzibiy: folds 
félix2011: raises 330 to 630
Hater RIP: folds 
Hill9595: folds 
motoboy13sp: folds 
Raonics3: raises 4300 to 4930 and is all-in
félix2011: calls 4300
*** FLOP *** [2c Tc 3d]
*** TURN *** [2c Tc 3d] [2d]
*** RIVER *** [2c Tc 3d 2d] [2s]
*** SHOW DOWN ***
Raonics3: shows [Ac 9d] (three of a kind, Deuces)
félix2011: shows [6d 6c] (a full house, Deuces full of Sixes)
félix2011 collected 10346 from pot
félix2011 wins $0.75 for eliminating Raonics3 and their own bounty increases by $0.75 to $4.87
Raonics3 finished the tournament in 817th place
*** SUMMARY ***
Total pot 10346 | Rake 0 
Board [2c Tc 3d 2d 2s]
Seat 1: Tango Habana folded before Flop (didn't bet)
Seat 2: Dzibiy folded before Flop (didn't bet)
Seat 3: félix2011 showed [6d 6c] and won (10346) with a full house, Deuces full of Sixes
Seat 4: Hater RIP folded before Flop (didn't bet)
Seat 5: Hill9595 (button) folded before Flop (didn't bet)
Seat 6: motoboy13sp (small blind) folded before Flop
Seat 7: Raonics3 (big blind) showed [Ac 9d] and lost with three of a kind, Deuces
Seat 8: Kevin12345Mc folded before Flop (didn't bet)



PokerStars Hand #254986723468: Tournament #3860676529, $0.46+$1.50+$0.24 USD Hold'em No Limit - Level XIII (150/300) - 2025/02/22 16:25:18 WET [2025/02/22 11:25:18 ET]
Table '3860676529 152' 8-max Seat #6 is the button
Seat 1: Gurana322 (6577 in chips, $1.50 bounty) 
Seat 2: Wagoo06 (8088 in chips, $1.50 bounty) 
Seat 3: didibaer1965 (15311 in chips, $3 bounty) 
Seat 4: malina7788 (3532 in chips, $3 bounty) 
Seat 5: Kevin12345Mc (8925 in chips, $3.37 bounty) 
Seat 6: mjcosta1 (16747 in chips, $2.25 bounty) 
Seat 7: fontaine1604 (22586 in chips, $3.75 bounty) 
Seat 8: MathewZvonL (18387 in chips, $2.25 bounty) 
Gurana322: posts the ante 42
Wagoo06: posts the ante 42
didibaer1965: posts the ante 42
malina7788: posts the ante 42
Kevin12345Mc: posts the ante 42
mjcosta1: posts the ante 42
fontaine1604: posts the ante 42
MathewZvonL: posts the ante 42
fontaine1604: posts small blind 150
MathewZvonL: posts big blind 300
*** HOLE CARDS ***
Dealt to Kevin12345Mc [Qh 7c]
Gurana322: folds 
Wagoo06: folds 
didibaer1965: folds 
malina7788: folds 
Kevin12345Mc: folds 
mjcosta1: folds 
fontaine1604: folds 
Uncalled bet (150) returned to MathewZvonL
MathewZvonL collected 636 from pot
MathewZvonL: doesn't show hand 
*** SUMMARY ***
Total pot 636 | Rake 0 
Seat 1: Gurana322 folded before Flop (didn't bet)
Seat 2: Wagoo06 folded before Flop (didn't bet)
Seat 3: didibaer1965 folded before Flop (didn't bet)
Seat 4: malina7788 folded before Flop (didn't bet)
Seat 5: Kevin12345Mc folded before Flop (didn't bet)
Seat 6: mjcosta1 (button) folded before Flop (didn't bet)
Seat 7: fontaine1604 (small blind) folded before Flop
Seat 8: MathewZvonL (big blind) collected (636)



PokerStars Hand #254986728276: Tournament #3860676529, $0.46+$1.50+$0.24 USD Hold'em No Limit - Level XIII (150/300) - 2025/02/22 16:25:39 WET [2025/02/22 11:25:39 ET]
Table '3860676529 152' 8-max Seat #7 is the button
Seat 2: Wagoo06 (8046 in chips, $1.50 bounty) 
Seat 3: didibaer1965 (15269 in chips, $3 bounty) 
Seat 4: malina7788 (3490 in chips, $3 bounty) 
Seat 5: Kevin12345Mc (8883 in chips, $3.37 bounty) 
Seat 6: mjcosta1 (16705 in chips, $2.25 bounty) 
Seat 7: fontaine1604 (22394 in chips, $3.75 bounty) 
Seat 8: MathewZvonL (18831 in chips, $2.25 bounty) 
Wagoo06: posts the ante 42
didibaer1965: posts the ante 42
malina7788: posts the ante 42
Kevin12345Mc: posts the ante 42
mjcosta1: posts the ante 42
fontaine1604: posts the ante 42
MathewZvonL: posts the ante 42
MathewZvonL: posts small blind 150
Wagoo06: posts big blind 300
*** HOLE CARDS ***
Dealt to Kevin12345Mc [Qh 7h]
didibaer1965: folds 
malina7788: folds 
Kevin12345Mc: folds 
mjcosta1: folds 
fontaine1604 has timed out
fontaine1604: folds 
fontaine1604 is sitting out
MathewZvonL: folds 
Uncalled bet (150) returned to Wagoo06
Wagoo06 collected 594 from pot
Wagoo06: doesn't show hand 
*** SUMMARY ***
Total pot 594 | Rake 0 
Seat 2: Wagoo06 (big blind) collected (594)
Seat 3: didibaer1965 folded before Flop (didn't bet)
Seat 4: malina7788 folded before Flop (didn't bet)
Seat 5: Kevin12345Mc folded before Flop (didn't bet)
Seat 6: mjcosta1 folded before Flop (didn't bet)
Seat 7: fontaine1604 (button) folded before Flop (didn't bet)
Seat 8: MathewZvonL (small blind) folded before Flop



PokerStars Hand #254986736479: Tournament #3860676529, $0.46+$1.50+$0.24 USD Hold'em No Limit - Level XIII (150/300) - 2025/02/22 16:26:13 WET [2025/02/22 11:26:13 ET]
Table '3860676529 152' 8-max Seat #8 is the button
Seat 1: TommyWD98 (7808 in chips) out of hand (moved from another table into small blind)
Seat 2: Wagoo06 (8448 in chips, $1.50 bounty) 
Seat 3: didibaer1965 (15227 in chips, $3 bounty) 
Seat 4: malina7788 (3448 in chips, $3 bounty) 
Seat 5: Kevin12345Mc (8841 in chips, $3.37 bounty) 
Seat 6: mjcosta1 (16663 in chips, $2.25 bounty) 
Seat 7: fontaine1604 (22352 in chips, $3.75 bounty) is sitting out
Seat 8: MathewZvonL (18639 in chips, $2.25 bounty) 
TommyWD98 will be allowed to play after the button
Wagoo06: posts the ante 42
didibaer1965: posts the ante 42
malina7788: posts the ante 42
Kevin12345Mc: posts the ante 42
mjcosta1: posts the ante 42
fontaine1604: posts the ante 42
MathewZvonL: posts the ante 42
Wagoo06: posts small blind 150
didibaer1965: posts big blind 300
*** HOLE CARDS ***
Dealt to Kevin12345Mc [3h 5h]
malina7788: raises 3106 to 3406 and is all-in
Kevin12345Mc: folds 
mjcosta1: folds 
fontaine1604: folds 
MathewZvonL: calls 3406
Wagoo06: folds 
didibaer1965: folds 
*** FLOP *** [Qs 2s 5s]
*** TURN *** [Qs 2s 5s] [9h]
*** RIVER *** [Qs 2s 5s 9h] [3c]
*** SHOW DOWN ***
malina7788: shows [2d Ad] (a pair of Deuces)
MathewZvonL: shows [5c Kd] (a pair of Fives)
MathewZvonL collected 7556 from pot
MathewZvonL wins $1.50 for eliminating malina7788 and their own bounty increases by $1.50 to $3.75
malina7788 finished the tournament in 756th place
*** SUMMARY ***
Total pot 7556 | Rake 0 
Board [Qs 2s 5s 9h 3c]
Seat 2: Wagoo06 (small blind) folded before Flop
Seat 3: didibaer1965 (big blind) folded before Flop
Seat 4: malina7788 showed [2d Ad] and lost with a pair of Deuces
Seat 5: Kevin12345Mc folded before Flop (didn't bet)
Seat 6: mjcosta1 folded before Flop (didn't bet)
Seat 7: fontaine1604 folded before Flop (didn't bet)
Seat 8: MathewZvonL (button) showed [5c Kd] and won (7556) with a pair of Fives



PokerStars Hand #254986744988: Tournament #3860676529, $0.46+$1.50+$0.24 USD Hold'em No Limit - Level XIII (150/300) - 2025/02/22 16:26:49 WET [2025/02/22 11:26:49 ET]
Table '3860676529 152' 8-max Seat #2 is the button
Seat 1: TommyWD98 (7808 in chips, $1.50 bounty) 
Seat 2: Wagoo06 (8256 in chips, $1.50 bounty) 
Seat 3: didibaer1965 (14885 in chips, $3 bounty) 
Seat 5: Kevin12345Mc (8799 in chips, $3.37 bounty) 
Seat 6: mjcosta1 (16621 in chips, $2.25 bounty) 
Seat 7: fontaine1604 (22310 in chips, $3.75 bounty) is sitting out
Seat 8: MathewZvonL (22747 in chips, $3.75 bounty) 
TommyWD98: posts the ante 42
Wagoo06: posts the ante 42
didibaer1965: posts the ante 42
Kevin12345Mc: posts the ante 42
mjcosta1: posts the ante 42
fontaine1604: posts the ante 42
MathewZvonL: posts the ante 42
didibaer1965: posts small blind 150
Kevin12345Mc: posts big blind 300
*** HOLE CARDS ***
Dealt to Kevin12345Mc [9s 7h]
mjcosta1: folds 
fontaine1604: folds 
MathewZvonL: raises 300 to 600
RaTaO20 is disconnected 
TommyWD98: folds 
Wagoo06: folds 
fontaine1604 has returned
fontaine1604 is sitting out
fontaine1604 has returned
didibaer1965: calls 450
Kevin12345Mc: folds 
*** FLOP *** [As 8d 7s]
didibaer1965: checks 
MathewZvonL: bets 592
didibaer1965: calls 592
*** TURN *** [As 8d 7s] [Kc]
didibaer1965: checks 
MathewZvonL: bets 983
didibaer1965: calls 983
*** RIVER *** [As 8d 7s Kc] [8h]
didibaer1965: checks 
MathewZvonL: checks 
*** SHOW DOWN ***
didibaer1965: shows [Ts Jd] (a pair of Eights)
MathewZvonL: shows [Qc Tc] (a pair of Eights - Ace+King+Queen kicker)
MathewZvonL collected 4944 from pot
*** SUMMARY ***
Total pot 4944 | Rake 0 
Board [As 8d 7s Kc 8h]
Seat 1: TommyWD98 folded before Flop (didn't bet)
Seat 2: Wagoo06 (button) folded before Flop (didn't bet)
Seat 3: didibaer1965 (small blind) showed [Ts Jd] and lost with a pair of Eights
Seat 5: Kevin12345Mc (big blind) folded before Flop
Seat 6: mjcosta1 folded before Flop (didn't bet)
Seat 7: fontaine1604 folded before Flop (didn't bet)
Seat 8: MathewZvonL showed [Qc Tc] and won (4944) with a pair of Eights



PokerStars Hand #254986760260: Tournament #3860676529, $0.46+$1.50+$0.24 USD Hold'em No Limit - Level XIII (150/300) - 2025/02/22 16:27:54 WET [2025/02/22 11:27:54 ET]
Table '3860676529 152' 8-max Seat #3 is the button
Seat 1: TommyWD98 (7766 in chips, $1.50 bounty) 
Seat 2: Wagoo06 (8214 in chips, $1.50 bounty) 
Seat 3: didibaer1965 (12668 in chips, $3 bounty) 
Seat 4: RaTaO20 (11120 in chips) out of hand (moved from another table into small blind)
Seat 5: Kevin12345Mc (8457 in chips, $3.37 bounty) 
Seat 6: mjcosta1 (16579 in chips, $2.25 bounty) 
Seat 7: fontaine1604 (22268 in chips, $3.75 bounty) 
Seat 8: MathewZvonL (25474 in chips, $3.75 bounty) 
RaTaO20 will be allowed to play after the button
TommyWD98: posts the ante 42
Wagoo06: posts the ante 42
didibaer1965: posts the ante 42
Kevin12345Mc: posts the ante 42
mjcosta1: posts the ante 42
fontaine1604: posts the ante 42
MathewZvonL: posts the ante 42
Kevin12345Mc: posts small blind 150
mjcosta1: posts big blind 300
*** HOLE CARDS ***
Dealt to Kevin12345Mc [As 5c]
fontaine1604: calls 300
MathewZvonL: calls 300
TommyWD98: folds 
Wagoo06: folds 
didibaer1965: calls 300
Kevin12345Mc: folds 
mjcosta1: checks 
*** FLOP *** [Qd Ac Kh]
mjcosta1: checks 
fontaine1604: checks 
MathewZvonL: checks 
didibaer1965: checks 
*** TURN *** [Qd Ac Kh] [4c]
mjcosta1: checks 
fontaine1604: bets 300
MathewZvonL: calls 300
didibaer1965: folds 
mjcosta1: folds 
*** RIVER *** [Qd Ac Kh 4c] [4s]
fontaine1604: checks 
MathewZvonL: bets 600
fontaine1604: raises 3444 to 4044
MathewZvonL: folds 
Uncalled bet (3444) returned to fontaine1604
fontaine1604 collected 3444 from pot
*** SUMMARY ***
Total pot 3444 | Rake 0 
Board [Qd Ac Kh 4c 4s]
Seat 1: TommyWD98 folded before Flop (didn't bet)
Seat 2: Wagoo06 folded before Flop (didn't bet)
Seat 3: didibaer1965 (button) folded on the Turn
Seat 5: Kevin12345Mc (small blind) folded before Flop
Seat 6: mjcosta1 (big blind) folded on the Turn
Seat 7: fontaine1604 collected (3444)
Seat 8: MathewZvonL folded on the River



PokerStars Hand #254986779614: Tournament #3860676529, $0.46+$1.50+$0.24 USD Hold'em No Limit - Level XIV (175/350) - 2025/02/22 16:29:17 WET [2025/02/22 11:29:17 ET]
Table '3860676529 152' 8-max Seat #5 is the button
Seat 1: TommyWD98 (7724 in chips, $1.50 bounty) 
Seat 2: Wagoo06 (8172 in chips, $1.50 bounty) 
Seat 3: didibaer1965 (12326 in chips, $3 bounty) 
Seat 4: RaTaO20 (11120 in chips, $1.50 bounty) 
Seat 5: Kevin12345Mc (8265 in chips, $3.37 bounty) 
Seat 6: mjcosta1 (16237 in chips, $2.25 bounty) 
Seat 7: fontaine1604 (24470 in chips, $3.75 bounty) 
Seat 8: MathewZvonL (24232 in chips, $3.75 bounty) 
TommyWD98: posts the ante 50
Wagoo06: posts the ante 50
didibaer1965: posts the ante 50
RaTaO20: posts the ante 50
Kevin12345Mc: posts the ante 50
mjcosta1: posts the ante 50
fontaine1604: posts the ante 50
MathewZvonL: posts the ante 50
mjcosta1: posts small blind 175
fontaine1604: posts big blind 350
*** HOLE CARDS ***
Dealt to Kevin12345Mc [Kh 3d]
MathewZvonL: folds 
TommyWD98: folds 
Wagoo06: folds 
didibaer1965: raises 700 to 1050
RaTaO20: folds 
Kevin12345Mc: folds 
mjcosta1: folds 
fontaine1604: raises 700 to 1750
didibaer1965: raises 10526 to 12276 and is all-in
fontaine1604: calls 10526
*** FLOP *** [9c Td 3c]
*** TURN *** [9c Td 3c] [Ts]
*** RIVER *** [9c Td 3c Ts] [9h]
*** SHOW DOWN ***
fontaine1604: shows [Ks Kd] (two pair, Kings and Tens)
didibaer1965: shows [Jc Jh] (two pair, Jacks and Tens)
fontaine1604 collected 25127 from pot
fontaine1604 wins $1.50 for eliminating didibaer1965 and their own bounty increases by $1.50 to $5.25
didibaer1965 finished the tournament in 707th place
*** SUMMARY ***
Total pot 25127 | Rake 0 
Board [9c Td 3c Ts 9h]
Seat 1: TommyWD98 folded before Flop (didn't bet)
Seat 2: Wagoo06 folded before Flop (didn't bet)
Seat 3: didibaer1965 showed [Jc Jh] and lost with two pair, Jacks and Tens
Seat 4: RaTaO20 folded before Flop (didn't bet)
Seat 5: Kevin12345Mc (button) folded before Flop (didn't bet)
Seat 6: mjcosta1 (small blind) folded before Flop
Seat 7: fontaine1604 (big blind) showed [Ks Kd] and won (25127) with two pair, Kings and Tens
Seat 8: MathewZvonL folded before Flop (didn't bet)



PokerStars Hand #254986789056: Tournament #3860676529, $0.46+$1.50+$0.24 USD Hold'em No Limit - Level XIV (175/350) - 2025/02/22 16:29:56 WET [2025/02/22 11:29:56 ET]
Table '3860676529 152' 8-max Seat #6 is the button
Seat 1: TommyWD98 (7674 in chips, $1.50 bounty) 
Seat 2: Wagoo06 (8122 in chips, $1.50 bounty) 
Seat 4: RaTaO20 (11070 in chips, $1.50 bounty) 
Seat 5: Kevin12345Mc (8215 in chips, $3.37 bounty) 
Seat 6: mjcosta1 (16012 in chips, $2.25 bounty) 
Seat 7: fontaine1604 (37271 in chips, $5.25 bounty) 
Seat 8: MathewZvonL (24182 in chips, $3.75 bounty) 
TommyWD98: posts the ante 50
Wagoo06: posts the ante 50
RaTaO20: posts the ante 50
Kevin12345Mc: posts the ante 50
mjcosta1: posts the ante 50
fontaine1604: posts the ante 50
MathewZvonL: posts the ante 50
fontaine1604: posts small blind 175
MathewZvonL: posts big blind 350
*** HOLE CARDS ***
Dealt to Kevin12345Mc [9h 8h]
TommyWD98: folds 
Wagoo06: folds 
RaTaO20: folds 
Kevin12345Mc: raises 385 to 735
mjcosta1: folds 
MrsHes is disconnected 
fontaine1604: folds 
MathewZvonL: raises 23397 to 24132 and is all-in
Kevin12345Mc: folds 
Uncalled bet (23397) returned to MathewZvonL
MathewZvonL collected 1995 from pot
MathewZvonL: doesn't show hand 
*** SUMMARY ***
Total pot 1995 | Rake 0 
Seat 1: TommyWD98 folded before Flop (didn't bet)
Seat 2: Wagoo06 folded before Flop (didn't bet)
Seat 4: RaTaO20 folded before Flop (didn't bet)
Seat 5: Kevin12345Mc folded before Flop
Seat 6: mjcosta1 (button) folded before Flop (didn't bet)
Seat 7: fontaine1604 (small blind) folded before Flop
Seat 8: MathewZvonL (big blind) collected (1995)



PokerStars Hand #254986796794: Tournament #3860676529, $0.46+$1.50+$0.24 USD Hold'em No Limit - Level XIV (175/350) - 2025/02/22 16:30:29 WET [2025/02/22 11:30:29 ET]
Table '3860676529 152' 8-max Seat #7 is the button
Seat 1: TommyWD98 (7624 in chips, $1.50 bounty) 
Seat 2: Wagoo06 (8072 in chips, $1.50 bounty) 
Seat 3: MrsHes (13052 in chips, $1.50 bounty) 
Seat 4: RaTaO20 (11020 in chips, $1.50 bounty) 
Seat 5: Kevin12345Mc (7430 in chips, $3.37 bounty) 
Seat 6: mjcosta1 (15962 in chips, $2.25 bounty) 
Seat 7: fontaine1604 (37046 in chips, $5.25 bounty) 
Seat 8: MathewZvonL (25392 in chips, $3.75 bounty) 
TommyWD98: posts the ante 50
Wagoo06: posts the ante 50
MrsHes: posts the ante 50
RaTaO20: posts the ante 50
Kevin12345Mc: posts the ante 50
mjcosta1: posts the ante 50
fontaine1604: posts the ante 50
MathewZvonL: posts the ante 50
MathewZvonL: posts small blind 175
TommyWD98: posts big blind 350
*** HOLE CARDS ***
Dealt to Kevin12345Mc [5h 9c]
Wagoo06: folds 
MrsHes: calls 350
RaTaO20: folds 
Kevin12345Mc: folds 
mjcosta1: folds 
fontaine1604: folds 
MathewZvonL: calls 175
TommyWD98: checks 
*** FLOP *** [Ah 2d Qc]
MathewZvonL: checks 
TommyWD98: checks 
MrsHes: checks 
*** TURN *** [Ah 2d Qc] [8d]
MathewZvonL: bets 700
TommyWD98: folds 
MrsHes: folds 
Uncalled bet (700) returned to MathewZvonL
MathewZvonL collected 1450 from pot
MathewZvonL: doesn't show hand 
*** SUMMARY ***
Total pot 1450 | Rake 0 
Board [Ah 2d Qc 8d]
Seat 1: TommyWD98 (big blind) folded on the Turn
Seat 2: Wagoo06 folded before Flop (didn't bet)
Seat 3: MrsHes folded on the Turn
Seat 4: RaTaO20 folded before Flop (didn't bet)
Seat 5: Kevin12345Mc folded before Flop (didn't bet)
Seat 6: mjcosta1 folded before Flop (didn't bet)
Seat 7: fontaine1604 (button) folded before Flop (didn't bet)
Seat 8: MathewZvonL (small blind) collected (1450)



PokerStars Hand #254986807968: Tournament #3860676529, $0.46+$1.50+$0.24 USD Hold'em No Limit - Level XIV (175/350) - 2025/02/22 16:31:15 WET [2025/02/22 11:31:15 ET]
Table '3860676529 152' 8-max Seat #8 is the button
Seat 1: TommyWD98 (7224 in chips, $1.50 bounty) 
Seat 2: Wagoo06 (8022 in chips, $1.50 bounty) 
Seat 3: MrsHes (12652 in chips, $1.50 bounty) 
Seat 4: RaTaO20 (10970 in chips, $1.50 bounty) 
Seat 5: Kevin12345Mc (7380 in chips, $3.37 bounty) 
Seat 6: mjcosta1 (15912 in chips, $2.25 bounty) 
Seat 7: fontaine1604 (36996 in chips, $5.25 bounty) 
Seat 8: MathewZvonL (26442 in chips, $3.75 bounty) 
TommyWD98: posts the ante 50
Wagoo06: posts the ante 50
MrsHes: posts the ante 50
RaTaO20: posts the ante 50
Kevin12345Mc: posts the ante 50
mjcosta1: posts the ante 50
fontaine1604: posts the ante 50
MathewZvonL: posts the ante 50
TommyWD98: posts small blind 175
Wagoo06: posts big blind 350
*** HOLE CARDS ***
Dealt to Kevin12345Mc [4s Ad]
MrsHes: calls 350
RaTaO20: folds 
Kevin12345Mc: folds 
mjcosta1: raises 350 to 700
fontaine1604: calls 700
MathewZvonL: folds 
TommyWD98: folds 
Wagoo06: raises 7272 to 7972 and is all-in
MrsHes: folds 
mjcosta1: folds 
fontaine1604: folds 
Uncalled bet (7272) returned to Wagoo06
Wagoo06 collected 3025 from pot
Wagoo06: doesn't show hand 
*** SUMMARY ***
Total pot 3025 | Rake 0 
Seat 1: TommyWD98 (small blind) folded before Flop
Seat 2: Wagoo06 (big blind) collected (3025)
Seat 3: MrsHes folded before Flop
Seat 4: RaTaO20 folded before Flop (didn't bet)
Seat 5: Kevin12345Mc folded before Flop (didn't bet)
Seat 6: mjcosta1 folded before Flop
Seat 7: fontaine1604 folded before Flop
Seat 8: MathewZvonL (button) folded before Flop (didn't bet)



PokerStars Hand #254986815544: Tournament #3860676529, $0.46+$1.50+$0.24 USD Hold'em No Limit - Level XIV (175/350) - 2025/02/22 16:31:47 WET [2025/02/22 11:31:47 ET]
Table '3860676529 152' 8-max Seat #1 is the button
Seat 1: TommyWD98 (6999 in chips, $1.50 bounty) 
Seat 2: Wagoo06 (10297 in chips, $1.50 bounty) 
Seat 3: MrsHes (12252 in chips, $1.50 bounty) 
Seat 4: RaTaO20 (10920 in chips, $1.50 bounty) 
Seat 5: Kevin12345Mc (7330 in chips, $3.37 bounty) 
Seat 6: mjcosta1 (15162 in chips, $2.25 bounty) 
Seat 7: fontaine1604 (36246 in chips, $5.25 bounty) 
Seat 8: MathewZvonL (26392 in chips, $3.75 bounty) 
TommyWD98: posts the ante 50
Wagoo06: posts the ante 50
MrsHes: posts the ante 50
RaTaO20: posts the ante 50
Kevin12345Mc: posts the ante 50
mjcosta1: posts the ante 50
fontaine1604: posts the ante 50
MathewZvonL: posts the ante 50
Wagoo06: posts small blind 175
MrsHes: posts big blind 350
*** HOLE CARDS ***
Dealt to Kevin12345Mc [8h 9c]
RaTaO20: folds 
Kevin12345Mc: folds 
mjcosta1: folds 
fontaine1604: folds 
MathewZvonL: folds 
TommyWD98: raises 350 to 700
Wagoo06: folds 
MrsHes: calls 350
*** FLOP *** [Jh Qd 2c]
MrsHes: checks 
TommyWD98: bets 638
MrsHes: folds 
Uncalled bet (638) returned to TommyWD98
TommyWD98 collected 1975 from pot
*** SUMMARY ***
Total pot 1975 | Rake 0 
Board [Jh Qd 2c]
Seat 1: TommyWD98 (button) collected (1975)
Seat 2: Wagoo06 (small blind) folded before Flop
Seat 3: MrsHes (big blind) folded on the Flop
Seat 4: RaTaO20 folded before Flop (didn't bet)
Seat 5: Kevin12345Mc folded before Flop (didn't bet)
Seat 6: mjcosta1 folded before Flop (didn't bet)
Seat 7: fontaine1604 folded before Flop (didn't bet)
Seat 8: MathewZvonL folded before Flop (didn't bet)



PokerStars Hand #254986825889: Tournament #3860676529, $0.46+$1.50+$0.24 USD Hold'em No Limit - Level XIV (175/350) - 2025/02/22 16:32:29 WET [2025/02/22 11:32:29 ET]
Table '3860676529 152' 8-max Seat #2 is the button
Seat 1: TommyWD98 (8224 in chips, $1.50 bounty) 
Seat 2: Wagoo06 (10072 in chips, $1.50 bounty) 
Seat 3: MrsHes (11502 in chips, $1.50 bounty) 
Seat 4: RaTaO20 (10870 in chips, $1.50 bounty) 
Seat 5: Kevin12345Mc (7280 in chips, $3.37 bounty) 
Seat 6: mjcosta1 (15112 in chips, $2.25 bounty) 
Seat 7: fontaine1604 (36196 in chips, $5.25 bounty) 
Seat 8: MathewZvonL (26342 in chips, $3.75 bounty) 
TommyWD98: posts the ante 50
Wagoo06: posts the ante 50
MrsHes: posts the ante 50
RaTaO20: posts the ante 50
Kevin12345Mc: posts the ante 50
mjcosta1: posts the ante 50
fontaine1604: posts the ante 50
MathewZvonL: posts the ante 50
MrsHes: posts small blind 175
RaTaO20: posts big blind 350
*** HOLE CARDS ***
Dealt to Kevin12345Mc [8h Jh]
Kevin12345Mc: folds 
mjcosta1: folds 
fontaine1604: raises 700 to 1050
MathewZvonL: folds 
TommyWD98: folds 
Wagoo06: folds 
MrsHes: calls 875
RaTaO20: calls 700
*** FLOP *** [9c Qd 6h]
MrsHes: checks 
RaTaO20: checks 
fontaine1604: checks 
*** TURN *** [9c Qd 6h] [5s]
MrsHes: bets 700
RaTaO20: raises 2475 to 3175
fontaine1604: raises 2475 to 5650
MrsHes: folds 
RaTaO20: raises 4120 to 9770 and is all-in
fontaine1604: calls 4120
*** RIVER *** [9c Qd 6h 5s] [Jd]
*** SHOW DOWN ***
RaTaO20: shows [9h Qs] (two pair, Queens and Nines)
fontaine1604: shows [Ks Kc] (a pair of Kings)
RaTaO20 collected 23790 from pot
*** SUMMARY ***
Total pot 23790 | Rake 0 
Board [9c Qd 6h 5s Jd]
Seat 1: TommyWD98 folded before Flop (didn't bet)
Seat 2: Wagoo06 (button) folded before Flop (didn't bet)
Seat 3: MrsHes (small blind) folded on the Turn
Seat 4: RaTaO20 (big blind) showed [9h Qs] and won (23790) with two pair, Queens and Nines
Seat 5: Kevin12345Mc folded before Flop (didn't bet)
Seat 6: mjcosta1 folded before Flop (didn't bet)
Seat 7: fontaine1604 showed [Ks Kc] and lost with a pair of Kings
Seat 8: MathewZvonL folded before Flop (didn't bet)



PokerStars Hand #254986842034: Tournament #3860676529, $0.46+$1.50+$0.24 USD Hold'em No Limit - Level XIV (175/350) - 2025/02/22 16:33:36 WET [2025/02/22 11:33:36 ET]
Table '3860676529 152' 8-max Seat #3 is the button
Seat 1: TommyWD98 (8174 in chips, $1.50 bounty) 
Seat 2: Wagoo06 (10022 in chips, $1.50 bounty) 
Seat 3: MrsHes (9702 in chips, $1.50 bounty) 
Seat 4: RaTaO20 (23790 in chips, $1.50 bounty) 
Seat 5: Kevin12345Mc (7230 in chips, $3.37 bounty) 
Seat 6: mjcosta1 (15062 in chips, $2.25 bounty) 
Seat 7: fontaine1604 (25326 in chips, $5.25 bounty) 
Seat 8: MathewZvonL (26292 in chips, $3.75 bounty) 
TommyWD98: posts the ante 50
Wagoo06: posts the ante 50
MrsHes: posts the ante 50
RaTaO20: posts the ante 50
Kevin12345Mc: posts the ante 50
mjcosta1: posts the ante 50
fontaine1604: posts the ante 50
MathewZvonL: posts the ante 50
RaTaO20: posts small blind 175
Kevin12345Mc: posts big blind 350
*** HOLE CARDS ***
Dealt to Kevin12345Mc [9d 9s]
mjcosta1: raises 700 to 1050
fontaine1604: folds 
MathewZvonL: folds 
TommyWD98: folds 
Wagoo06: folds 
MrsHes: folds 
RaTaO20: calls 875
Kevin12345Mc: raises 6130 to 7180 and is all-in
mjcosta1: raises 6130 to 13310
RaTaO20: folds 
Uncalled bet (6130) returned to mjcosta1
*** FLOP *** [4c Th Qd]
*** TURN *** [4c Th Qd] [7s]
*** RIVER *** [4c Th Qd 7s] [9c]
*** SHOW DOWN ***
Kevin12345Mc: shows [9d 9s] (three of a kind, Nines)
mjcosta1: shows [As Kh] (high card Ace)
Kevin12345Mc collected 15810 from pot
*** SUMMARY ***
Total pot 15810 | Rake 0 
Board [4c Th Qd 7s 9c]
Seat 1: TommyWD98 folded before Flop (didn't bet)
Seat 2: Wagoo06 folded before Flop (didn't bet)
Seat 3: MrsHes (button) folded before Flop (didn't bet)
Seat 4: RaTaO20 (small blind) folded before Flop
Seat 5: Kevin12345Mc (big blind) showed [9d 9s] and won (15810) with three of a kind, Nines
Seat 6: mjcosta1 showed [As Kh] and lost with high card Ace
Seat 7: fontaine1604 folded before Flop (didn't bet)
Seat 8: MathewZvonL folded before Flop (didn't bet)



PokerStars Hand #254986851937: Tournament #3860676529, $0.46+$1.50+$0.24 USD Hold'em No Limit - Level XIV (175/350) - 2025/02/22 16:34:18 WET [2025/02/22 11:34:18 ET]
Table '3860676529 152' 8-max Seat #4 is the button
Seat 1: TommyWD98 (8124 in chips, $1.50 bounty) 
Seat 2: Wagoo06 (9972 in chips, $1.50 bounty) 
Seat 3: MrsHes (9652 in chips, $1.50 bounty) 
Seat 4: RaTaO20 (22690 in chips, $1.50 bounty) 
Seat 5: Kevin12345Mc (15810 in chips, $3.37 bounty) 
Seat 6: mjcosta1 (7832 in chips, $2.25 bounty) 
Seat 7: fontaine1604 (25276 in chips, $5.25 bounty) 
Seat 8: MathewZvonL (26242 in chips, $3.75 bounty) 
TommyWD98: posts the ante 50
Wagoo06: posts the ante 50
MrsHes: posts the ante 50
RaTaO20: posts the ante 50
Kevin12345Mc: posts the ante 50
mjcosta1: posts the ante 50
fontaine1604: posts the ante 50
MathewZvonL: posts the ante 50
Kevin12345Mc: posts small blind 175
mjcosta1: posts big blind 350
*** HOLE CARDS ***
Dealt to Kevin12345Mc [Kd 5s]
fontaine1604 has timed out
fontaine1604: folds 
fontaine1604 is sitting out
MathewZvonL: raises 350 to 700
TommyWD98: calls 700
Wagoo06: folds 
MrsHes: calls 700
RaTaO20: calls 700
Kevin12345Mc: folds 
fontaine1604 has returned
mjcosta1: calls 350
*** FLOP *** [7d 6h Th]
mjcosta1: checks 
MathewZvonL: bets 1345
TommyWD98: folds 
MrsHes: calls 1345
RaTaO20: calls 1345
mjcosta1: folds 
*** TURN *** [7d 6h Th] [8s]
MathewZvonL: checks 
MrsHes: bets 7557 and is all-in
RaTaO20: folds 
MathewZvonL: folds 
Uncalled bet (7557) returned to MrsHes
MrsHes collected 8110 from pot
MrsHes: doesn't show hand 
*** SUMMARY ***
Total pot 8110 | Rake 0 
Board [7d 6h Th 8s]
Seat 1: TommyWD98 folded on the Flop
Seat 2: Wagoo06 folded before Flop (didn't bet)
Seat 3: MrsHes collected (8110)
Seat 4: RaTaO20 (button) folded on the Turn
Seat 5: Kevin12345Mc (small blind) folded before Flop
Seat 6: mjcosta1 (big blind) folded on the Flop
Seat 7: fontaine1604 folded before Flop (didn't bet)
Seat 8: MathewZvonL folded on the Turn



PokerStars Hand #254986865461: Tournament #3860676529, $0.46+$1.50+$0.24 USD Hold'em No Limit - Level XIV (175/350) - 2025/02/22 16:35:15 WET [2025/02/22 11:35:15 ET]
Table '3860676529 152' 8-max Seat #5 is the button
Seat 1: TommyWD98 (7374 in chips, $1.50 bounty) 
Seat 2: Wagoo06 (9922 in chips, $1.50 bounty) 
Seat 3: MrsHes (15667 in chips, $1.50 bounty) 
Seat 4: RaTaO20 (20595 in chips, $1.50 bounty) 
Seat 5: Kevin12345Mc (15585 in chips, $3.37 bounty) 
Seat 6: mjcosta1 (7082 in chips, $2.25 bounty) 
Seat 7: fontaine1604 (25226 in chips, $5.25 bounty) 
Seat 8: MathewZvonL (24147 in chips, $3.75 bounty) 
TommyWD98: posts the ante 50
Wagoo06: posts the ante 50
MrsHes: posts the ante 50
RaTaO20: posts the ante 50
Kevin12345Mc: posts the ante 50
mjcosta1: posts the ante 50
fontaine1604: posts the ante 50
MathewZvonL: posts the ante 50
mjcosta1: posts small blind 175
fontaine1604: posts big blind 350
*** HOLE CARDS ***
Dealt to Kevin12345Mc [9s 4c]
MathewZvonL: folds 
TommyWD98: folds 
Wagoo06: folds 
MrsHes: folds 
RaTaO20: raises 350 to 700
Kevin12345Mc: folds 
mjcosta1: folds 
fontaine1604: folds 
Uncalled bet (350) returned to RaTaO20
RaTaO20 collected 1275 from pot
*** SUMMARY ***
Total pot 1275 | Rake 0 
Seat 1: TommyWD98 folded before Flop (didn't bet)
Seat 2: Wagoo06 folded before Flop (didn't bet)
Seat 3: MrsHes folded before Flop (didn't bet)
Seat 4: RaTaO20 collected (1275)
Seat 5: Kevin12345Mc (button) folded before Flop (didn't bet)
Seat 6: mjcosta1 (small blind) folded before Flop
Seat 7: fontaine1604 (big blind) folded before Flop
Seat 8: MathewZvonL folded before Flop (didn't bet)



PokerStars Hand #254986870530: Tournament #3860676529, $0.46+$1.50+$0.24 USD Hold'em No Limit - Level XIV (175/350) - 2025/02/22 16:35:36 WET [2025/02/22 11:35:36 ET]
Table '3860676529 152' 8-max Seat #6 is the button
Seat 1: TommyWD98 (7324 in chips, $1.50 bounty) 
Seat 2: Wagoo06 (9872 in chips, $1.50 bounty) 
Seat 3: MrsHes (15617 in chips, $1.50 bounty) 
Seat 4: RaTaO20 (21470 in chips, $1.50 bounty) 
Seat 5: Kevin12345Mc (15535 in chips, $3.37 bounty) 
Seat 6: mjcosta1 (6857 in chips, $2.25 bounty) 
Seat 7: fontaine1604 (24826 in chips, $5.25 bounty) 
Seat 8: MathewZvonL (24097 in chips, $3.75 bounty) 
TommyWD98: posts the ante 50
Wagoo06: posts the ante 50
MrsHes: posts the ante 50
RaTaO20: posts the ante 50
Kevin12345Mc: posts the ante 50
mjcosta1: posts the ante 50
fontaine1604: posts the ante 50
MathewZvonL: posts the ante 50
fontaine1604: posts small blind 175
MathewZvonL: posts big blind 350
*** HOLE CARDS ***
Dealt to Kevin12345Mc [7h 3d]
TommyWD98: folds 
Wagoo06: folds 
MrsHes: folds 
RaTaO20: folds 
Kevin12345Mc: folds 
mjcosta1: folds 
fontaine1604: raises 2800 to 3150
MathewZvonL: folds 
Uncalled bet (2800) returned to fontaine1604
fontaine1604 collected 1100 from pot
*** SUMMARY ***
Total pot 1100 | Rake 0 
Seat 1: TommyWD98 folded before Flop (didn't bet)
Seat 2: Wagoo06 folded before Flop (didn't bet)
Seat 3: MrsHes folded before Flop (didn't bet)
Seat 4: RaTaO20 folded before Flop (didn't bet)
Seat 5: Kevin12345Mc folded before Flop (didn't bet)
Seat 6: mjcosta1 (button) folded before Flop (didn't bet)
Seat 7: fontaine1604 (small blind) collected (1100)
Seat 8: MathewZvonL (big blind) folded before Flop



PokerStars Hand #254986875054: Tournament #3860676529, $0.46+$1.50+$0.24 USD Hold'em No Limit - Level XIV (175/350) - 2025/02/22 16:35:55 WET [2025/02/22 11:35:55 ET]
Table '3860676529 152' 8-max Seat #7 is the button
Seat 1: TommyWD98 (7274 in chips, $1.50 bounty) 
Seat 2: Wagoo06 (9822 in chips, $1.50 bounty) 
Seat 3: MrsHes (15567 in chips, $1.50 bounty) 
Seat 4: RaTaO20 (21420 in chips, $1.50 bounty) 
Seat 5: Kevin12345Mc (15485 in chips, $3.37 bounty) 
Seat 6: mjcosta1 (6807 in chips, $2.25 bounty) 
Seat 7: fontaine1604 (25526 in chips, $5.25 bounty) 
Seat 8: MathewZvonL (23697 in chips, $3.75 bounty) 
TommyWD98: posts the ante 50
Wagoo06: posts the ante 50
MrsHes: posts the ante 50
RaTaO20: posts the ante 50
Kevin12345Mc: posts the ante 50
mjcosta1: posts the ante 50
fontaine1604: posts the ante 50
MathewZvonL: posts the ante 50
MathewZvonL: posts small blind 175
TommyWD98: posts big blind 350
*** HOLE CARDS ***
Dealt to Kevin12345Mc [2d 5d]
Wagoo06: folds 
MrsHes: raises 350 to 700
RaTaO20: folds 
Kevin12345Mc: folds 
mjcosta1: calls 700
fontaine1604 has timed out
fontaine1604: folds 
fontaine1604 is sitting out
MathewZvonL: folds 
TommyWD98: folds 
*** FLOP *** [4s 7d Kd]
MrsHes: bets 350
mjcosta1: calls 350
*** TURN *** [4s 7d Kd] [6h]
MrsHes: bets 350
mjcosta1: raises 1863 to 2213
MrsHes: folds 
Uncalled bet (1863) returned to mjcosta1
mjcosta1 collected 3725 from pot
*** SUMMARY ***
Total pot 3725 | Rake 0 
Board [4s 7d Kd 6h]
Seat 1: TommyWD98 (big blind) folded before Flop
Seat 2: Wagoo06 folded before Flop (didn't bet)
Seat 3: MrsHes folded on the Turn
Seat 4: RaTaO20 folded before Flop (didn't bet)
Seat 5: Kevin12345Mc folded before Flop (didn't bet)
Seat 6: mjcosta1 collected (3725)
Seat 7: fontaine1604 (button) folded before Flop (didn't bet)
Seat 8: MathewZvonL (small blind) folded before Flop



PokerStars Hand #254986887166: Tournament #3860676529, $0.46+$1.50+$0.24 USD Hold'em No Limit - Level XIV (175/350) - 2025/02/22 16:36:46 WET [2025/02/22 11:36:46 ET]
Table '3860676529 152' 8-max Seat #8 is the button
Seat 1: TommyWD98 (6874 in chips, $1.50 bounty) 
Seat 2: Wagoo06 (9772 in chips, $1.50 bounty) 
Seat 3: MrsHes (14117 in chips, $1.50 bounty) 
Seat 4: RaTaO20 (21370 in chips, $1.50 bounty) 
Seat 5: Kevin12345Mc (15435 in chips, $3.37 bounty) 
Seat 6: mjcosta1 (9082 in chips, $2.25 bounty) 
Seat 7: fontaine1604 (25476 in chips, $5.25 bounty) is sitting out
Seat 8: MathewZvonL (23472 in chips, $3.75 bounty) 
TommyWD98: posts the ante 50
Wagoo06: posts the ante 50
MrsHes: posts the ante 50
RaTaO20: posts the ante 50
Kevin12345Mc: posts the ante 50
mjcosta1: posts the ante 50
fontaine1604: posts the ante 50
MathewZvonL: posts the ante 50
TommyWD98: posts small blind 175
Wagoo06: posts big blind 350
*** HOLE CARDS ***
Dealt to Kevin12345Mc [6s 4s]
MrsHes: calls 350
RaTaO20: folds 
Kevin12345Mc: folds 
mjcosta1: folds 
fontaine1604: folds 
MathewZvonL: calls 350
TommyWD98: calls 175
Wagoo06: raises 9372 to 9722 and is all-in
MrsHes: folds 
MathewZvonL: folds 
TommyWD98: folds 
Uncalled bet (9372) returned to Wagoo06
Wagoo06 collected 1800 from pot
Wagoo06: doesn't show hand 
*** SUMMARY ***
Total pot 1800 | Rake 0 
Seat 1: TommyWD98 (small blind) folded before Flop
Seat 2: Wagoo06 (big blind) collected (1800)
Seat 3: MrsHes folded before Flop
Seat 4: RaTaO20 folded before Flop (didn't bet)
Seat 5: Kevin12345Mc folded before Flop (didn't bet)
Seat 6: mjcosta1 folded before Flop (didn't bet)
Seat 7: fontaine1604 folded before Flop (didn't bet)
Seat 8: MathewZvonL (button) folded before Flop



PokerStars Hand #254986897562: Tournament #3860676529, $0.46+$1.50+$0.24 USD Hold'em No Limit - Level XV (200/400) - 2025/02/22 16:37:29 WET [2025/02/22 11:37:29 ET]
Table '3860676529 152' 8-max Seat #1 is the button
Seat 1: TommyWD98 (6474 in chips, $1.50 bounty) 
Seat 2: Wagoo06 (11172 in chips, $1.50 bounty) 
Seat 3: MrsHes (13717 in chips, $1.50 bounty) 
Seat 4: RaTaO20 (21320 in chips, $1.50 bounty) 
Seat 5: Kevin12345Mc (15385 in chips, $3.37 bounty) 
Seat 6: mjcosta1 (9032 in chips, $2.25 bounty) 
Seat 7: fontaine1604 (25426 in chips, $5.25 bounty) is sitting out
Seat 8: MathewZvonL (23072 in chips, $3.75 bounty) 
TommyWD98: posts the ante 60
Wagoo06: posts the ante 60
MrsHes: posts the ante 60
RaTaO20: posts the ante 60
Kevin12345Mc: posts the ante 60
mjcosta1: posts the ante 60
fontaine1604: posts the ante 60
MathewZvonL: posts the ante 60
Wagoo06: posts small blind 200
MrsHes: posts big blind 400
*** HOLE CARDS ***
Dealt to Kevin12345Mc [7d 3d]
RaTaO20: folds 
Kevin12345Mc: folds 
mjcosta1: folds 
fontaine1604: folds 
MathewZvonL: folds 
TommyWD98: folds 
Wagoo06: calls 200
MrsHes: checks 
*** FLOP *** [6d 2d Tc]
Wagoo06: bets 640
MrsHes: folds 
Uncalled bet (640) returned to Wagoo06
Wagoo06 collected 1280 from pot
Wagoo06: doesn't show hand 
*** SUMMARY ***
Total pot 1280 | Rake 0 
Board [6d 2d Tc]
Seat 1: TommyWD98 (button) folded before Flop (didn't bet)
Seat 2: Wagoo06 (small blind) collected (1280)
Seat 3: MrsHes (big blind) folded on the Flop
Seat 4: RaTaO20 folded before Flop (didn't bet)
Seat 5: Kevin12345Mc folded before Flop (didn't bet)
Seat 6: mjcosta1 folded before Flop (didn't bet)
Seat 7: fontaine1604 folded before Flop (didn't bet)
Seat 8: MathewZvonL folded before Flop (didn't bet)



PokerStars Hand #254986903318: Tournament #3860676529, $0.46+$1.50+$0.24 USD Hold'em No Limit - Level XV (200/400) - 2025/02/22 16:37:53 WET [2025/02/22 11:37:53 ET]
Table '3860676529 152' 8-max Seat #2 is the button
Seat 1: TommyWD98 (6414 in chips, $1.50 bounty) 
Seat 2: Wagoo06 (11992 in chips, $1.50 bounty) 
Seat 3: MrsHes (13257 in chips, $1.50 bounty) 
Seat 4: RaTaO20 (21260 in chips, $1.50 bounty) 
Seat 5: Kevin12345Mc (15325 in chips, $3.37 bounty) 
Seat 6: mjcosta1 (8972 in chips, $2.25 bounty) 
Seat 7: fontaine1604 (25366 in chips, $5.25 bounty) is sitting out
Seat 8: MathewZvonL (23012 in chips, $3.75 bounty) 
TommyWD98: posts the ante 60
Wagoo06: posts the ante 60
MrsHes: posts the ante 60
RaTaO20: posts the ante 60
Kevin12345Mc: posts the ante 60
mjcosta1: posts the ante 60
fontaine1604: posts the ante 60
MathewZvonL: posts the ante 60
MrsHes: posts small blind 200
RaTaO20: posts big blind 400
*** HOLE CARDS ***
Dealt to Kevin12345Mc [Jd Qs]
fontaine1604 has returned
Kevin12345Mc: raises 480 to 880
mjcosta1: folds 
fontaine1604: raises 2840 to 3720
MathewZvonL: folds 
TommyWD98: folds 
Wagoo06: folds 
MrsHes: folds 
RaTaO20: folds 
Kevin12345Mc: folds 
Uncalled bet (2840) returned to fontaine1604
fontaine1604 collected 2840 from pot
*** SUMMARY ***
Total pot 2840 | Rake 0 
Seat 1: TommyWD98 folded before Flop (didn't bet)
Seat 2: Wagoo06 (button) folded before Flop (didn't bet)
Seat 3: MrsHes (small blind) folded before Flop
Seat 4: RaTaO20 (big blind) folded before Flop
Seat 5: Kevin12345Mc folded before Flop
Seat 6: mjcosta1 folded before Flop (didn't bet)
Seat 7: fontaine1604 collected (2840)
Seat 8: MathewZvonL folded before Flop (didn't bet)



PokerStars Hand #254986913195: Tournament #3860676529, $0.46+$1.50+$0.24 USD Hold'em No Limit - Level XV (200/400) - 2025/02/22 16:38:35 WET [2025/02/22 11:38:35 ET]
Table '3860676529 152' 8-max Seat #3 is the button
Seat 1: TommyWD98 (6354 in chips, $1.50 bounty) 
Seat 2: Wagoo06 (11932 in chips, $1.50 bounty) 
Seat 3: MrsHes (12997 in chips, $1.50 bounty) 
Seat 4: RaTaO20 (20800 in chips, $1.50 bounty) 
Seat 5: Kevin12345Mc (14385 in chips, $3.37 bounty) 
Seat 6: mjcosta1 (8912 in chips, $2.25 bounty) 
Seat 7: fontaine1604 (27266 in chips, $5.25 bounty) 
Seat 8: MathewZvonL (22952 in chips, $3.75 bounty) 
TommyWD98: posts the ante 60
Wagoo06: posts the ante 60
MrsHes: posts the ante 60
RaTaO20: posts the ante 60
Kevin12345Mc: posts the ante 60
mjcosta1: posts the ante 60
fontaine1604: posts the ante 60
MathewZvonL: posts the ante 60
RaTaO20: posts small blind 200
Kevin12345Mc: posts big blind 400
*** HOLE CARDS ***
Dealt to Kevin12345Mc [5d 2d]
mjcosta1: folds 
fontaine1604: folds 
MathewZvonL: folds 
TommyWD98: folds 
Wagoo06: folds 
MrsHes: folds 
RaTaO20: raises 800 to 1200
Kevin12345Mc: folds 
Uncalled bet (800) returned to RaTaO20
RaTaO20 collected 1280 from pot
*** SUMMARY ***
Total pot 1280 | Rake 0 
Seat 1: TommyWD98 folded before Flop (didn't bet)
Seat 2: Wagoo06 folded before Flop (didn't bet)
Seat 3: MrsHes (button) folded before Flop (didn't bet)
Seat 4: RaTaO20 (small blind) collected (1280)
Seat 5: Kevin12345Mc (big blind) folded before Flop
Seat 6: mjcosta1 folded before Flop (didn't bet)
Seat 7: fontaine1604 folded before Flop (didn't bet)
Seat 8: MathewZvonL folded before Flop (didn't bet)



PokerStars Hand #254986919744: Tournament #3860676529, $0.46+$1.50+$0.24 USD Hold'em No Limit - Level XV (200/400) - 2025/02/22 16:39:02 WET [2025/02/22 11:39:02 ET]
Table '3860676529 152' 8-max Seat #4 is the button
Seat 1: TommyWD98 (6294 in chips, $1.50 bounty) 
Seat 2: Wagoo06 (11872 in chips, $1.50 bounty) 
Seat 3: MrsHes (12937 in chips, $1.50 bounty) 
Seat 4: RaTaO20 (21620 in chips, $1.50 bounty) 
Seat 5: Kevin12345Mc (13925 in chips, $3.37 bounty) 
Seat 6: mjcosta1 (8852 in chips, $2.25 bounty) 
Seat 7: fontaine1604 (27206 in chips, $5.25 bounty) 
Seat 8: MathewZvonL (22892 in chips, $3.75 bounty) 
TommyWD98: posts the ante 60
Wagoo06: posts the ante 60
MrsHes: posts the ante 60
RaTaO20: posts the ante 60
Kevin12345Mc: posts the ante 60
mjcosta1: posts the ante 60
fontaine1604: posts the ante 60
MathewZvonL: posts the ante 60
Kevin12345Mc: posts small blind 200
mjcosta1: posts big blind 400
*** HOLE CARDS ***
Dealt to Kevin12345Mc [Jc 2h]
fontaine1604: folds 
MathewZvonL: folds 
TommyWD98: folds 
Wagoo06: folds 
MrsHes: folds 
RaTaO20: raises 400 to 800
Kevin12345Mc: folds 
mjcosta1: calls 400
*** FLOP *** [9d Kh Kc]
mjcosta1: checks 
RaTaO20: bets 1140
mjcosta1: folds 
Uncalled bet (1140) returned to RaTaO20
RaTaO20 collected 2280 from pot
*** SUMMARY ***
Total pot 2280 | Rake 0 
Board [9d Kh Kc]
Seat 1: TommyWD98 folded before Flop (didn't bet)
Seat 2: Wagoo06 folded before Flop (didn't bet)
Seat 3: MrsHes folded before Flop (didn't bet)
Seat 4: RaTaO20 (button) collected (2280)
Seat 5: Kevin12345Mc (small blind) folded before Flop
Seat 6: mjcosta1 (big blind) folded on the Flop
Seat 7: fontaine1604 folded before Flop (didn't bet)
Seat 8: MathewZvonL folded before Flop (didn't bet)



PokerStars Hand #254986928019: Tournament #3860676529, $0.46+$1.50+$0.24 USD Hold'em No Limit - Level XV (200/400) - 2025/02/22 16:39:37 WET [2025/02/22 11:39:37 ET]
Table '3860676529 152' 8-max Seat #5 is the button
Seat 1: TommyWD98 (6234 in chips, $1.50 bounty) 
Seat 2: Wagoo06 (11812 in chips, $1.50 bounty) 
Seat 3: MrsHes (12877 in chips, $1.50 bounty) 
Seat 4: RaTaO20 (23040 in chips, $1.50 bounty) 
Seat 5: Kevin12345Mc (13665 in chips, $3.37 bounty) 
Seat 6: mjcosta1 (7992 in chips, $2.25 bounty) 
Seat 7: fontaine1604 (27146 in chips, $5.25 bounty) 
Seat 8: MathewZvonL (22832 in chips, $3.75 bounty) 
TommyWD98: posts the ante 60
Wagoo06: posts the ante 60
MrsHes: posts the ante 60
RaTaO20: posts the ante 60
Kevin12345Mc: posts the ante 60
mjcosta1: posts the ante 60
fontaine1604: posts the ante 60
MathewZvonL: posts the ante 60
mjcosta1: posts small blind 200
fontaine1604: posts big blind 400
*** HOLE CARDS ***
Dealt to Kevin12345Mc [7s 5d]
MathewZvonL: folds 
TommyWD98: folds 
Wagoo06: folds 
MrsHes: raises 800 to 1200
RaTaO20: folds 
Kevin12345Mc: folds 
mjcosta1: calls 1000
fontaine1604: calls 800
*** FLOP *** [2c Js Jd]
mjcosta1: checks 
fontaine1604: checks 
MrsHes: bets 1200
mjcosta1: calls 1200
fontaine1604: raises 1600 to 2800
MrsHes: calls 1600
mjcosta1: calls 1600
*** TURN *** [2c Js Jd] [Ad]
mjcosta1: checks 
fontaine1604: bets 6240
MrsHes: folds 
mjcosta1: calls 3932 and is all-in
Uncalled bet (2308) returned to fontaine1604
*** RIVER *** [2c Js Jd Ad] [2s]
*** SHOW DOWN ***
mjcosta1: shows [As Jc] (a full house, Jacks full of Aces)
fontaine1604: shows [9d Jh] (a full house, Jacks full of Deuces)
mjcosta1 collected 20344 from pot
*** SUMMARY ***
Total pot 20344 | Rake 0 
Board [2c Js Jd Ad 2s]
Seat 1: TommyWD98 folded before Flop (didn't bet)
Seat 2: Wagoo06 folded before Flop (didn't bet)
Seat 3: MrsHes folded on the Turn
Seat 4: RaTaO20 folded before Flop (didn't bet)
Seat 5: Kevin12345Mc (button) folded before Flop (didn't bet)
Seat 6: mjcosta1 (small blind) showed [As Jc] and won (20344) with a full house, Jacks full of Aces
Seat 7: fontaine1604 (big blind) showed [9d Jh] and lost with a full house, Jacks full of Deuces
Seat 8: MathewZvonL folded before Flop (didn't bet)



PokerStars Hand #254986941813: Tournament #3860676529, $0.46+$1.50+$0.24 USD Hold'em No Limit - Level XV (200/400) - 2025/02/22 16:40:35 WET [2025/02/22 11:40:35 ET]
Table '3860676529 152' 8-max Seat #6 is the button
Seat 1: TommyWD98 (6174 in chips, $1.50 bounty) 
Seat 2: Wagoo06 (11752 in chips, $1.50 bounty) 
Seat 3: MrsHes (8817 in chips, $1.50 bounty) 
Seat 4: RaTaO20 (22980 in chips, $1.50 bounty) 
Seat 5: Kevin12345Mc (13605 in chips, $3.37 bounty) 
Seat 6: mjcosta1 (20344 in chips, $2.25 bounty) 
Seat 7: fontaine1604 (19154 in chips, $5.25 bounty) 
Seat 8: MathewZvonL (22772 in chips, $3.75 bounty) 
TommyWD98: posts the ante 60
Wagoo06: posts the ante 60
MrsHes: posts the ante 60
RaTaO20: posts the ante 60
Kevin12345Mc: posts the ante 60
mjcosta1: posts the ante 60
fontaine1604: posts the ante 60
MathewZvonL: posts the ante 60
fontaine1604: posts small blind 200
MathewZvonL: posts big blind 400
*** HOLE CARDS ***
Dealt to Kevin12345Mc [Ks 5c]
TommyWD98: raises 400 to 800
Wagoo06: folds 
MrsHes: calls 800
RaTaO20: raises 1400 to 2200
Kevin12345Mc: folds 
mjcosta1: folds 
fontaine1604: raises 16894 to 19094 and is all-in
MathewZvonL: folds 
TommyWD98: calls 5314 and is all-in
MrsHes: folds 
RaTaO20: folds 
Uncalled bet (12980) returned to fontaine1604
*** FLOP *** [Jc 5d Td]
*** TURN *** [Jc 5d Td] [Js]
*** RIVER *** [Jc 5d Td Js] [2h]
*** SHOW DOWN ***
fontaine1604: shows [As Jh] (three of a kind, Jacks)
TommyWD98: shows [Tc Th] (a full house, Tens full of Jacks)
TommyWD98 collected 16108 from pot
*** SUMMARY ***
Total pot 16108 | Rake 0 
Board [Jc 5d Td Js 2h]
Seat 1: TommyWD98 showed [Tc Th] and won (16108) with a full house, Tens full of Jacks
Seat 2: Wagoo06 folded before Flop (didn't bet)
Seat 3: MrsHes folded before Flop
Seat 4: RaTaO20 folded before Flop
Seat 5: Kevin12345Mc folded before Flop (didn't bet)
Seat 6: mjcosta1 (button) folded before Flop (didn't bet)
Seat 7: fontaine1604 (small blind) showed [As Jh] and lost with three of a kind, Jacks
Seat 8: MathewZvonL (big blind) folded before Flop



PokerStars Hand #254986951683: Tournament #3860676529, $0.46+$1.50+$0.24 USD Hold'em No Limit - Level XV (200/400) - 2025/02/22 16:41:17 WET [2025/02/22 11:41:17 ET]
Table '3860676529 152' 8-max Seat #7 is the button
Seat 1: TommyWD98 (16108 in chips, $1.50 bounty) 
Seat 2: Wagoo06 (11692 in chips, $1.50 bounty) 
Seat 3: MrsHes (7957 in chips, $1.50 bounty) 
Seat 4: RaTaO20 (20720 in chips, $1.50 bounty) 
Seat 5: Kevin12345Mc (13545 in chips, $3.37 bounty) 
Seat 6: mjcosta1 (20284 in chips, $2.25 bounty) 
Seat 7: fontaine1604 (12980 in chips, $5.25 bounty) 
Seat 8: MathewZvonL (22312 in chips, $3.75 bounty) 
TommyWD98: posts the ante 60
Wagoo06: posts the ante 60
MrsHes: posts the ante 60
RaTaO20: posts the ante 60
Kevin12345Mc: posts the ante 60
mjcosta1: posts the ante 60
fontaine1604: posts the ante 60
MathewZvonL: posts the ante 60
MathewZvonL: posts small blind 200
TommyWD98: posts big blind 400
*** HOLE CARDS ***
Dealt to Kevin12345Mc [2d 7d]
Wagoo06: folds 
MrsHes: folds 
RaTaO20: folds 
Kevin12345Mc: folds 
mjcosta1: raises 800 to 1200
fontaine1604: folds 
MathewZvonL: folds 
TommyWD98: folds 
Uncalled bet (800) returned to mjcosta1
mjcosta1 collected 1480 from pot
*** SUMMARY ***
Total pot 1480 | Rake 0 
Seat 1: TommyWD98 (big blind) folded before Flop
Seat 2: Wagoo06 folded before Flop (didn't bet)
Seat 3: MrsHes folded before Flop (didn't bet)
Seat 4: RaTaO20 folded before Flop (didn't bet)
Seat 5: Kevin12345Mc folded before Flop (didn't bet)
Seat 6: mjcosta1 collected (1480)
Seat 7: fontaine1604 (button) folded before Flop (didn't bet)
Seat 8: MathewZvonL (small blind) folded before Flop



PokerStars Hand #254986956384: Tournament #3860676529, $0.46+$1.50+$0.24 USD Hold'em No Limit - Level XV (200/400) - 2025/02/22 16:41:36 WET [2025/02/22 11:41:36 ET]
Table '3860676529 152' 8-max Seat #8 is the button
Seat 1: TommyWD98 (15648 in chips, $1.50 bounty) 
Seat 2: Wagoo06 (11632 in chips, $1.50 bounty) 
Seat 3: MrsHes (7897 in chips, $1.50 bounty) 
Seat 4: RaTaO20 (20660 in chips, $1.50 bounty) 
Seat 5: Kevin12345Mc (13485 in chips, $3.37 bounty) 
Seat 6: mjcosta1 (21304 in chips, $2.25 bounty) 
Seat 7: fontaine1604 (12920 in chips, $5.25 bounty) 
Seat 8: MathewZvonL (22052 in chips, $3.75 bounty) 
TommyWD98: posts the ante 60
Wagoo06: posts the ante 60
MrsHes: posts the ante 60
RaTaO20: posts the ante 60
Kevin12345Mc: posts the ante 60
mjcosta1: posts the ante 60
fontaine1604: posts the ante 60
MathewZvonL: posts the ante 60
TommyWD98: posts small blind 200
Wagoo06: posts big blind 400
*** HOLE CARDS ***
Dealt to Kevin12345Mc [Kd Js]
MrsHes: folds 
RaTaO20: folds 
Kevin12345Mc: raises 480 to 880
mjcosta1: folds 
fontaine1604: calls 880
MathewZvonL: calls 880
TommyWD98: folds 
Wagoo06: calls 480
*** FLOP *** [Ts 4c Jh]
Wagoo06: checks 
Kevin12345Mc: bets 1386
fontaine1604: folds 
MathewZvonL: calls 1386
Wagoo06: folds 
*** TURN *** [Ts 4c Jh] [3d]
Kevin12345Mc: bets 2301
MathewZvonL: calls 2301
*** RIVER *** [Ts 4c Jh 3d] [8h]
Kevin12345Mc: checks 
MathewZvonL: bets 11574
Kevin12345Mc: calls 8858 and is all-in
Uncalled bet (2716) returned to MathewZvonL
*** SHOW DOWN ***
MathewZvonL: shows [As Jc] (a pair of Jacks)
Kevin12345Mc: shows [Kd Js] (a pair of Jacks - lower kicker)
MathewZvonL collected 29290 from pot
MathewZvonL wins $1.69 for eliminating Kevin12345Mc and their own bounty increases by $1.68 to $5.43
Kevin12345Mc finished the tournament in 547th place
*** SUMMARY ***
Total pot 29290 | Rake 0 
Board [Ts 4c Jh 3d 8h]
Seat 1: TommyWD98 (small blind) folded before Flop
Seat 2: Wagoo06 (big blind) folded on the Flop
Seat 3: MrsHes folded before Flop (didn't bet)
Seat 4: RaTaO20 folded before Flop (didn't bet)
Seat 5: Kevin12345Mc showed [Kd Js] and lost with a pair of Jacks
Seat 6: mjcosta1 folded before Flop (didn't bet)
Seat 7: fontaine1604 folded on the Flop
Seat 8: MathewZvonL (button) showed [As Jc] and won (29290) with a pair of Jacks



